PokerStars Zoom Hand #257438767942:  Hold'em No Limit (€0.01/€0.02) - 2025/08/22 10:00:33 CET [2025/08/22 4:00:33 ET]
Table 'Arneb' 6-max Seat #1 is the button
Seat 1: titinantet (€1.77 in chips) 
Seat 2: SirDerius (€3.53 in chips) 
Seat 3: pipinoelbreve9 (€2 in chips) 
Seat 4: kombei63 (€2.01 in chips) 
Seat 5: sukocash (€2.12 in chips) 
Seat 6: hernandS&G (€2.81 in chips) 
SirDerius: posts small blind €0.01
pipinoelbreve9: posts big blind €0.02
*** HOLE CARDS ***
Dealt to pipinoelbreve9 [Js 5c]
kombei63: folds 
sukocash: folds 
hernandS&G: folds 
titinantet: folds 
SirDerius: raises €0.04 to €0.06
pipinoelbreve9: folds 
Uncalled bet (€0.04) returned to SirDerius
SirDerius collected €0.04 from pot
SirDerius: doesn't show hand 
*** SUMMARY ***
Total pot €0.04 | Rake €0 
Seat 1: titinantet (button) folded before Flop (didn't bet)
Seat 2: SirDerius (small blind) collected (€0.04)
Seat 3: pipinoelbreve9 (big blind) folded before Flop
Seat 4: kombei63 folded before Flop (didn't bet)
Seat 5: sukocash folded before Flop (didn't bet)
Seat 6: hernandS&G folded before Flop (didn't bet)



PokerStars Zoom Hand #257438769101:  Hold'em No Limit (€0.01/€0.02) - 2025/08/22 10:00:51 CET [2025/08/22 4:00:51 ET]
Table 'Arneb' 6-max Seat #1 is the button
Seat 1: pipinoelbreve9 (€2 in chips) 
Seat 2: davidelgnomo747 (€1.18 in chips) 
Seat 3: sukocash (€2.15 in chips) 
Seat 4: kombei63 (€1.24 in chips) 
Seat 5: pucelay.29 (€1.37 in chips) 
Seat 6: cegati444 (€3.44 in chips) 
davidelgnomo747: posts small blind €0.01
sukocash: posts big blind €0.02
*** HOLE CARDS ***
Dealt to pipinoelbreve9 [6d 3h]
kombei63: folds 
pucelay.29: folds 
cegati444: folds 
pipinoelbreve9: folds 
davidelgnomo747: folds 
Uncalled bet (€0.01) returned to sukocash
sukocash collected €0.02 from pot
sukocash: doesn't show hand 
*** SUMMARY ***
Total pot €0.02 | Rake €0 
Seat 1: pipinoelbreve9 (button) folded before Flop (didn't bet)
Seat 2: davidelgnomo747 (small blind) folded before Flop
Seat 3: sukocash (big blind) collected (€0.02)
Seat 4: kombei63 folded before Flop (didn't bet)
Seat 5: pucelay.29 folded before Flop (didn't bet)
Seat 6: cegati444 folded before Flop (didn't bet)



PokerStars Zoom Hand #257438768678:  Hold'em No Limit (€0.01/€0.02) - 2025/08/22 10:00:44 CET [2025/08/22 4:00:44 ET]
Table 'Arneb' 6-max Seat #1 is the button
Seat 1: sukocash (€2.13 in chips) 
Seat 2: pipinoelbreve9 (€2 in chips) 
Seat 3: roroni3 (€1.97 in chips) 
Seat 4: nometoquesloshu (€0.63 in chips) 
Seat 5: titinantet (€1.77 in chips) 
Seat 6: 77samuel33 (€4.73 in chips) 
pipinoelbreve9: posts small blind €0.01
roroni3: posts big blind €0.02
*** HOLE CARDS ***
Dealt to pipinoelbreve9 [Ac 9s]
nometoquesloshu: raises €0.04 to €0.06
titinantet: folds 
77samuel33: folds 
sukocash: folds 
pipinoelbreve9: folds 
roroni3: calls €0.04
*** FLOP *** [2h 6c 2s]
roroni3: checks 
nometoquesloshu: bets €0.03
roroni3: folds 
Uncalled bet (€0.03) returned to nometoquesloshu
nometoquesloshu collected €0.12 from pot
nometoquesloshu: doesn't show hand 
*** SUMMARY ***
Total pot €0.13 | Rake €0.01 
Board [2h 6c 2s]
Seat 1: sukocash (button) folded before Flop (didn't bet)
Seat 2: pipinoelbreve9 (small blind) folded before Flop
Seat 3: roroni3 (big blind) folded on the Flop
Seat 4: nometoquesloshu collected (€0.12)
Seat 5: titinantet folded before Flop (didn't bet)
Seat 6: 77samuel33 folded before Flop (didn't bet)



PokerStars Zoom Hand #257438769406:  Hold'em No Limit (€0.01/€0.02) - 2025/08/22 10:00:55 CET [2025/08/22 4:00:55 ET]
Table 'Arneb' 6-max Seat #1 is the button
Seat 1: kombei63 (€1.24 in chips) 
Seat 2: cegati444 (€3.44 in chips) 
Seat 3: pucelay.29 (€2.29 in chips) 
Seat 4: JENOFONTE73 (€1.98 in chips) 
Seat 5: charlyleon92 (€1.25 in chips) 
Seat 6: pipinoelbreve9 (€2 in chips) 
cegati444: posts small blind €0.01
pucelay.29: posts big blind €0.02
*** HOLE CARDS ***
Dealt to pipinoelbreve9 [As Jh]
JENOFONTE73: folds 
charlyleon92: folds 
pipinoelbreve9: raises €0.04 to €0.06
kombei63: folds 
cegati444: folds 
pucelay.29: folds 
Uncalled bet (€0.04) returned to pipinoelbreve9
pipinoelbreve9 collected €0.05 from pot
pipinoelbreve9: doesn't show hand 
*** SUMMARY ***
Total pot €0.05 | Rake €0 
Seat 1: kombei63 (button) folded before Flop (didn't bet)
Seat 2: cegati444 (small blind) folded before Flop
Seat 3: pucelay.29 (big blind) folded before Flop
Seat 4: JENOFONTE73 folded before Flop (didn't bet)
Seat 5: charlyleon92 folded before Flop (didn't bet)
Seat 6: pipinoelbreve9 collected (€0.05)



PokerStars Zoom Hand #257438770631:  Hold'em No Limit (€0.01/€0.02) - 2025/08/22 10:01:12 CET [2025/08/22 4:01:12 ET]
Table 'Arneb' 6-max Seat #1 is the button
Seat 1: nometoquesloshu (€0.69 in chips) 
Seat 2: cruass (€2.08 in chips) 
Seat 3: pucelay.29 (€1.96 in chips) 
Seat 4: titinantet (€1.80 in chips) 
Seat 5: pipinoelbreve9 (€2.03 in chips) 
Seat 6: sukocash (€2.12 in chips) 
cruass: posts small blind €0.01
pucelay.29: posts big blind €0.02
*** HOLE CARDS ***
Dealt to pipinoelbreve9 [5d 8c]
titinantet: folds 
pipinoelbreve9: folds 
sukocash: folds 
nometoquesloshu: folds 
cruass: folds 
Uncalled bet (€0.01) returned to pucelay.29
pucelay.29 collected €0.02 from pot
pucelay.29: doesn't show hand 
*** SUMMARY ***
Total pot €0.02 | Rake €0 
Seat 1: nometoquesloshu (button) folded before Flop (didn't bet)
Seat 2: cruass (small blind) folded before Flop
Seat 3: pucelay.29 (big blind) collected (€0.02)
Seat 4: titinantet folded before Flop (didn't bet)
Seat 5: pipinoelbreve9 folded before Flop (didn't bet)
Seat 6: sukocash folded before Flop (didn't bet)



PokerStars Zoom Hand #257438771104:  Hold'em No Limit (€0.01/€0.02) - 2025/08/22 10:01:19 CET [2025/08/22 4:01:19 ET]
Table 'Arneb' 6-max Seat #1 is the button
Seat 1: Danipro178 (€3.67 in chips) 
Seat 2: charlyleon92 (€1.28 in chips) 
Seat 3: pipinoelbreve9 (€2.03 in chips) 
Seat 4: Ibrahinpoker (€3.47 in chips) 
Seat 5: sukocash (€2.12 in chips) 
Seat 6: POUPIOU65 (€0.47 in chips) 
charlyleon92: posts small blind €0.01
pipinoelbreve9: posts big blind €0.02
*** HOLE CARDS ***
Dealt to pipinoelbreve9 [7s 4h]
Ibrahinpoker: folds 
sukocash: folds 
POUPIOU65: folds 
Danipro178: folds 
charlyleon92: folds 
Uncalled bet (€0.01) returned to pipinoelbreve9
pipinoelbreve9 collected €0.02 from pot
pipinoelbreve9: doesn't show hand 
*** SUMMARY ***
Total pot €0.02 | Rake €0 
Seat 1: Danipro178 (button) folded before Flop (didn't bet)
Seat 2: charlyleon92 (small blind) folded before Flop
Seat 3: pipinoelbreve9 (big blind) collected (€0.02)
Seat 4: Ibrahinpoker folded before Flop (didn't bet)
Seat 5: sukocash folded before Flop (didn't bet)
Seat 6: POUPIOU65 folded before Flop (didn't bet)



PokerStars Zoom Hand #257438771788:  Hold'em No Limit (€0.01/€0.02) - 2025/08/22 10:01:29 CET [2025/08/22 4:01:29 ET]
Table 'Arneb' 6-max Seat #1 is the button
Seat 1: XXILuv (€2 in chips) 
Seat 2: pipinoelbreve9 (€2.04 in chips) 
Seat 3: Ctr Alt Surp (€2.46 in chips) 
Seat 4: POUPIOU65 (€0.46 in chips) 
Seat 5: cruass (€2.07 in chips) 
Seat 6: Encina 99 (€1.64 in chips) 
pipinoelbreve9: posts small blind €0.01
Ctr Alt Surp: posts big blind €0.02
*** HOLE CARDS ***
Dealt to pipinoelbreve9 [Js As]
POUPIOU65: raises €0.02 to €0.04
cruass: folds 
Encina 99: calls €0.04
XXILuv: folds 
pipinoelbreve9: raises €0.18 to €0.22
Ctr Alt Surp: folds 
POUPIOU65: raises €0.24 to €0.46 and is all-in
Encina 99: calls €0.42
pipinoelbreve9: folds 
*** FLOP *** [7c 6h Jh]
*** TURN *** [7c 6h Jh] [5h]
*** RIVER *** [7c 6h Jh 5h] [2c]
*** SHOW DOWN ***
POUPIOU65: shows [Tc Th] (a pair of Tens)
Encina 99: shows [5s 4c] (a pair of Fives)
POUPIOU65 collected €1.10 from pot
*** SUMMARY ***
Total pot €1.16 | Rake €0.06 
Board [7c 6h Jh 5h 2c]
Seat 1: XXILuv (button) folded before Flop (didn't bet)
Seat 2: pipinoelbreve9 (small blind) folded before Flop
Seat 3: Ctr Alt Surp (big blind) folded before Flop
Seat 4: POUPIOU65 showed [Tc Th] and won (€1.10) with a pair of Tens
Seat 5: cruass folded before Flop (didn't bet)
Seat 6: Encina 99 showed [5s 4c] and lost with a pair of Fives



PokerStars Zoom Hand #257438774303:  Hold'em No Limit (€0.01/€0.02) - 2025/08/22 10:02:06 CET [2025/08/22 4:02:06 ET]
Table 'Arneb' 6-max Seat #1 is the button
Seat 1: titinantet (€2.01 in chips) 
Seat 2: sukocash (€2.10 in chips) 
Seat 3: rascavieja (€0.91 in chips) 
Seat 4: SmOuL123 (€1.76 in chips) 
Seat 5: 77samuel33 (€4.57 in chips) 
Seat 6: pipinoelbreve9 (€2 in chips) 
sukocash: posts small blind €0.01
rascavieja: posts big blind €0.02
*** HOLE CARDS ***
Dealt to pipinoelbreve9 [9h 7c]
SmOuL123: calls €0.02
77samuel33: folds 
pipinoelbreve9: folds 
titinantet: folds 
sukocash: folds 
rascavieja: checks 
*** FLOP *** [6h 5c 3s]
rascavieja: checks 
SmOuL123: checks 
*** TURN *** [6h 5c 3s] [9d]
rascavieja: checks 
SmOuL123: checks 
*** RIVER *** [6h 5c 3s 9d] [Th]
rascavieja: checks 
SmOuL123: checks 
*** SHOW DOWN ***
rascavieja: shows [Qs Js] (high card Queen)
SmOuL123: shows [8s 8h] (a pair of Eights)
SmOuL123 collected €0.05 from pot
*** SUMMARY ***
Total pot €0.05 | Rake €0 
Board [6h 5c 3s 9d Th]
Seat 1: titinantet (button) folded before Flop (didn't bet)
Seat 2: sukocash (small blind) folded before Flop
Seat 3: rascavieja (big blind) showed [Qs Js] and lost with high card Queen
Seat 4: SmOuL123 showed [8s 8h] and won (€0.05) with a pair of Eights
Seat 5: 77samuel33 folded before Flop (didn't bet)
Seat 6: pipinoelbreve9 folded before Flop (didn't bet)



PokerStars Zoom Hand #257438775972:  Hold'em No Limit (€0.01/€0.02) - 2025/08/22 10:02:30 CET [2025/08/22 4:02:30 ET]
Table 'Arneb' 6-max Seat #1 is the button
Seat 1: josep10965 (€2.22 in chips) 
Seat 2: 77samuel33 (€4.57 in chips) 
Seat 3: pucelay.29 (€2.24 in chips) 
Seat 4: pipinoelbreve9 (€2 in chips) 
Seat 5: POUPIOU65 (€1.08 in chips) 
Seat 6: davidelgnomo747 (€1.35 in chips) 
77samuel33: posts small blind €0.01
pucelay.29: posts big blind €0.02
*** HOLE CARDS ***
Dealt to pipinoelbreve9 [6d Qh]
pipinoelbreve9: folds 
POUPIOU65: folds 
davidelgnomo747: folds 
josep10965: folds 
77samuel33: raises €0.04 to €0.06
pucelay.29: raises €0.12 to €0.18
77samuel33: folds 
Uncalled bet (€0.12) returned to pucelay.29
pucelay.29 collected €0.12 from pot
pucelay.29: doesn't show hand 
*** SUMMARY ***
Total pot €0.12 | Rake €0 
Seat 1: josep10965 (button) folded before Flop (didn't bet)
Seat 2: 77samuel33 (small blind) folded before Flop
Seat 3: pucelay.29 (big blind) collected (€0.12)
Seat 4: pipinoelbreve9 folded before Flop (didn't bet)
Seat 5: POUPIOU65 folded before Flop (didn't bet)
Seat 6: davidelgnomo747 folded before Flop (didn't bet)



PokerStars Zoom Hand #257438774626:  Hold'em No Limit (€0.01/€0.02) - 2025/08/22 10:02:11 CET [2025/08/22 4:02:11 ET]
Table 'Arneb' 6-max Seat #1 is the button
Seat 1: pipinoelbreve9 (€2 in chips) 
Seat 2: titinantet (€2.01 in chips) 
Seat 3: JENOFONTE73 (€2.01 in chips) 
Seat 4: sukocash (€2.09 in chips) 
Seat 5: josep10965 (€2 in chips) 
Seat 6: kombei63 (€1.93 in chips) 
titinantet: posts small blind €0.01
JENOFONTE73: posts big blind €0.02
*** HOLE CARDS ***
Dealt to pipinoelbreve9 [3d Kc]
sukocash: folds 
josep10965: folds 
kombei63: folds 
pipinoelbreve9: folds 
titinantet: calls €0.01
JENOFONTE73: raises €0.03 to €0.05
titinantet: calls €0.03
*** FLOP *** [Kh 5s 8d]
titinantet: checks 
JENOFONTE73: bets €0.05
titinantet: calls €0.05
*** TURN *** [Kh 5s 8d] [8s]
titinantet: checks 
JENOFONTE73: checks 
*** RIVER *** [Kh 5s 8d 8s] [4d]
titinantet: checks 
JENOFONTE73: bets €0.10
titinantet: calls €0.10
*** SHOW DOWN ***
JENOFONTE73: shows [Ac 5c] (two pair, Eights and Fives)
titinantet: mucks hand 
JENOFONTE73 collected €0.38 from pot
*** SUMMARY ***
Total pot €0.40 | Rake €0.02 
Board [Kh 5s 8d 8s 4d]
Seat 1: pipinoelbreve9 (button) folded before Flop (didn't bet)
Seat 2: titinantet (small blind) mucked [Jh Ah]
Seat 3: JENOFONTE73 (big blind) showed [Ac 5c] and won (€0.38) with two pair, Eights and Fives
Seat 4: sukocash folded before Flop (didn't bet)
Seat 5: josep10965 folded before Flop (didn't bet)
Seat 6: kombei63 folded before Flop (didn't bet)



PokerStars Zoom Hand #257438776177:  Hold'em No Limit (€0.01/€0.02) - 2025/08/22 10:02:33 CET [2025/08/22 4:02:33 ET]
Table 'Arneb' 6-max Seat #1 is the button
Seat 1: rascavieja (€0.89 in chips) 
Seat 2: 77samuel33 (€3.05 in chips) 
Seat 3: Topuluz33 (€2 in chips) 
Seat 4: ma6as (€2.02 in chips) 
Seat 5: POUPIOU65 (€1.08 in chips) 
Seat 6: pipinoelbreve9 (€2 in chips) 
77samuel33: posts small blind €0.01
Topuluz33: posts big blind €0.02
*** HOLE CARDS ***
Dealt to pipinoelbreve9 [3c Qh]
ma6as: folds 
POUPIOU65: raises €0.03 to €0.05
pipinoelbreve9: folds 
rascavieja: folds 
77samuel33: folds 
Topuluz33: folds 
Uncalled bet (€0.03) returned to POUPIOU65
POUPIOU65 collected €0.05 from pot
POUPIOU65: doesn't show hand 
*** SUMMARY ***
Total pot €0.05 | Rake €0 
Seat 1: rascavieja (button) folded before Flop (didn't bet)
Seat 2: 77samuel33 (small blind) folded before Flop
Seat 3: Topuluz33 (big blind) folded before Flop
Seat 4: ma6as folded before Flop (didn't bet)
Seat 5: POUPIOU65 collected (€0.05)
Seat 6: pipinoelbreve9 folded before Flop (didn't bet)



PokerStars Zoom Hand #257438775636:  Hold'em No Limit (€0.01/€0.02) - 2025/08/22 10:02:25 CET [2025/08/22 4:02:25 ET]
Table 'Arneb' 6-max Seat #1 is the button
Seat 1: SirDerius (€3.49 in chips) 
Seat 2: nometoquesloshu (€0.57 in chips) 
Seat 3: kombei63 (€1.93 in chips) 
Seat 4: pipinoelbreve9 (€2 in chips) 
Seat 5: pucelay.29 (€3.24 in chips) 
Seat 6: SiuxPoker (€1.03 in chips) 
nometoquesloshu: posts small blind €0.01
kombei63: posts big blind €0.02
*** HOLE CARDS ***
Dealt to pipinoelbreve9 [7d 6c]
pipinoelbreve9: folds 
pucelay.29 is disconnected 
pucelay.29 has timed out while disconnected
pucelay.29: folds 
SiuxPoker: folds 
SirDerius: raises €0.04 to €0.06
nometoquesloshu: folds 
kombei63: calls €0.04
*** FLOP *** [Ac 4s 4d]
kombei63: checks 
SirDerius: bets €0.04
kombei63: folds 
Uncalled bet (€0.04) returned to SirDerius
SirDerius collected €0.12 from pot
SirDerius: doesn't show hand 
*** SUMMARY ***
Total pot €0.13 | Rake €0.01 
Board [Ac 4s 4d]
Seat 1: SirDerius (button) collected (€0.12)
Seat 2: nometoquesloshu (small blind) folded before Flop
Seat 3: kombei63 (big blind) folded on the Flop
Seat 4: pipinoelbreve9 folded before Flop (didn't bet)
Seat 5: pucelay.29 folded before Flop (didn't bet)
Seat 6: SiuxPoker folded before Flop (didn't bet)



PokerStars Zoom Hand #257438777313:  Hold'em No Limit (€0.01/€0.02) - 2025/08/22 10:02:49 CET [2025/08/22 4:02:49 ET]
Table 'Arneb' 6-max Seat #1 is the button
Seat 1: NouBet09 (€1.18 in chips) 
Seat 2: Topuluz33 (€2 in chips) 
Seat 3: pipinoelbreve9 (€2 in chips) 
Seat 4: charlyleon92 (€0.82 in chips) 
Seat 5: nometoquesloshu (€0.54 in chips) 
Seat 6: josep10965 (€2 in chips) 
Topuluz33: posts small blind €0.01
pipinoelbreve9: posts big blind €0.02
*** HOLE CARDS ***
Dealt to pipinoelbreve9 [Tc 3s]
charlyleon92: folds 
nometoquesloshu: folds 
josep10965: folds 
NouBet09: folds 
Topuluz33: folds 
Uncalled bet (€0.01) returned to pipinoelbreve9
pipinoelbreve9 collected €0.02 from pot
pipinoelbreve9: doesn't show hand 
*** SUMMARY ***
Total pot €0.02 | Rake €0 
Seat 1: NouBet09 (button) folded before Flop (didn't bet)
Seat 2: Topuluz33 (small blind) folded before Flop
Seat 3: pipinoelbreve9 (big blind) collected (€0.02)
Seat 4: charlyleon92 folded before Flop (didn't bet)
Seat 5: nometoquesloshu folded before Flop (didn't bet)
Seat 6: josep10965 folded before Flop (didn't bet)



PokerStars Zoom Hand #257438777972:  Hold'em No Limit (€0.01/€0.02) - 2025/08/22 10:02:59 CET [2025/08/22 4:02:59 ET]
Table 'Arneb' 6-max Seat #1 is the button
Seat 1: hernandS&G (€2.82 in chips) 
Seat 2: pipinoelbreve9 (€2.01 in chips) 
Seat 3: sukocash (€2.20 in chips) 
Seat 4: josep10965 (€2.43 in chips) 
Seat 5: JENOFONTE73 (€2.19 in chips) 
Seat 6: The4G (€1.68 in chips) 
pipinoelbreve9: posts small blind €0.01
sukocash: posts big blind €0.02
*** HOLE CARDS ***
Dealt to pipinoelbreve9 [7s 2d]
josep10965: raises €0.04 to €0.06
JENOFONTE73: folds 
The4G: folds 
hernandS&G: folds 
pipinoelbreve9: folds 
sukocash: folds 
Uncalled bet (€0.04) returned to josep10965
josep10965 collected €0.05 from pot
josep10965: doesn't show hand 
*** SUMMARY ***
Total pot €0.05 | Rake €0 
Seat 1: hernandS&G (button) folded before Flop (didn't bet)
Seat 2: pipinoelbreve9 (small blind) folded before Flop
Seat 3: sukocash (big blind) folded before Flop
Seat 4: josep10965 collected (€0.05)
Seat 5: JENOFONTE73 folded before Flop (didn't bet)
Seat 6: The4G folded before Flop (didn't bet)



PokerStars Zoom Hand #257438779319:  Hold'em No Limit (€0.01/€0.02) - 2025/08/22 10:03:18 CET [2025/08/22 4:03:18 ET]
Table 'Arneb' 6-max Seat #1 is the button
Seat 1: Danipro178 (€3.47 in chips) 
Seat 2: sukocash (€2.18 in chips) 
Seat 3: pipinoelbreve9 (€2 in chips) 
Seat 4: cruass (€1.99 in chips) 
Seat 5: charlyleon92 (€2.39 in chips) 
Seat 6: XXILuv (€2 in chips) 
sukocash: posts small blind €0.01
pipinoelbreve9: posts big blind €0.02
*** HOLE CARDS ***
Dealt to pipinoelbreve9 [Qs 4c]
cruass: folds 
charlyleon92: folds 
XXILuv: folds 
Danipro178: raises €0.03 to €0.05
sukocash: folds 
pipinoelbreve9: folds 
Uncalled bet (€0.03) returned to Danipro178
Danipro178 collected €0.05 from pot
Danipro178: doesn't show hand 
*** SUMMARY ***
Total pot €0.05 | Rake €0 
Seat 1: Danipro178 (button) collected (€0.05)
Seat 2: sukocash (small blind) folded before Flop
Seat 3: pipinoelbreve9 (big blind) folded before Flop
Seat 4: cruass folded before Flop (didn't bet)
Seat 5: charlyleon92 folded before Flop (didn't bet)
Seat 6: XXILuv folded before Flop (didn't bet)



PokerStars Zoom Hand #257438776663:  Hold'em No Limit (€0.01/€0.02) - 2025/08/22 10:02:40 CET [2025/08/22 4:02:40 ET]
Table 'Arneb' 6-max Seat #1 is the button
Seat 1: Areny_Sole (€1.94 in chips) 
Seat 2: davidelgnomo747 (€1.33 in chips) 
Seat 3: 77samuel33 (€3.04 in chips) 
Seat 4: nometoquesloshu (€0.54 in chips) 
Seat 5: pipinoelbreve9 (€2 in chips) 
Seat 6: AnaMaku (€2.36 in chips) 
davidelgnomo747: posts small blind €0.01
77samuel33: posts big blind €0.02
*** HOLE CARDS ***
Dealt to pipinoelbreve9 [5s Jh]
nometoquesloshu: folds 
pipinoelbreve9: folds 
AnaMaku: calls €0.02
Areny_Sole: raises €0.04 to €0.06
davidelgnomo747: folds 
77samuel33: calls €0.04
AnaMaku: calls €0.04
*** FLOP *** [9h Js Th]
77samuel33: checks 
AnaMaku: checks 
Areny_Sole: bets €0.06
77samuel33: calls €0.06
AnaMaku: calls €0.06
*** TURN *** [9h Js Th] [8s]
77samuel33: checks 
AnaMaku: bets €0.35
Areny_Sole: folds 
77samuel33: folds 
Uncalled bet (€0.35) returned to AnaMaku
AnaMaku collected €0.35 from pot
AnaMaku: doesn't show hand 
*** SUMMARY ***
Total pot €0.37 | Rake €0.02 
Board [9h Js Th 8s]
Seat 1: Areny_Sole (button) folded on the Turn
Seat 2: davidelgnomo747 (small blind) folded before Flop
Seat 3: 77samuel33 (big blind) folded on the Turn
Seat 4: nometoquesloshu folded before Flop (didn't bet)
Seat 5: pipinoelbreve9 folded before Flop (didn't bet)
Seat 6: AnaMaku collected (€0.35)



PokerStars Zoom Hand #257438780416:  Hold'em No Limit (€0.01/€0.02) - 2025/08/22 10:03:34 CET [2025/08/22 4:03:34 ET]
Table 'Arneb' 6-max Seat #1 is the button
Seat 1: ma6as (€2 in chips) 
Seat 2: pipinoelbreve9 (€2 in chips) 
Seat 3: mikpepra (€0.52 in chips) 
Seat 4: rascavieja (€0.89 in chips) 
Seat 5: Areny_Sole (€1.82 in chips) 
Seat 6: Topuluz33 (€2.08 in chips) 
pipinoelbreve9: posts small blind €0.01
mikpepra: posts big blind €0.02
*** HOLE CARDS ***
Dealt to pipinoelbreve9 [2d 6d]
rascavieja: folds 
Areny_Sole: folds 
Topuluz33: folds 
ma6as: folds 
pipinoelbreve9: folds 
Uncalled bet (€0.01) returned to mikpepra
mikpepra collected €0.02 from pot
mikpepra: doesn't show hand 
*** SUMMARY ***
Total pot €0.02 | Rake €0 
Seat 1: ma6as (button) folded before Flop (didn't bet)
Seat 2: pipinoelbreve9 (small blind) folded before Flop
Seat 3: mikpepra (big blind) collected (€0.02)
Seat 4: rascavieja folded before Flop (didn't bet)
Seat 5: Areny_Sole folded before Flop (didn't bet)
Seat 6: Topuluz33 folded before Flop (didn't bet)



PokerStars Zoom Hand #257438780679:  Hold'em No Limit (€0.01/€0.02) - 2025/08/22 10:03:38 CET [2025/08/22 4:03:38 ET]
Table 'Arneb' 6-max Seat #1 is the button
Seat 1: AnaMaku (€2.59 in chips) 
Seat 2: boulcheat (€3.92 in chips) 
Seat 3: nometoquesloshu (€0.86 in chips) 
Seat 4: rascavieja (€0.89 in chips) 
Seat 5: pipinoelbreve9 (€2 in chips) 
Seat 6: Areny_Sole (€1.82 in chips) 
boulcheat: posts small blind €0.01
nometoquesloshu: posts big blind €0.02
*** HOLE CARDS ***
Dealt to pipinoelbreve9 [As 2h]
rascavieja: folds 
pipinoelbreve9: folds 
Areny_Sole: raises €0.02 to €0.04
AnaMaku: folds 
boulcheat: folds 
nometoquesloshu: folds 
Uncalled bet (€0.02) returned to Areny_Sole
Areny_Sole collected €0.05 from pot
Areny_Sole: doesn't show hand 
*** SUMMARY ***
Total pot €0.05 | Rake €0 
Seat 1: AnaMaku (button) folded before Flop (didn't bet)
Seat 2: boulcheat (small blind) folded before Flop
Seat 3: nometoquesloshu (big blind) folded before Flop
Seat 4: rascavieja folded before Flop (didn't bet)
Seat 5: pipinoelbreve9 folded before Flop (didn't bet)
Seat 6: Areny_Sole collected (€0.05)



PokerStars Zoom Hand #257438778508:  Hold'em No Limit (€0.01/€0.02) - 2025/08/22 10:03:06 CET [2025/08/22 4:03:06 ET]
Table 'Arneb' 6-max Seat #1 is the button
Seat 1: pipinoelbreve9 (€2 in chips) 
Seat 2: cegati444 (€3.69 in chips) 
Seat 3: Lucian Morel (€2.03 in chips) 
Seat 4: JENOFONTE73 (€2.19 in chips) 
Seat 5: XXILuv (€2.37 in chips) 
Seat 6: kombei63 (€2.01 in chips) 
cegati444: posts small blind €0.01
Lucian Morel: posts big blind €0.02
*** HOLE CARDS ***
Dealt to pipinoelbreve9 [2c 5h]
JENOFONTE73: raises €0.03 to €0.05
XXILuv: folds 
kombei63: folds 
pipinoelbreve9: folds 
cegati444: folds 
Lucian Morel: calls €0.03
*** FLOP *** [5d Jh 4s]
Lucian Morel: checks 
JENOFONTE73: bets €0.05
Lucian Morel: calls €0.05
*** TURN *** [5d Jh 4s] [Jd]
Lucian Morel: checks 
JENOFONTE73: bets €0.12
Lucian Morel: folds 
Uncalled bet (€0.12) returned to JENOFONTE73
JENOFONTE73 collected €0.20 from pot
JENOFONTE73: doesn't show hand 
*** SUMMARY ***
Total pot €0.21 | Rake €0.01 
Board [5d Jh 4s Jd]
Seat 1: pipinoelbreve9 (button) folded before Flop (didn't bet)
Seat 2: cegati444 (small blind) folded before Flop
Seat 3: Lucian Morel (big blind) folded on the Turn
Seat 4: JENOFONTE73 collected (€0.20)
Seat 5: XXILuv folded before Flop (didn't bet)
Seat 6: kombei63 folded before Flop (didn't bet)



PokerStars Zoom Hand #257438781305:  Hold'em No Limit (€0.01/€0.02) - 2025/08/22 10:03:47 CET [2025/08/22 4:03:47 ET]
Table 'Arneb' 6-max Seat #1 is the button
Seat 1: JENOFONTE73 (€2.23 in chips) 
Seat 2: The4G (€1.50 in chips) 
Seat 3: hernandS&G (€5.01 in chips) 
Seat 4: pipinoelbreve9 (€2 in chips) 
Seat 5: Danipro178 (€3.49 in chips) 
Seat 6: Topuluz33 (€2 in chips) 
The4G: posts small blind €0.01
hernandS&G: posts big blind €0.02
*** HOLE CARDS ***
Dealt to pipinoelbreve9 [6c 2c]
pipinoelbreve9 has timed out
pipinoelbreve9: folds 
Danipro178: folds 
Topuluz33: folds 
JENOFONTE73: folds 
The4G: folds 
Uncalled bet (€0.01) returned to hernandS&G
hernandS&G collected €0.02 from pot
hernandS&G: doesn't show hand 
*** SUMMARY ***
Total pot €0.02 | Rake €0 
Seat 1: JENOFONTE73 (button) folded before Flop (didn't bet)
Seat 2: The4G (small blind) folded before Flop
Seat 3: hernandS&G (big blind) collected (€0.02)
Seat 4: pipinoelbreve9 folded before Flop (didn't bet)
Seat 5: Danipro178 folded before Flop (didn't bet)
Seat 6: Topuluz33 folded before Flop (didn't bet)



PokerStars Zoom Hand #257438780138:  Hold'em No Limit (€0.01/€0.02) - 2025/08/22 10:03:30 CET [2025/08/22 4:03:30 ET]
Table 'Arneb' 6-max Seat #1 is the button
Seat 1: charlyleon92 (€2.39 in chips) 
Seat 2: cruass (€1.99 in chips) 
Seat 3: XXILuv (€2.37 in chips) 
Seat 4: SmOuL123 (€1.75 in chips) 
Seat 5: pipinoelbreve9 (€2 in chips) 
Seat 6: mikpepra (€0.52 in chips) 
cruass: posts small blind €0.01
XXILuv: posts big blind €0.02
*** HOLE CARDS ***
Dealt to pipinoelbreve9 [5d Ah]
SmOuL123: calls €0.02
pipinoelbreve9: folds 
mikpepra: folds 
charlyleon92: calls €0.02
cruass: folds 
XXILuv: checks 
*** FLOP *** [4s 4c Qc]
XXILuv: checks 
SmOuL123: checks 
charlyleon92: checks 
*** TURN *** [4s 4c Qc] [9d]
XXILuv: checks 
SmOuL123: bets €0.08
charlyleon92: folds 
XXILuv: folds 
Uncalled bet (€0.08) returned to SmOuL123
SmOuL123 collected €0.07 from pot
SmOuL123: doesn't show hand 
*** SUMMARY ***
Total pot €0.07 | Rake €0 
Board [4s 4c Qc 9d]
Seat 1: charlyleon92 (button) folded on the Turn
Seat 2: cruass (small blind) folded before Flop
Seat 3: XXILuv (big blind) folded on the Turn
Seat 4: SmOuL123 collected (€0.07)
Seat 5: pipinoelbreve9 folded before Flop (didn't bet)
Seat 6: mikpepra folded before Flop (didn't bet)



PokerStars Zoom Hand #257438782326:  Hold'em No Limit (€0.01/€0.02) - 2025/08/22 10:04:02 CET [2025/08/22 4:04:02 ET]
Table 'Arneb' 6-max Seat #1 is the button
Seat 1: pipinoelbreve9 (€2 in chips) 
Seat 2: kekuss (€1.90 in chips) 
Seat 3: sukocash (€2.52 in chips) 
Seat 4: JENOFONTE73 (€2.23 in chips) 
Seat 5: Lucian Morel (€1.93 in chips) 
Seat 6: boulcheat (€3.92 in chips) 
kekuss: posts small blind €0.01
sukocash: posts big blind €0.02
*** HOLE CARDS ***
Dealt to pipinoelbreve9 [Ah 4c]
JENOFONTE73: folds 
Lucian Morel: folds 
boulcheat: raises €0.03 to €0.05
pipinoelbreve9: folds 
kekuss: folds 
sukocash: calls €0.03
*** FLOP *** [6c 3c Qh]
sukocash: checks 
boulcheat: bets €0.05
sukocash: folds 
Uncalled bet (€0.05) returned to boulcheat
boulcheat collected €0.10 from pot
boulcheat: doesn't show hand 
*** SUMMARY ***
Total pot €0.11 | Rake €0.01 
Board [6c 3c Qh]
Seat 1: pipinoelbreve9 (button) folded before Flop (didn't bet)
Seat 2: kekuss (small blind) folded before Flop
Seat 3: sukocash (big blind) folded on the Flop
Seat 4: JENOFONTE73 folded before Flop (didn't bet)
Seat 5: Lucian Morel folded before Flop (didn't bet)
Seat 6: boulcheat collected (€0.10)



PokerStars Zoom Hand #257438783097:  Hold'em No Limit (€0.01/€0.02) - 2025/08/22 10:04:13 CET [2025/08/22 4:04:13 ET]
Table 'Arneb' 6-max Seat #1 is the button
Seat 1: Topuluz33 (€2 in chips) 
Seat 2: nometoquesloshu (€0.83 in chips) 
Seat 3: pipinoelbreve9 (€2 in chips) 
Seat 4: kombei63 (€1.16 in chips) 
Seat 5: cruass (€1.99 in chips) 
Seat 6: Lucian Morel (€1.92 in chips) 
nometoquesloshu: posts small blind €0.01
pipinoelbreve9: posts big blind €0.02
*** HOLE CARDS ***
Dealt to pipinoelbreve9 [6d 8c]
kombei63: folds 
cruass: folds 
Lucian Morel: folds 
Topuluz33: folds 
nometoquesloshu: folds 
Uncalled bet (€0.01) returned to pipinoelbreve9
pipinoelbreve9 collected €0.02 from pot
pipinoelbreve9: doesn't show hand 
*** SUMMARY ***
Total pot €0.02 | Rake €0 
Seat 1: Topuluz33 (button) folded before Flop (didn't bet)
Seat 2: nometoquesloshu (small blind) folded before Flop
Seat 3: pipinoelbreve9 (big blind) collected (€0.02)
Seat 4: kombei63 folded before Flop (didn't bet)
Seat 5: cruass folded before Flop (didn't bet)
Seat 6: Lucian Morel folded before Flop (didn't bet)



PokerStars Zoom Hand #257438782567:  Hold'em No Limit (€0.01/€0.02) - 2025/08/22 10:04:06 CET [2025/08/22 4:04:06 ET]
Table 'Arneb' 6-max Seat #1 is the button
Seat 1: nometoquesloshu (€0.83 in chips) 
Seat 2: pipinoelbreve9 (€2 in chips) 
Seat 3: Topuluz33 (€2 in chips) 
Seat 4: axcom69 (€1.75 in chips) 
Seat 5: Lucian Morel (€1.93 in chips) 
Seat 6: NouBet09 (€1.21 in chips) 
pipinoelbreve9: posts small blind €0.01
Topuluz33: posts big blind €0.02
*** HOLE CARDS ***
Dealt to pipinoelbreve9 [Th 8h]
axcom69: folds 
Lucian Morel: folds 
NouBet09: calls €0.02
nometoquesloshu: folds 
pipinoelbreve9: folds 
Topuluz33: checks 
*** FLOP *** [5s 7c 5h]
Topuluz33: checks 
NouBet09: bets €0.11
Topuluz33: calls €0.11
*** TURN *** [5s 7c 5h] [8c]
Topuluz33: checks 
NouBet09: checks 
*** RIVER *** [5s 7c 5h 8c] [2c]
Topuluz33: bets €1.87 and is all-in
NouBet09: folds 
Uncalled bet (€1.87) returned to Topuluz33
Topuluz33 collected €0.26 from pot
Topuluz33: doesn't show hand 
*** SUMMARY ***
Total pot €0.27 | Rake €0.01 
Board [5s 7c 5h 8c 2c]
Seat 1: nometoquesloshu (button) folded before Flop (didn't bet)
Seat 2: pipinoelbreve9 (small blind) folded before Flop
Seat 3: Topuluz33 (big blind) collected (€0.26)
Seat 4: axcom69 folded before Flop (didn't bet)
Seat 5: Lucian Morel folded before Flop (didn't bet)
Seat 6: NouBet09 folded on the River



PokerStars Zoom Hand #257438784123:  Hold'em No Limit (€0.01/€0.02) - 2025/08/22 10:04:28 CET [2025/08/22 4:04:28 ET]
Table 'Arneb' 6-max Seat #1 is the button
Seat 1: pipinoelbreve9 (€2.01 in chips) 
Seat 2: Topuluz33 (€2.06 in chips) 
Seat 3: FELIPE439 (€2 in chips) 
Seat 4: kombei63 (€1.16 in chips) 
Seat 5: sukocash (€2.20 in chips) 
Seat 6: SmOuL123 (€1.80 in chips) 
Topuluz33: posts small blind €0.01
FELIPE439: posts big blind €0.02
*** HOLE CARDS ***
Dealt to pipinoelbreve9 [7d 2s]
kombei63: folds 
sukocash: raises €0.03 to €0.05
SmOuL123: folds 
pipinoelbreve9: folds 
Topuluz33: folds 
FELIPE439: folds 
Uncalled bet (€0.03) returned to sukocash
sukocash collected €0.05 from pot
sukocash: doesn't show hand 
*** SUMMARY ***
Total pot €0.05 | Rake €0 
Seat 1: pipinoelbreve9 (button) folded before Flop (didn't bet)
Seat 2: Topuluz33 (small blind) folded before Flop
Seat 3: FELIPE439 (big blind) folded before Flop
Seat 4: kombei63 folded before Flop (didn't bet)
Seat 5: sukocash collected (€0.05)
Seat 6: SmOuL123 folded before Flop (didn't bet)



PokerStars Zoom Hand #257438784568:  Hold'em No Limit (€0.01/€0.02) - 2025/08/22 10:04:34 CET [2025/08/22 4:04:34 ET]
Table 'Arneb' 6-max Seat #1 is the button
Seat 1: titinantet (€1.95 in chips) 
Seat 2: charlyleon92 (€2.46 in chips) 
Seat 3: FELIPE439 (€2 in chips) 
Seat 4: kombei63 (€1.82 in chips) 
Seat 5: nometoquesloshu (€0.36 in chips) 
Seat 6: pipinoelbreve9 (€2.01 in chips) 
charlyleon92: posts small blind €0.01
FELIPE439: posts big blind €0.02
*** HOLE CARDS ***
Dealt to pipinoelbreve9 [9s Ad]
kombei63: folds 
nometoquesloshu: folds 
pipinoelbreve9: raises €0.04 to €0.06
titinantet: folds 
charlyleon92: folds 
FELIPE439: folds 
Uncalled bet (€0.04) returned to pipinoelbreve9
pipinoelbreve9 collected €0.05 from pot
pipinoelbreve9: doesn't show hand 
*** SUMMARY ***
Total pot €0.05 | Rake €0 
Seat 1: titinantet (button) folded before Flop (didn't bet)
Seat 2: charlyleon92 (small blind) folded before Flop
Seat 3: FELIPE439 (big blind) folded before Flop
Seat 4: kombei63 folded before Flop (didn't bet)
Seat 5: nometoquesloshu folded before Flop (didn't bet)
Seat 6: pipinoelbreve9 collected (€0.05)



PokerStars Zoom Hand #257438785653:  Hold'em No Limit (€0.01/€0.02) - 2025/08/22 10:04:50 CET [2025/08/22 4:04:50 ET]
Table 'Arneb' 6-max Seat #1 is the button
Seat 1: ShardeRR (€2 in chips) 
Seat 2: XXILuv (€2 in chips) 
Seat 3: kombei63 (€1.82 in chips) 
Seat 4: elrusogamer (€5.52 in chips) 
Seat 5: mikpepra (€0.46 in chips) 
Seat 6: pipinoelbreve9 (€2.04 in chips) 
XXILuv: posts small blind €0.01
kombei63: posts big blind €0.02
*** HOLE CARDS ***
Dealt to pipinoelbreve9 [9s Jc]
elrusogamer: folds 
mikpepra: folds 
pipinoelbreve9: folds 
ShardeRR: raises €0.04 to €0.06
XXILuv: folds 
kombei63: folds 
Uncalled bet (€0.04) returned to ShardeRR
ShardeRR collected €0.05 from pot
ShardeRR: doesn't show hand 
*** SUMMARY ***
Total pot €0.05 | Rake €0 
Seat 1: ShardeRR (button) collected (€0.05)
Seat 2: XXILuv (small blind) folded before Flop
Seat 3: kombei63 (big blind) folded before Flop
Seat 4: elrusogamer folded before Flop (didn't bet)
Seat 5: mikpepra folded before Flop (didn't bet)
Seat 6: pipinoelbreve9 folded before Flop (didn't bet)



PokerStars Zoom Hand #257438780955:  Hold'em No Limit (€0.01/€0.02) - 2025/08/22 10:03:41 CET [2025/08/22 4:03:41 ET]
Table 'Arneb' 6-max Seat #1 is the button
Seat 1: Topuluz33 (€2.18 in chips) 
Seat 2: rascavieja (€0.89 in chips) 
Seat 3: josep10965 (€2.46 in chips) 
Seat 4: pipinoelbreve9 (€2 in chips) 
Seat 5: AnaMaku (€2.59 in chips) 
Seat 6: Danipro178 (€3.49 in chips) 
rascavieja: posts small blind €0.01
josep10965: posts big blind €0.02
*** HOLE CARDS ***
Dealt to pipinoelbreve9 [2h 8s]
pipinoelbreve9: folds 
AnaMaku: calls €0.02
Danipro178: folds 
Topuluz33: folds 
rascavieja: calls €0.01
josep10965: checks 
*** FLOP *** [Jc 3c Kd]
rascavieja: checks 
josep10965 is disconnected 
josep10965 has timed out while disconnected
josep10965: checks 
AnaMaku: checks 
*** TURN *** [Jc 3c Kd] [4c]
rascavieja: checks 
josep10965 has timed out while disconnected
josep10965: checks 
AnaMaku: bets €0.06
rascavieja: folds 
josep10965 has timed out while disconnected
josep10965: folds 
Uncalled bet (€0.06) returned to AnaMaku
AnaMaku collected €0.06 from pot
AnaMaku: doesn't show hand 
*** SUMMARY ***
Total pot €0.06 | Rake €0 
Board [Jc 3c Kd 4c]
Seat 1: Topuluz33 (button) folded before Flop (didn't bet)
Seat 2: rascavieja (small blind) folded on the Turn
Seat 3: josep10965 (big blind) folded on the Turn
Seat 4: pipinoelbreve9 folded before Flop (didn't bet)
Seat 5: AnaMaku collected (€0.06)
Seat 6: Danipro178 folded before Flop (didn't bet)



PokerStars Zoom Hand #257438786253:  Hold'em No Limit (€0.01/€0.02) - 2025/08/22 10:04:59 CET [2025/08/22 4:04:59 ET]
Table 'Arneb' 6-max Seat #1 is the button
Seat 1: Topuluz33 (€2.15 in chips) 
Seat 2: FELIPE439 (€1.98 in chips) 
Seat 3: axcom69 (€1.75 in chips) 
Seat 4: rascavieja (€0.88 in chips) 
Seat 5: pipinoelbreve9 (€2.04 in chips) 
Seat 6: sukocash (€2.23 in chips) 
FELIPE439: posts small blind €0.01
axcom69: posts big blind €0.02
*** HOLE CARDS ***
Dealt to pipinoelbreve9 [5h 3s]
rascavieja: folds 
pipinoelbreve9: folds 
sukocash: folds 
Topuluz33: folds 
FELIPE439: raises €0.04 to €0.06
axcom69: calls €0.04
*** FLOP *** [7s 7d 3c]
FELIPE439: bets €0.08
axcom69: folds 
Uncalled bet (€0.08) returned to FELIPE439
FELIPE439 collected €0.11 from pot
FELIPE439: doesn't show hand 
*** SUMMARY ***
Total pot €0.12 | Rake €0.01 
Board [7s 7d 3c]
Seat 1: Topuluz33 (button) folded before Flop (didn't bet)
Seat 2: FELIPE439 (small blind) collected (€0.11)
Seat 3: axcom69 (big blind) folded on the Flop
Seat 4: rascavieja folded before Flop (didn't bet)
Seat 5: pipinoelbreve9 folded before Flop (didn't bet)
Seat 6: sukocash folded before Flop (didn't bet)



PokerStars Zoom Hand #257438786870:  Hold'em No Limit (€0.01/€0.02) - 2025/08/22 10:05:07 CET [2025/08/22 4:05:07 ET]
Table 'Arneb' 6-max Seat #1 is the button
Seat 1: charlyleon92 (€1.95 in chips) 
Seat 2: FELIPE439 (€1.98 in chips) 
Seat 3: davidelgnomo747 (€1.44 in chips) 
Seat 4: pipinoelbreve9 (€2.03 in chips) 
Seat 5: kombei63 (€0.25 in chips) 
Seat 6: ShardeRR (€2.03 in chips) 
FELIPE439: posts small blind €0.01
davidelgnomo747: posts big blind €0.02
*** HOLE CARDS ***
Dealt to pipinoelbreve9 [2c 5d]
pipinoelbreve9: folds 
kombei63: folds 
ShardeRR: folds 
charlyleon92: folds 
FELIPE439: raises €0.04 to €0.06
davidelgnomo747: calls €0.04
*** FLOP *** [8s 8h 6c]
FELIPE439: bets €0.06
davidelgnomo747: folds 
Uncalled bet (€0.06) returned to FELIPE439
FELIPE439 collected €0.11 from pot
FELIPE439: doesn't show hand 
*** SUMMARY ***
Total pot €0.12 | Rake €0.01 
Board [8s 8h 6c]
Seat 1: charlyleon92 (button) folded before Flop (didn't bet)
Seat 2: FELIPE439 (small blind) collected (€0.11)
Seat 3: davidelgnomo747 (big blind) folded on the Flop
Seat 4: pipinoelbreve9 folded before Flop (didn't bet)
Seat 5: kombei63 folded before Flop (didn't bet)
Seat 6: ShardeRR folded before Flop (didn't bet)



PokerStars Zoom Hand #257438786667:  Hold'em No Limit (€0.01/€0.02) - 2025/08/22 10:05:04 CET [2025/08/22 4:05:04 ET]
Table 'Arneb' 6-max Seat #1 is the button
Seat 1: rascavieja (€0.88 in chips) 
Seat 2: pipinoelbreve9 (€2.04 in chips) 
Seat 3: cruass (€1.95 in chips) 
Seat 4: The4G (€1.40 in chips) 
Seat 5: NouBet09 (€1.05 in chips) 
Seat 6: Topuluz33 (€2.15 in chips) 
pipinoelbreve9: posts small blind €0.01
cruass: posts big blind €0.02
*** HOLE CARDS ***
Dealt to pipinoelbreve9 [9h 7s]
The4G: calls €0.02
NouBet09: calls €0.02
Topuluz33: folds 
rascavieja: folds 
pipinoelbreve9: folds 
cruass: checks 
*** FLOP *** [Ts 6d 7d]
cruass: checks 
The4G: bets €0.04
NouBet09: raises €0.15 to €0.19
cruass: folds 
The4G: calls €0.15
*** TURN *** [Ts 6d 7d] [As]
The4G: checks 
NouBet09: bets €0.43
The4G: folds 
Uncalled bet (€0.43) returned to NouBet09
NouBet09 collected €0.43 from pot
NouBet09: doesn't show hand 
*** SUMMARY ***
Total pot €0.45 | Rake €0.02 
Board [Ts 6d 7d As]
Seat 1: rascavieja (button) folded before Flop (didn't bet)
Seat 2: pipinoelbreve9 (small blind) folded before Flop
Seat 3: cruass (big blind) folded on the Flop
Seat 4: The4G folded on the Turn
Seat 5: NouBet09 collected (€0.43)
Seat 6: Topuluz33 folded before Flop (didn't bet)



PokerStars Zoom Hand #257438787097:  Hold'em No Limit (€0.01/€0.02) - 2025/08/22 10:05:11 CET [2025/08/22 4:05:11 ET]
Table 'Arneb' 6-max Seat #1 is the button
Seat 1: Topuluz33 (€2.15 in chips) 
Seat 2: kombei63 (€0.25 in chips) 
Seat 3: pipinoelbreve9 (€2.03 in chips) 
Seat 4: JENOFONTE73 (€2.02 in chips) 
Seat 5: titinantet (€2.14 in chips) 
Seat 6: charlyleon92 (€2.45 in chips) 
kombei63: posts small blind €0.01
pipinoelbreve9: posts big blind €0.02
*** HOLE CARDS ***
Dealt to pipinoelbreve9 [7d 3s]
JENOFONTE73: folds 
titinantet: calls €0.02
charlyleon92: calls €0.02
Topuluz33: folds 
kombei63: folds 
pipinoelbreve9: checks 
*** FLOP *** [Qs Jd 3c]
pipinoelbreve9: checks 
titinantet: checks 
charlyleon92: bets €0.07
pipinoelbreve9: folds 
titinantet: calls €0.07
*** TURN *** [Qs Jd 3c] [2d]
titinantet: checks 
charlyleon92: bets €0.20
titinantet: folds 
Uncalled bet (€0.20) returned to charlyleon92
charlyleon92 collected €0.20 from pot
charlyleon92: doesn't show hand 
*** SUMMARY ***
Total pot €0.21 | Rake €0.01 
Board [Qs Jd 3c 2d]
Seat 1: Topuluz33 (button) folded before Flop (didn't bet)
Seat 2: kombei63 (small blind) folded before Flop
Seat 3: pipinoelbreve9 (big blind) folded on the Flop
Seat 4: JENOFONTE73 folded before Flop (didn't bet)
Seat 5: titinantet folded on the Turn
Seat 6: charlyleon92 collected (€0.20)



PokerStars Zoom Hand #257438788406:  Hold'em No Limit (€0.01/€0.02) - 2025/08/22 10:05:29 CET [2025/08/22 4:05:29 ET]
Table 'Arneb' 6-max Seat #1 is the button
Seat 1: pipinoelbreve9 (€2.01 in chips) 
Seat 2: kekuss (€2.05 in chips) 
Seat 3: ma6as (€2.10 in chips) 
Seat 4: davidelgnomo747 (€1.38 in chips) 
Seat 5: kombei63 (€1.96 in chips) 
Seat 6: mikpepra (€0.46 in chips) 
kekuss: posts small blind €0.01
ma6as: posts big blind €0.02
*** HOLE CARDS ***
Dealt to pipinoelbreve9 [6s 9c]
davidelgnomo747: folds 
kombei63: folds 
mikpepra: raises €0.02 to €0.04
pipinoelbreve9: folds 
kekuss: folds 
ma6as: folds 
Uncalled bet (€0.02) returned to mikpepra
mikpepra collected €0.05 from pot
mikpepra: doesn't show hand 
*** SUMMARY ***
Total pot €0.05 | Rake €0 
Seat 1: pipinoelbreve9 (button) folded before Flop (didn't bet)
Seat 2: kekuss (small blind) folded before Flop
Seat 3: ma6as (big blind) folded before Flop
Seat 4: davidelgnomo747 folded before Flop (didn't bet)
Seat 5: kombei63 folded before Flop (didn't bet)
Seat 6: mikpepra collected (€0.05)



PokerStars Zoom Hand #257438789566:  Hold'em No Limit (€0.01/€0.02) - 2025/08/22 10:05:45 CET [2025/08/22 4:05:45 ET]
Table 'Arneb' 6-max Seat #1 is the button
Seat 1: 77samuel33 (€3.89 in chips) 
Seat 2: Figas89 (€2 in chips) 
Seat 3: The4G (€1.18 in chips) 
Seat 4: pipinoelbreve9 (€2.01 in chips) 
Seat 5: FELIPE439 (€2.03 in chips) 
Seat 6: sukocash (€2.35 in chips) 
Figas89: posts small blind €0.01
The4G: posts big blind €0.02
*** HOLE CARDS ***
Dealt to pipinoelbreve9 [Kc 8d]
pipinoelbreve9: folds 
FELIPE439: folds 
sukocash: folds 
77samuel33: folds 
Figas89: folds 
Uncalled bet (€0.01) returned to The4G
The4G collected €0.02 from pot
The4G: doesn't show hand 
*** SUMMARY ***
Total pot €0.02 | Rake €0 
Seat 1: 77samuel33 (button) folded before Flop (didn't bet)
Seat 2: Figas89 (small blind) folded before Flop
Seat 3: The4G (big blind) collected (€0.02)
Seat 4: pipinoelbreve9 folded before Flop (didn't bet)
Seat 5: FELIPE439 folded before Flop (didn't bet)
Seat 6: sukocash folded before Flop (didn't bet)



PokerStars Zoom Hand #257438790030:  Hold'em No Limit (€0.01/€0.02) - 2025/08/22 10:05:52 CET [2025/08/22 4:05:52 ET]
Table 'Arneb' 6-max Seat #1 is the button
Seat 1: sukocash (€2.34 in chips) 
Seat 2: charlyleon92 (€2.54 in chips) 
Seat 3: FELIPE439 (€2.03 in chips) 
Seat 4: pipinoelbreve9 (€2.01 in chips) 
Seat 5: kombei63 (€1.88 in chips) 
Seat 6: boulcheat (€5.81 in chips) 
charlyleon92: posts small blind €0.01
FELIPE439: posts big blind €0.02
*** HOLE CARDS ***
Dealt to pipinoelbreve9 [7d 8d]
pipinoelbreve9: folds 
kombei63: folds 
boulcheat: folds 
sukocash: folds 
charlyleon92: raises €0.04 to €0.06
FELIPE439: folds 
Uncalled bet (€0.04) returned to charlyleon92
charlyleon92 collected €0.04 from pot
charlyleon92: doesn't show hand 
*** SUMMARY ***
Total pot €0.04 | Rake €0 
Seat 1: sukocash (button) folded before Flop (didn't bet)
Seat 2: charlyleon92 (small blind) collected (€0.04)
Seat 3: FELIPE439 (big blind) folded before Flop
Seat 4: pipinoelbreve9 folded before Flop (didn't bet)
Seat 5: kombei63 folded before Flop (didn't bet)
Seat 6: boulcheat folded before Flop (didn't bet)



PokerStars Zoom Hand #257438789036:  Hold'em No Limit (€0.01/€0.02) - 2025/08/22 10:05:38 CET [2025/08/22 4:05:38 ET]
Table 'Arneb' 6-max Seat #1 is the button
Seat 1: nometoquesloshu (€0.27 in chips) 
Seat 2: sukocash (€2.20 in chips) 
Seat 3: charlyleon92 (€2.56 in chips) 
Seat 4: titinantet (€2.05 in chips) 
Seat 5: The4G (€1.18 in chips) 
Seat 6: pipinoelbreve9 (€2.01 in chips) 
sukocash: posts small blind €0.01
charlyleon92: posts big blind €0.02
*** HOLE CARDS ***
Dealt to pipinoelbreve9 [8d 7h]
titinantet: calls €0.02
The4G: folds 
pipinoelbreve9: folds 
nometoquesloshu: raises €0.04 to €0.06
sukocash: folds 
charlyleon92: folds 
titinantet: calls €0.04
*** FLOP *** [Js Ac 3d]
titinantet: checks 
nometoquesloshu: checks 
*** TURN *** [Js Ac 3d] [9s]
titinantet: checks 
nometoquesloshu: bets €0.04
titinantet: folds 
Uncalled bet (€0.04) returned to nometoquesloshu
nometoquesloshu collected €0.14 from pot
nometoquesloshu: doesn't show hand 
*** SUMMARY ***
Total pot €0.15 | Rake €0.01 
Board [Js Ac 3d 9s]
Seat 1: nometoquesloshu (button) collected (€0.14)
Seat 2: sukocash (small blind) folded before Flop
Seat 3: charlyleon92 (big blind) folded before Flop
Seat 4: titinantet folded on the Turn
Seat 5: The4G folded before Flop (didn't bet)
Seat 6: pipinoelbreve9 folded before Flop (didn't bet)



PokerStars Zoom Hand #257438789737:  Hold'em No Limit (€0.01/€0.02) - 2025/08/22 10:05:48 CET [2025/08/22 4:05:48 ET]
Table 'Arneb' 6-max Seat #1 is the button
Seat 1: boulcheat (€5.81 in chips) 
Seat 2: sukocash (€2.35 in chips) 
Seat 3: davidelgnomo747 (€1.38 in chips) 
Seat 4: JENOFONTE73 (€2.34 in chips) 
Seat 5: pipinoelbreve9 (€2.01 in chips) 
Seat 6: Topuluz33 (€2.13 in chips) 
sukocash: posts small blind €0.01
davidelgnomo747: posts big blind €0.02
*** HOLE CARDS ***
Dealt to pipinoelbreve9 [9h 2h]
JENOFONTE73: folds 
pipinoelbreve9: folds 
Topuluz33 is disconnected 
Topuluz33 has timed out while disconnected
Topuluz33: folds 
boulcheat: folds 
sukocash: folds 
Uncalled bet (€0.01) returned to davidelgnomo747
davidelgnomo747 collected €0.02 from pot
davidelgnomo747: doesn't show hand 
*** SUMMARY ***
Total pot €0.02 | Rake €0 
Seat 1: boulcheat (button) folded before Flop (didn't bet)
Seat 2: sukocash (small blind) folded before Flop
Seat 3: davidelgnomo747 (big blind) collected (€0.02)
Seat 4: JENOFONTE73 folded before Flop (didn't bet)
Seat 5: pipinoelbreve9 folded before Flop (didn't bet)
Seat 6: Topuluz33 folded before Flop (didn't bet)



PokerStars Zoom Hand #257438790868:  Hold'em No Limit (€0.01/€0.02) - 2025/08/22 10:06:04 CET [2025/08/22 4:06:04 ET]
Table 'Arneb' 6-max Seat #1 is the button
Seat 1: Figas89 (€2 in chips) 
Seat 2: axcom69 (€2.02 in chips) 
Seat 3: pipinoelbreve9 (€2 in chips) 
Seat 4: nometoquesloshu (€0.35 in chips) 
Seat 5: POUPIOU65 (€0.99 in chips) 
Seat 6: 77samuel33 (€3.09 in chips) 
axcom69: posts small blind €0.01
pipinoelbreve9: posts big blind €0.02
*** HOLE CARDS ***
Dealt to pipinoelbreve9 [5h 4h]
nometoquesloshu: raises €0.04 to €0.06
POUPIOU65: folds 
77samuel33: folds 
Figas89: folds 
axcom69: folds 
pipinoelbreve9: calls €0.04
*** FLOP *** [9c 7h 2s]
pipinoelbreve9: checks 
nometoquesloshu: bets €0.03
pipinoelbreve9: calls €0.03
*** TURN *** [9c 7h 2s] [Jd]
pipinoelbreve9: checks 
nometoquesloshu: bets €0.26 and is all-in
pipinoelbreve9: folds 
Uncalled bet (€0.26) returned to nometoquesloshu
nometoquesloshu collected €0.18 from pot
nometoquesloshu: doesn't show hand 
*** SUMMARY ***
Total pot €0.19 | Rake €0.01 
Board [9c 7h 2s Jd]
Seat 1: Figas89 (button) folded before Flop (didn't bet)
Seat 2: axcom69 (small blind) folded before Flop
Seat 3: pipinoelbreve9 (big blind) folded on the Turn
Seat 4: nometoquesloshu collected (€0.18)
Seat 5: POUPIOU65 folded before Flop (didn't bet)
Seat 6: 77samuel33 folded before Flop (didn't bet)



PokerStars Zoom Hand #257438790393:  Hold'em No Limit (€0.01/€0.02) - 2025/08/22 10:05:57 CET [2025/08/22 4:05:57 ET]
Table 'Arneb' 6-max Seat #1 is the button
Seat 1: cruass (€1.96 in chips) 
Seat 2: pipinoelbreve9 (€2.01 in chips) 
Seat 3: kombei63 (€1.88 in chips) 
Seat 4: FELIPE439 (€2.05 in chips) 
Seat 5: Ctr Alt Surp (€4.38 in chips) 
Seat 6: sukocash (€2.34 in chips) 
pipinoelbreve9: posts small blind €0.01
kombei63: posts big blind €0.02
*** HOLE CARDS ***
Dealt to pipinoelbreve9 [Th As]
FELIPE439: raises €0.04 to €0.06
Ctr Alt Surp: folds 
sukocash: folds 
cruass: calls €0.06
pipinoelbreve9: folds 
kombei63: calls €0.04
*** FLOP *** [7h Jh 7c]
kombei63: checks 
FELIPE439: checks 
cruass: checks 
*** TURN *** [7h Jh 7c] [6h]
kombei63: bets €0.06
FELIPE439: folds 
cruass: calls €0.06
*** RIVER *** [7h Jh 7c 6h] [Kd]
kombei63: checks 
cruass: bets €0.14
kombei63: calls €0.14
*** SHOW DOWN ***
cruass: shows [6s Ks] (two pair, Kings and Sevens)
kombei63: mucks hand 
cruass collected €0.56 from pot
*** SUMMARY ***
Total pot €0.59 | Rake €0.03 
Board [7h Jh 7c 6h Kd]
Seat 1: cruass (button) showed [6s Ks] and won (€0.56) with two pair, Kings and Sevens
Seat 2: pipinoelbreve9 (small blind) folded before Flop
Seat 3: kombei63 (big blind) mucked [Ac Jc]
Seat 4: FELIPE439 folded on the Turn
Seat 5: Ctr Alt Surp folded before Flop (didn't bet)
Seat 6: sukocash folded before Flop (didn't bet)



PokerStars Zoom Hand #257438793917:  Hold'em No Limit (€0.01/€0.02) - 2025/08/22 10:06:47 CET [2025/08/22 4:06:47 ET]
Table 'Arneb' 6-max Seat #1 is the button
Seat 1: pipinoelbreve9 (€2 in chips) 
Seat 2: Figas89 (€2 in chips) 
Seat 3: ShardeRR (€2.04 in chips) 
Seat 4: kekuss (€1.95 in chips) 
Seat 5: elrusogamer (€5.53 in chips) 
Seat 6: JENOFONTE73 (€2.54 in chips) 
Figas89: posts small blind €0.01
ShardeRR: posts big blind €0.02
*** HOLE CARDS ***
Dealt to pipinoelbreve9 [Qd 5h]
kekuss: folds 
elrusogamer: folds 
JENOFONTE73: folds 
pipinoelbreve9: folds 
Figas89: folds 
Uncalled bet (€0.01) returned to ShardeRR
ShardeRR collected €0.02 from pot
ShardeRR: doesn't show hand 
*** SUMMARY ***
Total pot €0.02 | Rake €0 
Seat 1: pipinoelbreve9 (button) folded before Flop (didn't bet)
Seat 2: Figas89 (small blind) folded before Flop
Seat 3: ShardeRR (big blind) collected (€0.02)
Seat 4: kekuss folded before Flop (didn't bet)
Seat 5: elrusogamer folded before Flop (didn't bet)
Seat 6: JENOFONTE73 folded before Flop (didn't bet)



PokerStars Zoom Hand #257438793295:  Hold'em No Limit (€0.01/€0.02) - 2025/08/22 10:06:39 CET [2025/08/22 4:06:39 ET]
Table 'Arneb' 6-max Seat #1 is the button
Seat 1: rascavieja (€0.82 in chips) 
Seat 2: FELIPE439 (€2.01 in chips) 
Seat 3: mikpepra (€0.37 in chips) 
Seat 4: axcom69 (€2.01 in chips) 
Seat 5: pipinoelbreve9 (€2 in chips) 
Seat 6: nometoquesloshu (€0.44 in chips) 
FELIPE439: posts small blind €0.01
mikpepra: posts big blind €0.02
*** HOLE CARDS ***
Dealt to pipinoelbreve9 [Kh 3s]
axcom69: folds 
pipinoelbreve9: folds 
nometoquesloshu: folds 
rascavieja: folds 
FELIPE439: calls €0.01
mikpepra: raises €0.35 to €0.37 and is all-in
FELIPE439: folds 
Uncalled bet (€0.35) returned to mikpepra
mikpepra collected €0.04 from pot
mikpepra: doesn't show hand 
*** SUMMARY ***
Total pot €0.04 | Rake €0 
Seat 1: rascavieja (button) folded before Flop (didn't bet)
Seat 2: FELIPE439 (small blind) folded before Flop
Seat 3: mikpepra (big blind) collected (€0.04)
Seat 4: axcom69 folded before Flop (didn't bet)
Seat 5: pipinoelbreve9 folded before Flop (didn't bet)
Seat 6: nometoquesloshu folded before Flop (didn't bet)



PokerStars Zoom Hand #257438794326:  Hold'em No Limit (€0.01/€0.02) - 2025/08/22 10:06:53 CET [2025/08/22 4:06:53 ET]
Table 'Arneb' 6-max Seat #1 is the button
Seat 1: kombei63 (€1.16 in chips) 
Seat 2: FELIPE439 (€1.97 in chips) 
Seat 3: SmOuL123 (€2 in chips) 
Seat 4: sukocash (€2.30 in chips) 
Seat 5: JENOFONTE73 (€2.29 in chips) 
Seat 6: pipinoelbreve9 (€2 in chips) 
FELIPE439: posts small blind €0.01
SmOuL123: posts big blind €0.02
*** HOLE CARDS ***
Dealt to pipinoelbreve9 [3h Qc]
sukocash: folds 
JENOFONTE73: folds 
pipinoelbreve9: folds 
kombei63: raises €0.04 to €0.06
FELIPE439: folds 
SmOuL123: folds 
Uncalled bet (€0.04) returned to kombei63
kombei63 collected €0.05 from pot
kombei63: doesn't show hand 
*** SUMMARY ***
Total pot €0.05 | Rake €0 
Seat 1: kombei63 (button) collected (€0.05)
Seat 2: FELIPE439 (small blind) folded before Flop
Seat 3: SmOuL123 (big blind) folded before Flop
Seat 4: sukocash folded before Flop (didn't bet)
Seat 5: JENOFONTE73 folded before Flop (didn't bet)
Seat 6: pipinoelbreve9 folded before Flop (didn't bet)



PokerStars Zoom Hand #257438794612:  Hold'em No Limit (€0.01/€0.02) - 2025/08/22 10:06:57 CET [2025/08/22 4:06:57 ET]
Table 'Arneb' 6-max Seat #1 is the button
Seat 1: pipinoelbreve9 (€2 in chips) 
Seat 2: ShardeRR (€2.05 in chips) 
Seat 3: Areny_Sole (€2.21 in chips) 
Seat 4: mikpepra (€0.39 in chips) 
Seat 5: Figas89 (€2 in chips) 
Seat 6: titinantet (€1.94 in chips) 
ShardeRR: posts small blind €0.01
Areny_Sole: posts big blind €0.02
*** HOLE CARDS ***
Dealt to pipinoelbreve9 [6h 6s]
mikpepra: raises €0.03 to €0.05
Figas89: folds 
titinantet: folds 
pipinoelbreve9: calls €0.05
ShardeRR: folds 
Areny_Sole: folds 
*** FLOP *** [Qd 3h 3s]
mikpepra: bets €0.04
pipinoelbreve9: calls €0.04
*** TURN *** [Qd 3h 3s] [Ts]
mikpepra: bets €0.15
pipinoelbreve9: raises €0.15 to €0.30
mikpepra: calls €0.15 and is all-in
*** RIVER *** [Qd 3h 3s Ts] [Jh]
*** SHOW DOWN ***
mikpepra: shows [Ks Qs] (two pair, Queens and Threes)
pipinoelbreve9: shows [6h 6s] (two pair, Sixes and Threes)
mikpepra collected €0.77 from pot
*** SUMMARY ***
Total pot €0.81 | Rake €0.04 
Board [Qd 3h 3s Ts Jh]
Seat 1: pipinoelbreve9 (button) showed [6h 6s] and lost with two pair, Sixes and Threes
Seat 2: ShardeRR (small blind) folded before Flop
Seat 3: Areny_Sole (big blind) folded before Flop
Seat 4: mikpepra showed [Ks Qs] and won (€0.77) with two pair, Queens and Threes
Seat 5: Figas89 folded before Flop (didn't bet)
Seat 6: titinantet folded before Flop (didn't bet)



PokerStars Zoom Hand #257438798307:  Hold'em No Limit (€0.01/€0.02) - 2025/08/22 10:07:51 CET [2025/08/22 4:07:51 ET]
Table 'Arneb' 6-max Seat #1 is the button
Seat 1: Figas89 (€2.90 in chips) 
Seat 2: mikpepra (€0.77 in chips) 
Seat 3: pipinoelbreve9 (€2 in chips) 
Seat 4: kombei63 (€1.19 in chips) 
Seat 5: JENOFONTE73 (€2.31 in chips) 
Seat 6: Lucian Morel (€2.09 in chips) 
mikpepra: posts small blind €0.01
pipinoelbreve9: posts big blind €0.02
*** HOLE CARDS ***
Dealt to pipinoelbreve9 [7c 7d]
kombei63: folds 
JENOFONTE73: raises €0.03 to €0.05
Lucian Morel: folds 
Figas89: folds 
mikpepra: folds 
pipinoelbreve9: calls €0.03
*** FLOP *** [9c Kh 7s]
pipinoelbreve9: checks 
JENOFONTE73: bets €0.05
pipinoelbreve9: calls €0.05
*** TURN *** [9c Kh 7s] [Js]
pipinoelbreve9: checks 
JENOFONTE73: checks 
*** RIVER *** [9c Kh 7s Js] [7h]
pipinoelbreve9: bets €0.06
JENOFONTE73: folds 
Uncalled bet (€0.06) returned to pipinoelbreve9
pipinoelbreve9 collected €0.20 from pot
pipinoelbreve9: doesn't show hand 
*** SUMMARY ***
Total pot €0.21 | Rake €0.01 
Board [9c Kh 7s Js 7h]
Seat 1: Figas89 (button) folded before Flop (didn't bet)
Seat 2: mikpepra (small blind) folded before Flop
Seat 3: pipinoelbreve9 (big blind) collected (€0.20)
Seat 4: kombei63 folded before Flop (didn't bet)
Seat 5: JENOFONTE73 folded on the River
Seat 6: Lucian Morel folded before Flop (didn't bet)



PokerStars Zoom Hand #257438801579:  Hold'em No Limit (€0.01/€0.02) - 2025/08/22 10:08:37 CET [2025/08/22 4:08:37 ET]
Table 'Arneb' 6-max Seat #1 is the button
Seat 1: JENOFONTE73 (€2.52 in chips) 
Seat 2: pipinoelbreve9 (€2.10 in chips) 
Seat 3: sukocash (€2.32 in chips) 
Seat 4: ShardeRR (€2.12 in chips) 
Seat 5: Lucian Morel (€2.06 in chips) 
Seat 6: hernandS&G (€2 in chips) 
pipinoelbreve9: posts small blind €0.01
sukocash: posts big blind €0.02
*** HOLE CARDS ***
Dealt to pipinoelbreve9 [5c 2d]
ShardeRR: raises €0.04 to €0.06
Lucian Morel: folds 
hernandS&G: folds 
JENOFONTE73: folds 
pipinoelbreve9: folds 
sukocash: folds 
Uncalled bet (€0.04) returned to ShardeRR
ShardeRR collected €0.05 from pot
ShardeRR: doesn't show hand 
*** SUMMARY ***
Total pot €0.05 | Rake €0 
Seat 1: JENOFONTE73 (button) folded before Flop (didn't bet)
Seat 2: pipinoelbreve9 (small blind) folded before Flop
Seat 3: sukocash (big blind) folded before Flop
Seat 4: ShardeRR collected (€0.05)
Seat 5: Lucian Morel folded before Flop (didn't bet)
Seat 6: hernandS&G folded before Flop (didn't bet)



PokerStars Zoom Hand #257438801858:  Hold'em No Limit (€0.01/€0.02) - 2025/08/22 10:08:41 CET [2025/08/22 4:08:41 ET]
Table 'Arneb' 6-max Seat #1 is the button
Seat 1: charlyleon92 (€2.41 in chips) 
Seat 2: ReyGuto (€1.98 in chips) 
Seat 3: rascavieja (€0.95 in chips) 
Seat 4: Figas89 (€2 in chips) 
Seat 5: sukocash (€2.30 in chips) 
Seat 6: pipinoelbreve9 (€2.09 in chips) 
ReyGuto: posts small blind €0.01
rascavieja: posts big blind €0.02
*** HOLE CARDS ***
Dealt to pipinoelbreve9 [9s 2c]
Figas89: folds 
sukocash: folds 
pipinoelbreve9: folds 
charlyleon92: raises €0.04 to €0.06
ReyGuto: folds 
rascavieja: folds 
Uncalled bet (€0.04) returned to charlyleon92
charlyleon92 collected €0.05 from pot
charlyleon92: doesn't show hand 
*** SUMMARY ***
Total pot €0.05 | Rake €0 
Seat 1: charlyleon92 (button) collected (€0.05)
Seat 2: ReyGuto (small blind) folded before Flop
Seat 3: rascavieja (big blind) folded before Flop
Seat 4: Figas89 folded before Flop (didn't bet)
Seat 5: sukocash folded before Flop (didn't bet)
Seat 6: pipinoelbreve9 folded before Flop (didn't bet)



PokerStars Zoom Hand #257438802531:  Hold'em No Limit (€0.01/€0.02) - 2025/08/22 10:08:50 CET [2025/08/22 4:08:50 ET]
Table 'Arneb' 6-max Seat #1 is the button
Seat 1: kombei63 (€1.55 in chips) 
Seat 2: KizoMaster (€1.81 in chips) 
Seat 3: elrusogamer (€5.47 in chips) 
Seat 4: pipinoelbreve9 (€2.09 in chips) 
Seat 5: sukocash (€2.34 in chips) 
Seat 6: SirDerius (€4.56 in chips) 
KizoMaster: posts small blind €0.01
elrusogamer: posts big blind €0.02
*** HOLE CARDS ***
Dealt to pipinoelbreve9 [6s Td]
pipinoelbreve9: folds 
sukocash: folds 
SirDerius: folds 
kombei63: folds 
KizoMaster: folds 
Uncalled bet (€0.01) returned to elrusogamer
elrusogamer collected €0.02 from pot
elrusogamer: doesn't show hand 
*** SUMMARY ***
Total pot €0.02 | Rake €0 
Seat 1: kombei63 (button) folded before Flop (didn't bet)
Seat 2: KizoMaster (small blind) folded before Flop
Seat 3: elrusogamer (big blind) collected (€0.02)
Seat 4: pipinoelbreve9 folded before Flop (didn't bet)
Seat 5: sukocash folded before Flop (didn't bet)
Seat 6: SirDerius folded before Flop (didn't bet)



PokerStars Zoom Hand #257438803454:  Hold'em No Limit (€0.01/€0.02) - 2025/08/22 10:09:03 CET [2025/08/22 4:09:03 ET]
Table 'Arneb' 6-max Seat #1 is the button
Seat 1: elrusogamer (€5.48 in chips) 
Seat 2: pipinoelbreve9 (€2.09 in chips) 
Seat 3: boulcheat (€6.63 in chips) 
Seat 4: nometoquesloshu (€0.34 in chips) 
Seat 5: Figas89 (€2.07 in chips) 
Seat 6: pucelay.29 (€1.18 in chips) 
pipinoelbreve9: posts small blind €0.01
boulcheat: posts big blind €0.02
*** HOLE CARDS ***
Dealt to pipinoelbreve9 [7d Th]
nometoquesloshu: raises €0.05 to €0.07
Figas89: folds 
pucelay.29: folds 
elrusogamer: folds 
pipinoelbreve9: folds 
boulcheat: folds 
Uncalled bet (€0.05) returned to nometoquesloshu
nometoquesloshu collected €0.05 from pot
nometoquesloshu: doesn't show hand 
*** SUMMARY ***
Total pot €0.05 | Rake €0 
Seat 1: elrusogamer (button) folded before Flop (didn't bet)
Seat 2: pipinoelbreve9 (small blind) folded before Flop
Seat 3: boulcheat (big blind) folded before Flop
Seat 4: nometoquesloshu collected (€0.05)
Seat 5: Figas89 folded before Flop (didn't bet)
Seat 6: pucelay.29 folded before Flop (didn't bet)



PokerStars Zoom Hand #257438802363:  Hold'em No Limit (€0.01/€0.02) - 2025/08/22 10:08:48 CET [2025/08/22 4:08:48 ET]
Table 'Arneb' 6-max Seat #1 is the button
Seat 1: ReyGuto (€1.97 in chips) 
Seat 2: PSCL61 (€0.95 in chips) 
Seat 3: Ctr Alt Surp (€5.46 in chips) 
Seat 4: cruass (€2.19 in chips) 
Seat 5: pipinoelbreve9 (€2.09 in chips) 
Seat 6: SmOuL123 (€1.71 in chips) 
PSCL61: posts small blind €0.01
Ctr Alt Surp: posts big blind €0.02
*** HOLE CARDS ***
Dealt to pipinoelbreve9 [8h 6c]
cruass: folds 
pipinoelbreve9: folds 
SmOuL123: calls €0.02
ReyGuto: folds 
PSCL61: raises €0.06 to €0.08
Ctr Alt Surp: calls €0.06
SmOuL123: calls €0.06
*** FLOP *** [Th 3s Kh]
PSCL61: bets €0.87 and is all-in
Ctr Alt Surp: folds 
SmOuL123: folds 
Uncalled bet (€0.87) returned to PSCL61
PSCL61 collected €0.23 from pot
PSCL61: doesn't show hand 
*** SUMMARY ***
Total pot €0.24 | Rake €0.01 
Board [Th 3s Kh]
Seat 1: ReyGuto (button) folded before Flop (didn't bet)
Seat 2: PSCL61 (small blind) collected (€0.23)
Seat 3: Ctr Alt Surp (big blind) folded on the Flop
Seat 4: cruass folded before Flop (didn't bet)
Seat 5: pipinoelbreve9 folded before Flop (didn't bet)
Seat 6: SmOuL123 folded on the Flop



PokerStars Zoom Hand #257438803682:  Hold'em No Limit (€0.01/€0.02) - 2025/08/22 10:09:07 CET [2025/08/22 4:09:07 ET]
Table 'Arneb' 6-max Seat #1 is the button
Seat 1: pipinoelbreve9 (€2.08 in chips) 
Seat 2: boulcheat (€6.61 in chips) 
Seat 3: konkrettrec (€1 in chips) 
Seat 4: ReyGuto (€1.97 in chips) 
Seat 5: SmOuL123 (€1.63 in chips) 
Seat 6: elrusogamer (€5.48 in chips) 
boulcheat: posts small blind €0.01
konkrettrec: posts big blind €0.02
*** HOLE CARDS ***
Dealt to pipinoelbreve9 [5h Ah]
ReyGuto: folds 
SmOuL123: folds 
elrusogamer: folds 
pipinoelbreve9: raises €0.04 to €0.06
boulcheat: calls €0.05
konkrettrec: folds 
*** FLOP *** [Kh 5c 9s]
boulcheat: checks 
pipinoelbreve9: bets €0.07
boulcheat: folds 
Uncalled bet (€0.07) returned to pipinoelbreve9
pipinoelbreve9 collected €0.13 from pot
pipinoelbreve9: doesn't show hand 
*** SUMMARY ***
Total pot €0.14 | Rake €0.01 
Board [Kh 5c 9s]
Seat 1: pipinoelbreve9 (button) collected (€0.13)
Seat 2: boulcheat (small blind) folded on the Flop
Seat 3: konkrettrec (big blind) folded before Flop
Seat 4: ReyGuto folded before Flop (didn't bet)
Seat 5: SmOuL123 folded before Flop (didn't bet)
Seat 6: elrusogamer folded before Flop (didn't bet)



PokerStars Zoom Hand #257438803174:  Hold'em No Limit (€0.01/€0.02) - 2025/08/22 10:08:59 CET [2025/08/22 4:08:59 ET]
Table 'Arneb' 6-max Seat #1 is the button
Seat 1: cruass (€2.19 in chips) 
Seat 2: Figas89 (€2 in chips) 
Seat 3: AnaMaku (€2.88 in chips) 
Seat 4: boulcheat (€6.63 in chips) 
Seat 5: pipinoelbreve9 (€2.09 in chips) 
Seat 6: charlyleon92 (€2.44 in chips) 
Figas89: posts small blind €0.01
AnaMaku: posts big blind €0.02
*** HOLE CARDS ***
Dealt to pipinoelbreve9 [6c Td]
boulcheat: folds 
pipinoelbreve9: folds 
charlyleon92: calls €0.02
cruass: raises €0.02 to €0.04
Figas89: folds 
AnaMaku: calls €0.02
charlyleon92: calls €0.02
*** FLOP *** [3s 7s 8s]
AnaMaku: checks 
charlyleon92: bets €0.12
cruass: folds 
AnaMaku: folds 
Uncalled bet (€0.12) returned to charlyleon92
charlyleon92 collected €0.12 from pot
charlyleon92: doesn't show hand 
*** SUMMARY ***
Total pot €0.13 | Rake €0.01 
Board [3s 7s 8s]
Seat 1: cruass (button) folded on the Flop
Seat 2: Figas89 (small blind) folded before Flop
Seat 3: AnaMaku (big blind) folded on the Flop
Seat 4: boulcheat folded before Flop (didn't bet)
Seat 5: pipinoelbreve9 folded before Flop (didn't bet)
Seat 6: charlyleon92 collected (€0.12)



PokerStars Zoom Hand #257438805277:  Hold'em No Limit (€0.01/€0.02) - 2025/08/22 10:09:29 CET [2025/08/22 4:09:29 ET]
Table 'Arneb' 6-max Seat #1 is the button
Seat 1: Figas89 (€2.07 in chips) 
Seat 2: elrusogamer (€5.48 in chips) 
Seat 3: pipinoelbreve9 (€2.15 in chips) 
Seat 4: kombei63 (€2.47 in chips) 
Seat 5: Areny_Sole (€2.35 in chips) 
Seat 6: elperrosequema (€1.26 in chips) 
elrusogamer: posts small blind €0.01
pipinoelbreve9: posts big blind €0.02
*** HOLE CARDS ***
Dealt to pipinoelbreve9 [Th Ts]
kombei63: folds 
Areny_Sole: folds 
elperrosequema: folds 
Figas89: folds 
elrusogamer: raises €0.04 to €0.06
pipinoelbreve9: calls €0.04
*** FLOP *** [Qd 4s 4h]
elrusogamer: bets €0.06
pipinoelbreve9: calls €0.06
*** TURN *** [Qd 4s 4h] [6d]
elrusogamer: bets €0.20
pipinoelbreve9: folds 
Uncalled bet (€0.20) returned to elrusogamer
elrusogamer collected €0.23 from pot
elrusogamer: doesn't show hand 
*** SUMMARY ***
Total pot €0.24 | Rake €0.01 
Board [Qd 4s 4h 6d]
Seat 1: Figas89 (button) folded before Flop (didn't bet)
Seat 2: elrusogamer (small blind) collected (€0.23)
Seat 3: pipinoelbreve9 (big blind) folded on the Turn
Seat 4: kombei63 folded before Flop (didn't bet)
Seat 5: Areny_Sole folded before Flop (didn't bet)
Seat 6: elperrosequema folded before Flop (didn't bet)



PokerStars Zoom Hand #257438808004:  Hold'em No Limit (€0.01/€0.02) - 2025/08/22 10:10:08 CET [2025/08/22 4:10:08 ET]
Table 'Arneb' 6-max Seat #1 is the button
Seat 1: titinantet (€2.45 in chips) 
Seat 2: Ctr Alt Surp (€6.66 in chips) 
Seat 3: mikpepra (€0.95 in chips) 
Seat 4: 34Sirina (€1.11 in chips) 
Seat 5: sukocash (€2.05 in chips) 
Seat 6: pipinoelbreve9 (€2.03 in chips) 
Ctr Alt Surp: posts small blind €0.01
mikpepra: posts big blind €0.02
*** HOLE CARDS ***
Dealt to pipinoelbreve9 [Qs Qc]
34Sirina: folds 
sukocash: folds 
pipinoelbreve9: raises €0.04 to €0.06
titinantet: folds 
Ctr Alt Surp: calls €0.05
mikpepra: folds 
*** FLOP *** [7c 8s 5d]
Ctr Alt Surp: checks 
pipinoelbreve9: checks 
*** TURN *** [7c 8s 5d] [6c]
Ctr Alt Surp: bets €0.07
pipinoelbreve9: calls €0.07
*** RIVER *** [7c 8s 5d 6c] [Qd]
Ctr Alt Surp: checks 
pipinoelbreve9: bets €0.27
Ctr Alt Surp: folds 
Uncalled bet (€0.27) returned to pipinoelbreve9
pipinoelbreve9 collected €0.27 from pot
pipinoelbreve9: doesn't show hand 
*** SUMMARY ***
Total pot €0.28 | Rake €0.01 
Board [7c 8s 5d 6c Qd]
Seat 1: titinantet (button) folded before Flop (didn't bet)
Seat 2: Ctr Alt Surp (small blind) folded on the River
Seat 3: mikpepra (big blind) folded before Flop
Seat 4: 34Sirina folded before Flop (didn't bet)
Seat 5: sukocash folded before Flop (didn't bet)
Seat 6: pipinoelbreve9 collected (€0.27)



PokerStars Zoom Hand #257438810751:  Hold'em No Limit (€0.01/€0.02) - 2025/08/22 10:10:46 CET [2025/08/22 4:10:46 ET]
Table 'Arneb' 6-max Seat #1 is the button
Seat 1: kombei63 (€1.47 in chips) 
Seat 2: nometoquesloshu (€0.27 in chips) 
Seat 3: ShardeRR (€2.06 in chips) 
Seat 4: pipinoelbreve9 (€2.17 in chips) 
Seat 5: Figas89 (€2 in chips) 
Seat 6: SmOuL123 (€1.53 in chips) 
nometoquesloshu: posts small blind €0.01
ShardeRR: posts big blind €0.02
*** HOLE CARDS ***
Dealt to pipinoelbreve9 [Jc Qc]
pipinoelbreve9: raises €0.04 to €0.06
Figas89: folds 
SmOuL123: folds 
kombei63: folds 
nometoquesloshu: folds 
ShardeRR: folds 
Uncalled bet (€0.04) returned to pipinoelbreve9
pipinoelbreve9 collected €0.05 from pot
pipinoelbreve9: doesn't show hand 
*** SUMMARY ***
Total pot €0.05 | Rake €0 
Seat 1: kombei63 (button) folded before Flop (didn't bet)
Seat 2: nometoquesloshu (small blind) folded before Flop
Seat 3: ShardeRR (big blind) folded before Flop
Seat 4: pipinoelbreve9 collected (€0.05)
Seat 5: Figas89 folded before Flop (didn't bet)
Seat 6: SmOuL123 folded before Flop (didn't bet)



PokerStars Zoom Hand #257438813377:  Hold'em No Limit (€0.01/€0.02) - 2025/08/22 10:11:23 CET [2025/08/22 4:11:23 ET]
Table 'Arneb' 6-max Seat #1 is the button
Seat 1: kombei63 (€2.41 in chips) 
Seat 2: pipinoelbreve9 (€2.20 in chips) 
Seat 3: Figas89 (€5.02 in chips) 
Seat 4: eres_tontito (€1.97 in chips) 
Seat 5: charlyleon92 (€2.07 in chips) 
Seat 6: AnaMaku (€2.76 in chips) 
pipinoelbreve9: posts small blind €0.01
Figas89: posts big blind €0.02
*** HOLE CARDS ***
Dealt to pipinoelbreve9 [Qs 2s]
eres_tontito: folds 
charlyleon92: calls €0.02
AnaMaku: folds 
kombei63: folds 
pipinoelbreve9: folds 
Figas89: checks 
*** FLOP *** [8c As 9c]
Figas89: checks 
charlyleon92: checks 
*** TURN *** [8c As 9c] [9h]
Figas89: bets €0.03
charlyleon92: folds 
Uncalled bet (€0.03) returned to Figas89
Figas89 collected €0.05 from pot
Figas89: doesn't show hand 
*** SUMMARY ***
Total pot €0.05 | Rake €0 
Board [8c As 9c 9h]
Seat 1: kombei63 (button) folded before Flop (didn't bet)
Seat 2: pipinoelbreve9 (small blind) folded before Flop
Seat 3: Figas89 (big blind) collected (€0.05)
Seat 4: eres_tontito folded before Flop (didn't bet)
Seat 5: charlyleon92 folded on the Turn
Seat 6: AnaMaku folded before Flop (didn't bet)



PokerStars Zoom Hand #257438814380:  Hold'em No Limit (€0.01/€0.02) - 2025/08/22 10:11:37 CET [2025/08/22 4:11:37 ET]
Table 'Arneb' 6-max Seat #1 is the button
Seat 1: The4G (€1.64 in chips) 
Seat 2: ShardeRR (€2.19 in chips) 
Seat 3: pipinoelbreve9 (€2.19 in chips) 
Seat 4: kombei63 (€0.87 in chips) 
Seat 5: elperrosequema (€1.20 in chips) 
Seat 6: eres_tontito (€3.79 in chips) 
ShardeRR: posts small blind €0.01
pipinoelbreve9: posts big blind €0.02
*** HOLE CARDS ***
Dealt to pipinoelbreve9 [3h Kc]
kombei63: folds 
elperrosequema: raises €0.04 to €0.06
eres_tontito: folds 
The4G: folds 
ShardeRR: folds 
pipinoelbreve9: folds 
Uncalled bet (€0.04) returned to elperrosequema
elperrosequema collected €0.05 from pot
elperrosequema: doesn't show hand 
*** SUMMARY ***
Total pot €0.05 | Rake €0 
Seat 1: The4G (button) folded before Flop (didn't bet)
Seat 2: ShardeRR (small blind) folded before Flop
Seat 3: pipinoelbreve9 (big blind) folded before Flop
Seat 4: kombei63 folded before Flop (didn't bet)
Seat 5: elperrosequema collected (€0.05)
Seat 6: eres_tontito folded before Flop (didn't bet)



PokerStars Zoom Hand #257438812286:  Hold'em No Limit (€0.01/€0.02) - 2025/08/22 10:11:08 CET [2025/08/22 4:11:08 ET]
Table 'Arneb' 6-max Seat #1 is the button
Seat 1: Figas89 (€2.01 in chips) 
Seat 2: marcel13013 (€1.58 in chips) 
Seat 3: kombei63 (€0.89 in chips) 
Seat 4: ShardeRR (€2.04 in chips) 
Seat 5: pipinoelbreve9 (€2.20 in chips) 
Seat 6: eres_tontito (€1.97 in chips) 
marcel13013: posts small blind €0.01
kombei63: posts big blind €0.02
*** HOLE CARDS ***
Dealt to pipinoelbreve9 [6d Ac]
ShardeRR: folds 
pipinoelbreve9: folds 
eres_tontito: folds 
Figas89: raises €0.04 to €0.06
marcel13013 has timed out
marcel13013: folds 
kombei63: folds 
Uncalled bet (€0.04) returned to Figas89
Figas89 collected €0.05 from pot
Figas89: doesn't show hand 
*** SUMMARY ***
Total pot €0.05 | Rake €0 
Seat 1: Figas89 (button) collected (€0.05)
Seat 2: marcel13013 (small blind) folded before Flop
Seat 3: kombei63 (big blind) folded before Flop
Seat 4: ShardeRR folded before Flop (didn't bet)
Seat 5: pipinoelbreve9 folded before Flop (didn't bet)
Seat 6: eres_tontito folded before Flop (didn't bet)



PokerStars Zoom Hand #257438814963:  Hold'em No Limit (€0.01/€0.02) - 2025/08/22 10:11:45 CET [2025/08/22 4:11:45 ET]
Table 'Arneb' 6-max Seat #1 is the button
Seat 1: pipinoelbreve9 (€2.17 in chips) 
Seat 2: charlyleon92 (€2.20 in chips) 
Seat 3: sukocash (€2.08 in chips) 
Seat 4: konkrettrec (€0.83 in chips) 
Seat 5: kombei63 (€0.86 in chips) 
Seat 6: mikpepra (€1.54 in chips) 
charlyleon92: posts small blind €0.01
sukocash: posts big blind €0.02
*** HOLE CARDS ***
Dealt to pipinoelbreve9 [5c 8h]
konkrettrec: calls €0.02
kombei63: folds 
mikpepra: folds 
pipinoelbreve9: folds 
charlyleon92: raises €0.04 to €0.06
sukocash: folds 
konkrettrec: calls €0.04
*** FLOP *** [6h 6c 6d]
charlyleon92: checks 
konkrettrec: checks 
*** TURN *** [6h 6c 6d] [As]
charlyleon92: checks 
konkrettrec: checks 
*** RIVER *** [6h 6c 6d As] [Ad]
charlyleon92: checks 
konkrettrec: checks 
*** SHOW DOWN ***
charlyleon92: shows [4d Kd] (a full house, Sixes full of Aces)
konkrettrec: shows [Th 9d] (a full house, Sixes full of Aces)
charlyleon92 collected €0.07 from pot
konkrettrec collected €0.06 from pot
*** SUMMARY ***
Total pot €0.14 | Rake €0.01 
Board [6h 6c 6d As Ad]
Seat 1: pipinoelbreve9 (button) folded before Flop (didn't bet)
Seat 2: charlyleon92 (small blind) showed [4d Kd] and won (€0.07) with a full house, Sixes full of Aces
Seat 3: sukocash (big blind) folded before Flop
Seat 4: konkrettrec showed [Th 9d] and won (€0.06) with a full house, Sixes full of Aces
Seat 5: kombei63 folded before Flop (didn't bet)
Seat 6: mikpepra folded before Flop (didn't bet)



PokerStars Zoom Hand #257438814073:  Hold'em No Limit (€0.01/€0.02) - 2025/08/22 10:11:32 CET [2025/08/22 4:11:32 ET]
Table 'Arneb' 6-max Seat #1 is the button
Seat 1: eres_tontito (€3.79 in chips) 
Seat 2: The4G (€1.65 in chips) 
Seat 3: AnaMaku (€2.76 in chips) 
Seat 4: pipinoelbreve9 (€2.19 in chips) 
Seat 5: kombei63 (€2.41 in chips) 
Seat 6: SirDerius (€2.40 in chips) 
The4G: posts small blind €0.01
AnaMaku: posts big blind €0.02
*** HOLE CARDS ***
Dealt to pipinoelbreve9 [6d Ks]
pipinoelbreve9: folds 
kombei63: folds 
SirDerius: raises €0.03 to €0.05
eres_tontito: folds 
The4G: folds 
AnaMaku: calls €0.03
*** FLOP *** [2d 8s Kh]
AnaMaku: checks 
SirDerius: bets €0.03
AnaMaku: calls €0.03
*** TURN *** [2d 8s Kh] [Ac]
AnaMaku: checks 
SirDerius: bets €0.12
AnaMaku: folds 
Uncalled bet (€0.12) returned to SirDerius
SirDerius collected €0.16 from pot
SirDerius: doesn't show hand 
*** SUMMARY ***
Total pot €0.17 | Rake €0.01 
Board [2d 8s Kh Ac]
Seat 1: eres_tontito (button) folded before Flop (didn't bet)
Seat 2: The4G (small blind) folded before Flop
Seat 3: AnaMaku (big blind) folded on the Turn
Seat 4: pipinoelbreve9 folded before Flop (didn't bet)
Seat 5: kombei63 folded before Flop (didn't bet)
Seat 6: SirDerius collected (€0.16)



PokerStars Zoom Hand #257438816815:  Hold'em No Limit (€0.01/€0.02) - 2025/08/22 10:12:11 CET [2025/08/22 4:12:11 ET]
Table 'Arneb' 6-max Seat #1 is the button
Seat 1: eres_tontito (€1.94 in chips) 
Seat 2: Ctr Alt Surp (€6.58 in chips) 
Seat 3: Lucian Morel (€1.90 in chips) 
Seat 4: kombei63 (€2.38 in chips) 
Seat 5: Danipro178 (€2.03 in chips) 
Seat 6: pipinoelbreve9 (€2.17 in chips) 
Ctr Alt Surp: posts small blind €0.01
Lucian Morel: posts big blind €0.02
*** HOLE CARDS ***
Dealt to pipinoelbreve9 [9d Jc]
kombei63: folds 
Danipro178: folds 
pipinoelbreve9: folds 
eres_tontito: folds 
Ctr Alt Surp: folds 
Uncalled bet (€0.01) returned to Lucian Morel
Lucian Morel collected €0.02 from pot
Lucian Morel: doesn't show hand 
*** SUMMARY ***
Total pot €0.02 | Rake €0 
Seat 1: eres_tontito (button) folded before Flop (didn't bet)
Seat 2: Ctr Alt Surp (small blind) folded before Flop
Seat 3: Lucian Morel (big blind) collected (€0.02)
Seat 4: kombei63 folded before Flop (didn't bet)
Seat 5: Danipro178 folded before Flop (didn't bet)
Seat 6: pipinoelbreve9 folded before Flop (didn't bet)



PokerStars Zoom Hand #257438816174:  Hold'em No Limit (€0.01/€0.02) - 2025/08/22 10:12:01 CET [2025/08/22 4:12:01 ET]
Table 'Arneb' 6-max Seat #1 is the button
Seat 1: kombei63 (€1.44 in chips) 
Seat 2: eres_tontito (€1.94 in chips) 
Seat 3: Figas89 (€2.04 in chips) 
Seat 4: NouBet09 (€2.27 in chips) 
Seat 5: pipinoelbreve9 (€2.17 in chips) 
Seat 6: PSCL61 (€1.21 in chips) 
eres_tontito: posts small blind €0.01
Figas89: posts big blind €0.02
*** HOLE CARDS ***
Dealt to pipinoelbreve9 [3c Qd]
NouBet09: calls €0.02
pipinoelbreve9: folds 
PSCL61: folds 
kombei63: folds 
eres_tontito: folds 
Figas89: checks 
*** FLOP *** [Ks 9c Qs]
Figas89: checks 
NouBet09: bets €0.05
Figas89: folds 
Uncalled bet (€0.05) returned to NouBet09
NouBet09 collected €0.05 from pot
NouBet09: doesn't show hand 
*** SUMMARY ***
Total pot €0.05 | Rake €0 
Board [Ks 9c Qs]
Seat 1: kombei63 (button) folded before Flop (didn't bet)
Seat 2: eres_tontito (small blind) folded before Flop
Seat 3: Figas89 (big blind) folded on the Flop
Seat 4: NouBet09 collected (€0.05)
Seat 5: pipinoelbreve9 folded before Flop (didn't bet)
Seat 6: PSCL61 folded before Flop (didn't bet)



PokerStars Zoom Hand #257438819419:  Hold'em No Limit (€0.01/€0.02) - 2025/08/22 10:12:46 CET [2025/08/22 4:12:46 ET]
Table 'Arneb' 6-max Seat #1 is the button
Seat 1: kombei63 (€0.79 in chips) 
Seat 2: pipinoelbreve9 (€2.15 in chips) 
Seat 3: Figas89 (€5.06 in chips) 
Seat 4: eres_tontito (€1.93 in chips) 
Seat 5: AnaMaku (€2.67 in chips) 
Seat 6: boulcheat (€6.61 in chips) 
pipinoelbreve9: posts small blind €0.01
Figas89: posts big blind €0.02
*** HOLE CARDS ***
Dealt to pipinoelbreve9 [4c 8d]
eres_tontito: folds 
AnaMaku: folds 
boulcheat: folds 
kombei63: raises €0.04 to €0.06
pipinoelbreve9: folds 
Figas89: folds 
Uncalled bet (€0.04) returned to kombei63
kombei63 collected €0.05 from pot
kombei63: doesn't show hand 
*** SUMMARY ***
Total pot €0.05 | Rake €0 
Seat 1: kombei63 (button) collected (€0.05)
Seat 2: pipinoelbreve9 (small blind) folded before Flop
Seat 3: Figas89 (big blind) folded before Flop
Seat 4: eres_tontito folded before Flop (didn't bet)
Seat 5: AnaMaku folded before Flop (didn't bet)
Seat 6: boulcheat folded before Flop (didn't bet)



PokerStars Zoom Hand #257438818988:  Hold'em No Limit (€0.01/€0.02) - 2025/08/22 10:12:40 CET [2025/08/22 4:12:40 ET]
Table 'Arneb' 6-max Seat #1 is the button
Seat 1: charlyleon92 (€2.08 in chips) 
Seat 2: Figas89 (€5.07 in chips) 
Seat 3: pipinoelbreve9 (€2.17 in chips) 
Seat 4: Areny_Sole (€2.31 in chips) 
Seat 5: KizoMaster (€1.99 in chips) 
Seat 6: axcom69 (€1.44 in chips) 
Figas89: posts small blind €0.01
pipinoelbreve9: posts big blind €0.02
*** HOLE CARDS ***
Dealt to pipinoelbreve9 [Jd 9h]
Areny_Sole: folds 
KizoMaster: folds 
axcom69: raises €0.04 to €0.06
charlyleon92: calls €0.06
Figas89: folds 
pipinoelbreve9: folds 
*** FLOP *** [6h 8d 8s]
axcom69: bets €0.07
charlyleon92: calls €0.07
*** TURN *** [6h 8d 8s] [Ac]
axcom69: checks 
charlyleon92: checks 
*** RIVER *** [6h 8d 8s Ac] [2s]
axcom69: bets €0.14
charlyleon92: raises €0.16 to €0.30
axcom69: calls €0.16
*** SHOW DOWN ***
charlyleon92: shows [8c Tc] (three of a kind, Eights)
axcom69: mucks hand 
charlyleon92 collected €0.85 from pot
*** SUMMARY ***
Total pot €0.89 | Rake €0.04 
Board [6h 8d 8s Ac 2s]
Seat 1: charlyleon92 (button) showed [8c Tc] and won (€0.85) with three of a kind, Eights
Seat 2: Figas89 (small blind) folded before Flop
Seat 3: pipinoelbreve9 (big blind) folded before Flop
Seat 4: Areny_Sole folded before Flop (didn't bet)
Seat 5: KizoMaster folded before Flop (didn't bet)
Seat 6: axcom69 mucked [Qh Qc]



PokerStars Zoom Hand #257438817779:  Hold'em No Limit (€0.01/€0.02) - 2025/08/22 10:12:23 CET [2025/08/22 4:12:23 ET]
Table 'Arneb' 6-max Seat #1 is the button
Seat 1: Lucian Morel (€1.91 in chips) 
Seat 2: sukocash (€2.06 in chips) 
Seat 3: herode2000 (€2.95 in chips) 
Seat 4: pipinoelbreve9 (€2.17 in chips) 
Seat 5: marcel13013 (€1.57 in chips) 
Seat 6: eres_tontito (€1.91 in chips) 
sukocash: posts small blind €0.01
herode2000: posts big blind €0.02
*** HOLE CARDS ***
Dealt to pipinoelbreve9 [Kd 3h]
pipinoelbreve9: folds 
marcel13013: folds 
eres_tontito: folds 
Lucian Morel: raises €0.04 to €0.06
sukocash: folds 
herode2000: calls €0.04
*** FLOP *** [Js 4s 6d]
herode2000: checks 
Lucian Morel: checks 
*** TURN *** [Js 4s 6d] [5h]
herode2000: bets €0.12
Lucian Morel: folds 
Uncalled bet (€0.12) returned to herode2000
herode2000 collected €0.12 from pot
herode2000: doesn't show hand 
*** SUMMARY ***
Total pot €0.13 | Rake €0.01 
Board [Js 4s 6d 5h]
Seat 1: Lucian Morel (button) folded on the Turn
Seat 2: sukocash (small blind) folded before Flop
Seat 3: herode2000 (big blind) collected (€0.12)
Seat 4: pipinoelbreve9 folded before Flop (didn't bet)
Seat 5: marcel13013 folded before Flop (didn't bet)
Seat 6: eres_tontito folded before Flop (didn't bet)



PokerStars Zoom Hand #257438818264:  Hold'em No Limit (€0.01/€0.02) - 2025/08/22 10:12:30 CET [2025/08/22 4:12:30 ET]
Table 'Arneb' 6-max Seat #1 is the button
Seat 1: Figas89 (€2 in chips) 
Seat 2: AnaMaku (€2.68 in chips) 
Seat 3: FELIPE439 (€1.99 in chips) 
Seat 4: pipinoelbreve9 (€2.17 in chips) 
Seat 5: ShardeRR (€2 in chips) 
Seat 6: NouBet09 (€2.30 in chips) 
AnaMaku: posts small blind €0.01
FELIPE439: posts big blind €0.02
*** HOLE CARDS ***
Dealt to pipinoelbreve9 [Td 6c]
pipinoelbreve9: folds 
ShardeRR: folds 
NouBet09: calls €0.02
Figas89: raises €0.05 to €0.07
AnaMaku: folds 
FELIPE439: calls €0.05
NouBet09: raises €0.09 to €0.16
Figas89: calls €0.09
FELIPE439: folds 
*** FLOP *** [5d 7h Qd]
NouBet09: checks 
Figas89: checks 
*** TURN *** [5d 7h Qd] [9c]
NouBet09: checks 
Figas89: checks 
*** RIVER *** [5d 7h Qd 9c] [Jc]
NouBet09: bets €0.38
Figas89: folds 
Uncalled bet (€0.38) returned to NouBet09
NouBet09 collected €0.38 from pot
NouBet09: doesn't show hand 
*** SUMMARY ***
Total pot €0.40 | Rake €0.02 
Board [5d 7h Qd 9c Jc]
Seat 1: Figas89 (button) folded on the River
Seat 2: AnaMaku (small blind) folded before Flop
Seat 3: FELIPE439 (big blind) folded before Flop
Seat 4: pipinoelbreve9 folded before Flop (didn't bet)
Seat 5: ShardeRR folded before Flop (didn't bet)
Seat 6: NouBet09 collected (€0.38)



PokerStars Zoom Hand #257438819628:  Hold'em No Limit (€0.01/€0.02) - 2025/08/22 10:12:49 CET [2025/08/22 4:12:49 ET]
Table 'Arneb' 6-max Seat #1 is the button
Seat 1: pipinoelbreve9 (€2.14 in chips) 
Seat 2: boulcheat (€6.61 in chips) 
Seat 3: JENOFONTE73 (€2.33 in chips) 
Seat 4: charlyleon92 (€2.21 in chips) 
Seat 5: Ctr Alt Surp (€6.37 in chips) 
Seat 6: sukocash (€2.05 in chips) 
boulcheat: posts small blind €0.01
JENOFONTE73: posts big blind €0.02
*** HOLE CARDS ***
Dealt to pipinoelbreve9 [Ac Ad]
charlyleon92: folds 
Ctr Alt Surp: folds 
sukocash: raises €0.03 to €0.05
pipinoelbreve9: raises €0.09 to €0.14
boulcheat: folds 
JENOFONTE73: folds 
sukocash: calls €0.09
*** FLOP *** [8s Ts 8c]
sukocash: checks 
pipinoelbreve9: bets €0.04
sukocash: calls €0.04
*** TURN *** [8s Ts 8c] [5d]
sukocash: checks 
pipinoelbreve9: bets €0.18
sukocash: folds 
Uncalled bet (€0.18) returned to pipinoelbreve9
pipinoelbreve9 collected €0.37 from pot
pipinoelbreve9: doesn't show hand 
*** SUMMARY ***
Total pot €0.39 | Rake €0.02 
Board [8s Ts 8c 5d]
Seat 1: pipinoelbreve9 (button) collected (€0.37)
Seat 2: boulcheat (small blind) folded before Flop
Seat 3: JENOFONTE73 (big blind) folded before Flop
Seat 4: charlyleon92 folded before Flop (didn't bet)
Seat 5: Ctr Alt Surp folded before Flop (didn't bet)
Seat 6: sukocash folded on the Turn



PokerStars Zoom Hand #257438822517:  Hold'em No Limit (€0.01/€0.02) - 2025/08/22 10:13:28 CET [2025/08/22 4:13:28 ET]
Table 'Arneb' 6-max Seat #1 is the button
Seat 1: SirDerius (€2.43 in chips) 
Seat 2: Areny_Sole (€1.92 in chips) 
Seat 3: josuavion (€2.25 in chips) 
Seat 4: JENOFONTE73 (€2.44 in chips) 
Seat 5: Figas89 (€2.01 in chips) 
Seat 6: pipinoelbreve9 (€2.33 in chips) 
Areny_Sole: posts small blind €0.01
josuavion: posts big blind €0.02
*** HOLE CARDS ***
Dealt to pipinoelbreve9 [Ad Jh]
JENOFONTE73 has timed out
JENOFONTE73: folds 
Figas89: folds 
pipinoelbreve9: raises €0.02 to €0.04
SirDerius: folds 
Areny_Sole: folds 
josuavion: calls €0.02
*** FLOP *** [7h 7d 3h]
josuavion: checks 
pipinoelbreve9: bets €0.04
josuavion: folds 
Uncalled bet (€0.04) returned to pipinoelbreve9
pipinoelbreve9 collected €0.09 from pot
pipinoelbreve9: doesn't show hand 
*** SUMMARY ***
Total pot €0.09 | Rake €0 
Board [7h 7d 3h]
Seat 1: SirDerius (button) folded before Flop (didn't bet)
Seat 2: Areny_Sole (small blind) folded before Flop
Seat 3: josuavion (big blind) folded on the Flop
Seat 4: JENOFONTE73 folded before Flop (didn't bet)
Seat 5: Figas89 folded before Flop (didn't bet)
Seat 6: pipinoelbreve9 collected (€0.09)



PokerStars Zoom Hand #257438825262:  Hold'em No Limit (€0.01/€0.02) - 2025/08/22 10:14:06 CET [2025/08/22 4:14:06 ET]
Table 'Arneb' 6-max Seat #1 is the button
Seat 1: pipinoelbreve9 (€2.38 in chips) 
Seat 2: axcom69 (€2.01 in chips) 
Seat 3: herode2000 (€3.03 in chips) 
Seat 4: eres_tontito (€2.02 in chips) 
Seat 5: mikpepra (€2.09 in chips) 
Seat 6: kombei63 (€1.62 in chips) 
axcom69: posts small blind €0.01
herode2000: posts big blind €0.02
*** HOLE CARDS ***
Dealt to pipinoelbreve9 [Ah 2c]
eres_tontito: folds 
mikpepra: raises €0.02 to €0.04
kombei63: folds 
pipinoelbreve9: folds 
axcom69: folds 
herode2000: calls €0.02
*** FLOP *** [As 3s Qc]
herode2000: checks 
mikpepra: checks 
*** TURN *** [As 3s Qc] [Qs]
herode2000: bets €0.08
mikpepra: folds 
Uncalled bet (€0.08) returned to herode2000
herode2000 collected €0.09 from pot
herode2000: doesn't show hand 
*** SUMMARY ***
Total pot €0.09 | Rake €0 
Board [As 3s Qc Qs]
Seat 1: pipinoelbreve9 (button) folded before Flop (didn't bet)
Seat 2: axcom69 (small blind) folded before Flop
Seat 3: herode2000 (big blind) collected (€0.09)
Seat 4: eres_tontito folded before Flop (didn't bet)
Seat 5: mikpepra folded on the Turn
Seat 6: kombei63 folded before Flop (didn't bet)



PokerStars Zoom Hand #257438826878:  Hold'em No Limit (€0.01/€0.02) - 2025/08/22 10:14:28 CET [2025/08/22 4:14:28 ET]
Table 'Arneb' 6-max Seat #1 is the button
Seat 1: 34Sirina (€1.16 in chips) 
Seat 2: sukocash (€2 in chips) 
Seat 3: ReyGuto (€2.05 in chips) 
Seat 4: timo773 (€1.02 in chips) 
Seat 5: pipinoelbreve9 (€2.37 in chips) 
Seat 6: charlyleon92 (€2.01 in chips) 
sukocash: posts small blind €0.01
ReyGuto: posts big blind €0.02
*** HOLE CARDS ***
Dealt to pipinoelbreve9 [9d 4h]
timo773: folds 
pipinoelbreve9: folds 
charlyleon92: raises €0.04 to €0.06
34Sirina: folds 
sukocash: folds 
ReyGuto: folds 
Uncalled bet (€0.04) returned to charlyleon92
charlyleon92 collected €0.05 from pot
charlyleon92: doesn't show hand 
*** SUMMARY ***
Total pot €0.05 | Rake €0 
Seat 1: 34Sirina (button) folded before Flop (didn't bet)
Seat 2: sukocash (small blind) folded before Flop
Seat 3: ReyGuto (big blind) folded before Flop
Seat 4: timo773 folded before Flop (didn't bet)
Seat 5: pipinoelbreve9 folded before Flop (didn't bet)
Seat 6: charlyleon92 collected (€0.05)



PokerStars Zoom Hand #257438827359:  Hold'em No Limit (€0.01/€0.02) - 2025/08/22 10:14:35 CET [2025/08/22 4:14:35 ET]
Table 'Arneb' 6-max Seat #1 is the button
Seat 1: kombei63 (€2.13 in chips) 
Seat 2: sukocash (€1.98 in chips) 
Seat 3: pipinoelbreve9 (€2.37 in chips) 
Seat 4: PSCL61 (€2.08 in chips) 
Seat 5: Ctr Alt Surp (€6.43 in chips) 
Seat 6: timo773 (€1.02 in chips) 
sukocash: posts small blind €0.01
pipinoelbreve9: posts big blind €0.02
*** HOLE CARDS ***
Dealt to pipinoelbreve9 [2d Qd]
PSCL61: folds 
Ctr Alt Surp: folds 
timo773: folds 
kombei63: folds 
sukocash: folds 
Uncalled bet (€0.01) returned to pipinoelbreve9
pipinoelbreve9 collected €0.02 from pot
pipinoelbreve9: doesn't show hand 
*** SUMMARY ***
Total pot €0.02 | Rake €0 
Seat 1: kombei63 (button) folded before Flop (didn't bet)
Seat 2: sukocash (small blind) folded before Flop
Seat 3: pipinoelbreve9 (big blind) collected (€0.02)
Seat 4: PSCL61 folded before Flop (didn't bet)
Seat 5: Ctr Alt Surp folded before Flop (didn't bet)
Seat 6: timo773 folded before Flop (didn't bet)



PokerStars Zoom Hand #257438828129:  Hold'em No Limit (€0.01/€0.02) - 2025/08/22 10:14:45 CET [2025/08/22 4:14:45 ET]
Table 'Arneb' 6-max Seat #1 is the button
Seat 1: NouBet09 (€0.50 in chips) 
Seat 2: SmOuL123 (€0.64 in chips) 
Seat 3: kombei63 (€2.13 in chips) 
Seat 4: eres_tontito (€1.85 in chips) 
Seat 5: POUPIOU65 (€0.59 in chips) 
Seat 6: pipinoelbreve9 (€2.38 in chips) 
SmOuL123: posts small blind €0.01
kombei63: posts big blind €0.02
*** HOLE CARDS ***
Dealt to pipinoelbreve9 [Ad 8d]
eres_tontito: folds 
POUPIOU65: folds 
pipinoelbreve9: raises €0.04 to €0.06
NouBet09: folds 
SmOuL123: folds 
kombei63: folds 
Uncalled bet (€0.04) returned to pipinoelbreve9
pipinoelbreve9 collected €0.05 from pot
pipinoelbreve9: doesn't show hand 
*** SUMMARY ***
Total pot €0.05 | Rake €0 
Seat 1: NouBet09 (button) folded before Flop (didn't bet)
Seat 2: SmOuL123 (small blind) folded before Flop
Seat 3: kombei63 (big blind) folded before Flop
Seat 4: eres_tontito folded before Flop (didn't bet)
Seat 5: POUPIOU65 folded before Flop (didn't bet)
Seat 6: pipinoelbreve9 collected (€0.05)



PokerStars Zoom Hand #257438829022:  Hold'em No Limit (€0.01/€0.02) - 2025/08/22 10:14:57 CET [2025/08/22 4:14:57 ET]
Table 'Arneb' 6-max Seat #1 is the button
Seat 1: Danipro178 (€2 in chips) 
Seat 2: pipinoelbreve9 (€2.41 in chips) 
Seat 3: eres_tontito (€1.98 in chips) 
Seat 4: sukocash (€2 in chips) 
Seat 5: JENOFONTE73 (€2.36 in chips) 
Seat 6: 77samuel33 (€2 in chips) 
pipinoelbreve9: posts small blind €0.01
eres_tontito: posts big blind €0.02
*** HOLE CARDS ***
Dealt to pipinoelbreve9 [6s Qc]
sukocash: folds 
JENOFONTE73: raises €0.03 to €0.05
77samuel33: folds 
Danipro178: folds 
pipinoelbreve9: folds 
eres_tontito: folds 
Uncalled bet (€0.03) returned to JENOFONTE73
JENOFONTE73 collected €0.05 from pot
JENOFONTE73: doesn't show hand 
*** SUMMARY ***
Total pot €0.05 | Rake €0 
Seat 1: Danipro178 (button) folded before Flop (didn't bet)
Seat 2: pipinoelbreve9 (small blind) folded before Flop
Seat 3: eres_tontito (big blind) folded before Flop
Seat 4: sukocash folded before Flop (didn't bet)
Seat 5: JENOFONTE73 collected (€0.05)
Seat 6: 77samuel33 folded before Flop (didn't bet)



PokerStars Zoom Hand #257438825938:  Hold'em No Limit (€0.01/€0.02) - 2025/08/22 10:14:16 CET [2025/08/22 4:14:16 ET]
Table 'Arneb' 6-max Seat #1 is the button
Seat 1: Figas89 (€2 in chips) 
Seat 2: pipinoelbreve9 (€2.38 in chips) 
Seat 3: crissstal (€1.24 in chips) 
Seat 4: POUPIOU65 (€0.57 in chips) 
Seat 5: kombei63 (€1.62 in chips) 
Seat 6: eres_tontito (€2.08 in chips) 
pipinoelbreve9: posts small blind €0.01
crissstal: posts big blind €0.02
*** HOLE CARDS ***
Dealt to pipinoelbreve9 [7s Jd]
POUPIOU65: folds 
kombei63: raises €0.04 to €0.06
eres_tontito: calls €0.06
Figas89: raises €0.18 to €0.24
pipinoelbreve9: folds 
crissstal: folds 
kombei63: calls €0.18
eres_tontito: folds 
*** FLOP *** [Ks Qc 9c]
kombei63: checks 
Figas89: checks 
*** TURN *** [Ks Qc 9c] [Qd]
kombei63: checks 
Figas89: checks 
*** RIVER *** [Ks Qc 9c Qd] [4s]
kombei63: bets €0.27
Figas89: folds 
Uncalled bet (€0.27) returned to kombei63
kombei63 collected €0.54 from pot
kombei63: doesn't show hand 
*** SUMMARY ***
Total pot €0.57 | Rake €0.03 
Board [Ks Qc 9c Qd 4s]
Seat 1: Figas89 (button) folded on the River
Seat 2: pipinoelbreve9 (small blind) folded before Flop
Seat 3: crissstal (big blind) folded before Flop
Seat 4: POUPIOU65 folded before Flop (didn't bet)
Seat 5: kombei63 collected (€0.54)
Seat 6: eres_tontito folded before Flop



PokerStars Zoom Hand #257438829515:  Hold'em No Limit (€0.01/€0.02) - 2025/08/22 10:15:04 CET [2025/08/22 4:15:04 ET]
Table 'Arneb' 6-max Seat #1 is the button
Seat 1: Ctr Alt Surp (€6.40 in chips) 
Seat 2: nometoquesloshu (€1.63 in chips) 
Seat 3: sukocash (€2 in chips) 
Seat 4: pipinoelbreve9 (€2.40 in chips) 
Seat 5: josuavion (€1.15 in chips) 
Seat 6: NouBet09 (€0.53 in chips) 
nometoquesloshu: posts small blind €0.01
sukocash: posts big blind €0.02
*** HOLE CARDS ***
Dealt to pipinoelbreve9 [Kc Js]
pipinoelbreve9: raises €0.04 to €0.06
josuavion: calls €0.06
NouBet09: folds 
Ctr Alt Surp: folds 
nometoquesloshu: raises €0.20 to €0.26
sukocash: folds 
pipinoelbreve9: folds 
josuavion: calls €0.20
*** FLOP *** [Ad Kd As]
nometoquesloshu: checks 
josuavion: bets €0.89 and is all-in
nometoquesloshu: calls €0.89
*** TURN *** [Ad Kd As] [7c]
*** RIVER *** [Ad Kd As 7c] [Tc]
*** SHOW DOWN ***
nometoquesloshu: shows [Ac Ah] (four of a kind, Aces)
josuavion: shows [Qd 9s] (a pair of Aces)
nometoquesloshu collected €2.26 from pot
*** SUMMARY ***
Total pot €2.38 | Rake €0.12 
Board [Ad Kd As 7c Tc]
Seat 1: Ctr Alt Surp (button) folded before Flop (didn't bet)
Seat 2: nometoquesloshu (small blind) showed [Ac Ah] and won (€2.26) with four of a kind, Aces
Seat 3: sukocash (big blind) folded before Flop
Seat 4: pipinoelbreve9 folded before Flop
Seat 5: josuavion showed [Qd 9s] and lost with a pair of Aces
Seat 6: NouBet09 folded before Flop (didn't bet)



PokerStars Zoom Hand #257438830748:  Hold'em No Limit (€0.01/€0.02) - 2025/08/22 10:15:22 CET [2025/08/22 4:15:22 ET]
Table 'Arneb' 6-max Seat #1 is the button
Seat 1: pipinoelbreve9 (€2.34 in chips) 
Seat 2: JENOFONTE73 (€2.39 in chips) 
Seat 3: FELIPE439 (€1.91 in chips) 
Seat 4: kombei63 (€1.92 in chips) 
Seat 5: eres_tontito (€2.02 in chips) 
Seat 6: 77samuel33 (€2 in chips) 
JENOFONTE73: posts small blind €0.01
FELIPE439: posts big blind €0.02
*** HOLE CARDS ***
Dealt to pipinoelbreve9 [9h 5h]
kombei63: raises €0.04 to €0.06
eres_tontito: folds 
77samuel33: calls €0.06
pipinoelbreve9: folds 
JENOFONTE73: raises €0.16 to €0.22
FELIPE439: folds 
kombei63: folds 
77samuel33: calls €0.16
*** FLOP *** [8h Th 2s]
JENOFONTE73: bets €0.25
77samuel33: folds 
Uncalled bet (€0.25) returned to JENOFONTE73
JENOFONTE73 collected €0.49 from pot
JENOFONTE73: doesn't show hand 
*** SUMMARY ***
Total pot €0.52 | Rake €0.03 
Board [8h Th 2s]
Seat 1: pipinoelbreve9 (button) folded before Flop (didn't bet)
Seat 2: JENOFONTE73 (small blind) collected (€0.49)
Seat 3: FELIPE439 (big blind) folded before Flop
Seat 4: kombei63 folded before Flop
Seat 5: eres_tontito folded before Flop (didn't bet)
Seat 6: 77samuel33 folded on the Flop



PokerStars Zoom Hand #257438831776:  Hold'em No Limit (€0.01/€0.02) - 2025/08/22 10:15:37 CET [2025/08/22 4:15:37 ET]
Table 'Arneb' 6-max Seat #1 is the button
Seat 1: eres_tontito (€1.97 in chips) 
Seat 2: POUPIOU65 (€0.57 in chips) 
Seat 3: pipinoelbreve9 (€2.34 in chips) 
Seat 4: SmOuL123 (€1.98 in chips) 
Seat 5: 34Sirina (€1.24 in chips) 
Seat 6: boulcheat (€5.49 in chips) 
POUPIOU65: posts small blind €0.01
pipinoelbreve9: posts big blind €0.02
*** HOLE CARDS ***
Dealt to pipinoelbreve9 [8h Jh]
SmOuL123: folds 
34Sirina: raises €0.05 to €0.07
boulcheat: calls €0.07
eres_tontito: folds 
POUPIOU65: folds 
pipinoelbreve9: calls €0.05
*** FLOP *** [6d 6h 3h]
pipinoelbreve9: checks 
34Sirina: bets €0.11
boulcheat: folds 
pipinoelbreve9: calls €0.11
*** TURN *** [6d 6h 3h] [5s]
pipinoelbreve9: checks 
34Sirina: bets €0.08
pipinoelbreve9: calls €0.08
*** RIVER *** [6d 6h 3h 5s] [8c]
pipinoelbreve9: checks 
34Sirina: checks 
*** SHOW DOWN ***
pipinoelbreve9: shows [8h Jh] (two pair, Eights and Sixes)
34Sirina: mucks hand 
pipinoelbreve9 collected €0.57 from pot
*** SUMMARY ***
Total pot €0.60 | Rake €0.03 
Board [6d 6h 3h 5s 8c]
Seat 1: eres_tontito (button) folded before Flop (didn't bet)
Seat 2: POUPIOU65 (small blind) folded before Flop
Seat 3: pipinoelbreve9 (big blind) showed [8h Jh] and won (€0.57) with two pair, Eights and Sixes
Seat 4: SmOuL123 folded before Flop (didn't bet)
Seat 5: 34Sirina mucked [Jd Qh]
Seat 6: boulcheat folded on the Flop



PokerStars Zoom Hand #257438835351:  Hold'em No Limit (€0.01/€0.02) - 2025/08/22 10:16:28 CET [2025/08/22 4:16:28 ET]
Table 'Arneb' 6-max Seat #1 is the button
Seat 1: kombei63 (€1.75 in chips) 
Seat 2: FELIPE439 (€2.22 in chips) 
Seat 3: Ctr Alt Surp (€6.28 in chips) 
Seat 4: ReyGuto (€2.26 in chips) 
Seat 5: JENOFONTE73 (€3.71 in chips) 
Seat 6: pipinoelbreve9 (€2.65 in chips) 
FELIPE439: posts small blind €0.01
Ctr Alt Surp: posts big blind €0.02
*** HOLE CARDS ***
Dealt to pipinoelbreve9 [Qc 5h]
ReyGuto: folds 
JENOFONTE73: folds 
pipinoelbreve9: folds 
kombei63: folds 
FELIPE439: folds 
Uncalled bet (€0.01) returned to Ctr Alt Surp
Ctr Alt Surp collected €0.02 from pot
Ctr Alt Surp: doesn't show hand 
*** SUMMARY ***
Total pot €0.02 | Rake €0 
Seat 1: kombei63 (button) folded before Flop (didn't bet)
Seat 2: FELIPE439 (small blind) folded before Flop
Seat 3: Ctr Alt Surp (big blind) collected (€0.02)
Seat 4: ReyGuto folded before Flop (didn't bet)
Seat 5: JENOFONTE73 folded before Flop (didn't bet)
Seat 6: pipinoelbreve9 folded before Flop (didn't bet)



PokerStars Zoom Hand #257438835804:  Hold'em No Limit (€0.01/€0.02) - 2025/08/22 10:16:35 CET [2025/08/22 4:16:35 ET]
Table 'Arneb' 6-max Seat #1 is the button
Seat 1: ReyGuto (€2.26 in chips) 
Seat 2: JENOFONTE73 (€3.71 in chips) 
Seat 3: sukocash (€2 in chips) 
Seat 4: eres_tontito (€1.82 in chips) 
Seat 5: pipinoelbreve9 (€2.65 in chips) 
Seat 6: kombei63 (€1.75 in chips) 
JENOFONTE73: posts small blind €0.01
sukocash: posts big blind €0.02
*** HOLE CARDS ***
Dealt to pipinoelbreve9 [2d Tc]
eres_tontito: folds 
pipinoelbreve9: folds 
kombei63: folds 
ReyGuto: folds 
JENOFONTE73: folds 
Uncalled bet (€0.01) returned to sukocash
sukocash collected €0.02 from pot
sukocash: doesn't show hand 
*** SUMMARY ***
Total pot €0.02 | Rake €0 
Seat 1: ReyGuto (button) folded before Flop (didn't bet)
Seat 2: JENOFONTE73 (small blind) folded before Flop
Seat 3: sukocash (big blind) collected (€0.02)
Seat 4: eres_tontito folded before Flop (didn't bet)
Seat 5: pipinoelbreve9 folded before Flop (didn't bet)
Seat 6: kombei63 folded before Flop (didn't bet)



PokerStars Zoom Hand #257438836327:  Hold'em No Limit (€0.01/€0.02) - 2025/08/22 10:16:41 CET [2025/08/22 4:16:41 ET]
Table 'Arneb' 6-max Seat #1 is the button
Seat 1: ShardeRR (€2.30 in chips) 
Seat 2: Danipro178 (€2.33 in chips) 
Seat 3: mikpepra (€1.20 in chips) 
Seat 4: pipinoelbreve9 (€2.65 in chips) 
Seat 5: FELIPE439 (€1.73 in chips) 
Seat 6: ReyGuto (€2.26 in chips) 
Danipro178: posts small blind €0.01
mikpepra: posts big blind €0.02
*** HOLE CARDS ***
Dealt to pipinoelbreve9 [6h Th]
pipinoelbreve9: folds 
FELIPE439: folds 
ReyGuto: folds 
ShardeRR: raises €0.04 to €0.06
Danipro178: raises €0.16 to €0.22
mikpepra: folds 
ShardeRR: folds 
Uncalled bet (€0.16) returned to Danipro178
Danipro178 collected €0.14 from pot
Danipro178: doesn't show hand 
*** SUMMARY ***
Total pot €0.14 | Rake €0 
Seat 1: ShardeRR (button) folded before Flop
Seat 2: Danipro178 (small blind) collected (€0.14)
Seat 3: mikpepra (big blind) folded before Flop
Seat 4: pipinoelbreve9 folded before Flop (didn't bet)
Seat 5: FELIPE439 folded before Flop (didn't bet)
Seat 6: ReyGuto folded before Flop (didn't bet)



PokerStars Zoom Hand #257438836966:  Hold'em No Limit (€0.01/€0.02) - 2025/08/22 10:16:50 CET [2025/08/22 4:16:50 ET]
Table 'Arneb' 6-max Seat #1 is the button
Seat 1: timo773 (€1.98 in chips) 
Seat 2: eres_tontito (€1.89 in chips) 
Seat 3: Figas89 (€5.22 in chips) 
Seat 4: charlyleon92 (€1.62 in chips) 
Seat 5: pipinoelbreve9 (€2.65 in chips) 
Seat 6: sukocash (€2.01 in chips) 
eres_tontito: posts small blind €0.01
Figas89: posts big blind €0.02
*** HOLE CARDS ***
Dealt to pipinoelbreve9 [9s Kh]
charlyleon92: calls €0.02
pipinoelbreve9: folds 
sukocash: folds 
timo773: folds 
eres_tontito: folds 
Figas89: raises €0.05 to €0.07
charlyleon92: calls €0.05
*** FLOP *** [As 7d Jd]
Figas89: bets €0.07
charlyleon92: folds 
Uncalled bet (€0.07) returned to Figas89
Figas89 collected €0.14 from pot
Figas89: doesn't show hand 
*** SUMMARY ***
Total pot €0.15 | Rake €0.01 
Board [As 7d Jd]
Seat 1: timo773 (button) folded before Flop (didn't bet)
Seat 2: eres_tontito (small blind) folded before Flop
Seat 3: Figas89 (big blind) collected (€0.14)
Seat 4: charlyleon92 folded on the Flop
Seat 5: pipinoelbreve9 folded before Flop (didn't bet)
Seat 6: sukocash folded before Flop (didn't bet)



PokerStars Zoom Hand #257438836581:  Hold'em No Limit (€0.01/€0.02) - 2025/08/22 10:16:45 CET [2025/08/22 4:16:45 ET]
Table 'Arneb' 6-max Seat #1 is the button
Seat 1: Danipro178 (€2.06 in chips) 
Seat 2: Ctr Alt Surp (€6.29 in chips) 
Seat 3: 77samuel33 (€2 in chips) 
Seat 4: pipinoelbreve9 (€2.65 in chips) 
Seat 5: JENOFONTE73 (€2.64 in chips) 
Seat 6: FELIPE439 (€1.83 in chips) 
Ctr Alt Surp: posts small blind €0.01
77samuel33: posts big blind €0.02
*** HOLE CARDS ***
Dealt to pipinoelbreve9 [Ts 2s]
pipinoelbreve9: folds 
JENOFONTE73: folds 
FELIPE439: folds 
Danipro178: raises €0.03 to €0.05
Ctr Alt Surp: calls €0.04
77samuel33: calls €0.03
*** FLOP *** [Ad Qh 2c]
Ctr Alt Surp: checks 
77samuel33: checks 
Danipro178: checks 
*** TURN *** [Ad Qh 2c] [9c]
Ctr Alt Surp: checks 
77samuel33: checks 
Danipro178: checks 
*** RIVER *** [Ad Qh 2c 9c] [4c]
Ctr Alt Surp: checks 
77samuel33: checks 
Danipro178: bets €0.10
Ctr Alt Surp: folds 
77samuel33: folds 
Uncalled bet (€0.10) returned to Danipro178
Danipro178 collected €0.14 from pot
Danipro178: doesn't show hand 
*** SUMMARY ***
Total pot €0.15 | Rake €0.01 
Board [Ad Qh 2c 9c 4c]
Seat 1: Danipro178 (button) collected (€0.14)
Seat 2: Ctr Alt Surp (small blind) folded on the River
Seat 3: 77samuel33 (big blind) folded on the River
Seat 4: pipinoelbreve9 folded before Flop (didn't bet)
Seat 5: JENOFONTE73 folded before Flop (didn't bet)
Seat 6: FELIPE439 folded before Flop (didn't bet)



PokerStars Zoom Hand #257438837458:  Hold'em No Limit (€0.01/€0.02) - 2025/08/22 10:16:56 CET [2025/08/22 4:16:56 ET]
Table 'Arneb' 6-max Seat #1 is the button
Seat 1: FELIPE439 (€1.83 in chips) 
Seat 2: pipinoelbreve9 (€2.65 in chips) 
Seat 3: POUPIOU65 (€1.23 in chips) 
Seat 4: JENOFONTE73 (€2.64 in chips) 
Seat 5: fallingredstar (€1.90 in chips) 
Seat 6: timo773 (€1.98 in chips) 
pipinoelbreve9: posts small blind €0.01
POUPIOU65: posts big blind €0.02
*** HOLE CARDS ***
Dealt to pipinoelbreve9 [Qc Ah]
JENOFONTE73: raises €0.03 to €0.05
fallingredstar: folds 
timo773: calls €0.05
FELIPE439: folds 
pipinoelbreve9: calls €0.04
POUPIOU65: calls €0.03
*** FLOP *** [Kc 5c Ts]
pipinoelbreve9: checks 
POUPIOU65: bets €0.03
JENOFONTE73: calls €0.03
timo773: raises €0.28 to €0.31
pipinoelbreve9: folds 
POUPIOU65: folds 
JENOFONTE73: folds 
Uncalled bet (€0.28) returned to timo773
timo773 collected €0.28 from pot
timo773: doesn't show hand 
*** SUMMARY ***
Total pot €0.29 | Rake €0.01 
Board [Kc 5c Ts]
Seat 1: FELIPE439 (button) folded before Flop (didn't bet)
Seat 2: pipinoelbreve9 (small blind) folded on the Flop
Seat 3: POUPIOU65 (big blind) folded on the Flop
Seat 4: JENOFONTE73 folded on the Flop
Seat 5: fallingredstar folded before Flop (didn't bet)
Seat 6: timo773 collected (€0.28)



PokerStars Zoom Hand #257438840518:  Hold'em No Limit (€0.01/€0.02) - 2025/08/22 10:17:39 CET [2025/08/22 4:17:39 ET]
Table 'Arneb' 6-max Seat #1 is the button
Seat 1: 77samuel33 (€2 in chips) 
Seat 2: PSCL61 (€2.08 in chips) 
Seat 3: pipinoelbreve9 (€2.60 in chips) 
Seat 4: sukocash (€2.11 in chips) 
Seat 5: nometoquesloshu (€2.66 in chips) 
Seat 6: FELIPE439 (€2.25 in chips) 
PSCL61: posts small blind €0.01
pipinoelbreve9: posts big blind €0.02
*** HOLE CARDS ***
Dealt to pipinoelbreve9 [5d 9h]
sukocash: folds 
nometoquesloshu: raises €0.04 to €0.06
FELIPE439: folds 
77samuel33: folds 
PSCL61: folds 
pipinoelbreve9: folds 
Uncalled bet (€0.04) returned to nometoquesloshu
nometoquesloshu collected €0.05 from pot
nometoquesloshu: doesn't show hand 
*** SUMMARY ***
Total pot €0.05 | Rake €0 
Seat 1: 77samuel33 (button) folded before Flop (didn't bet)
Seat 2: PSCL61 (small blind) folded before Flop
Seat 3: pipinoelbreve9 (big blind) folded before Flop
Seat 4: sukocash folded before Flop (didn't bet)
Seat 5: nometoquesloshu collected (€0.05)
Seat 6: FELIPE439 folded before Flop (didn't bet)



PokerStars Zoom Hand #257438841864:  Hold'em No Limit (€0.01/€0.02) - 2025/08/22 10:17:57 CET [2025/08/22 4:17:57 ET]
Table 'Arneb' 6-max Seat #1 is the button
Seat 1: pipinoelbreve9 (€2.58 in chips) 
Seat 2: FELIPE439 (€2.25 in chips) 
Seat 3: ReyGuto (€2.28 in chips) 
Seat 4: kombei63 (€1.90 in chips) 
Seat 5: timo773 (€2.17 in chips) 
Seat 6: mgmandi (€1.15 in chips) 
FELIPE439: posts small blind €0.01
ReyGuto: posts big blind €0.02
*** HOLE CARDS ***
Dealt to pipinoelbreve9 [3d 5d]
kombei63: folds 
timo773: folds 
mgmandi: folds 
pipinoelbreve9: folds 
FELIPE439: folds 
Uncalled bet (€0.01) returned to ReyGuto
ReyGuto collected €0.02 from pot
ReyGuto: doesn't show hand 
*** SUMMARY ***
Total pot €0.02 | Rake €0 
Seat 1: pipinoelbreve9 (button) folded before Flop (didn't bet)
Seat 2: FELIPE439 (small blind) folded before Flop
Seat 3: ReyGuto (big blind) collected (€0.02)
Seat 4: kombei63 folded before Flop (didn't bet)
Seat 5: timo773 folded before Flop (didn't bet)
Seat 6: mgmandi folded before Flop (didn't bet)



PokerStars Zoom Hand #257438842228:  Hold'em No Limit (€0.01/€0.02) - 2025/08/22 10:18:02 CET [2025/08/22 4:18:02 ET]
Table 'Arneb' 6-max Seat #1 is the button
Seat 1: FELIPE439 (€1.77 in chips) 
Seat 2: eres_tontito (€2.13 in chips) 
Seat 3: Ctr Alt Surp (€6.18 in chips) 
Seat 4: nometoquesloshu (€2.68 in chips) 
Seat 5: JENOFONTE73 (€3.95 in chips) 
Seat 6: pipinoelbreve9 (€2.58 in chips) 
eres_tontito: posts small blind €0.01
Ctr Alt Surp: posts big blind €0.02
*** HOLE CARDS ***
Dealt to pipinoelbreve9 [Qd 7d]
nometoquesloshu: raises €0.04 to €0.06
JENOFONTE73: folds 
pipinoelbreve9: folds 
FELIPE439: folds 
eres_tontito: calls €0.05
Ctr Alt Surp: folds 
*** FLOP *** [Js Jh 8c]
eres_tontito: bets €0.07
nometoquesloshu: folds 
Uncalled bet (€0.07) returned to eres_tontito
eres_tontito collected €0.13 from pot
eres_tontito: doesn't show hand 
*** SUMMARY ***
Total pot €0.14 | Rake €0.01 
Board [Js Jh 8c]
Seat 1: FELIPE439 (button) folded before Flop (didn't bet)
Seat 2: eres_tontito (small blind) collected (€0.13)
Seat 3: Ctr Alt Surp (big blind) folded before Flop
Seat 4: nometoquesloshu folded on the Flop
Seat 5: JENOFONTE73 folded before Flop (didn't bet)
Seat 6: pipinoelbreve9 folded before Flop (didn't bet)



PokerStars Zoom Hand #257438842880:  Hold'em No Limit (€0.01/€0.02) - 2025/08/22 10:18:10 CET [2025/08/22 4:18:10 ET]
Table 'Arneb' 6-max Seat #1 is the button
Seat 1: crissstal (€1.38 in chips) 
Seat 2: kombei63 (€1.17 in chips) 
Seat 3: Figas89 (€2.64 in chips) 
Seat 4: pipinoelbreve9 (€2.58 in chips) 
Seat 5: 77samuel33 (€2 in chips) 
Seat 6: mgmandi (€1.15 in chips) 
kombei63: posts small blind €0.01
Figas89: posts big blind €0.02
*** HOLE CARDS ***
Dealt to pipinoelbreve9 [Jc Th]
pipinoelbreve9: folds 
77samuel33: folds 
mgmandi: calls €0.02
crissstal: folds 
kombei63: folds 
Figas89: checks 
*** FLOP *** [Ts 8s 5h]
Figas89: checks 
mgmandi: bets €0.22
Figas89: folds 
Uncalled bet (€0.22) returned to mgmandi
mgmandi collected €0.05 from pot
mgmandi: doesn't show hand 
*** SUMMARY ***
Total pot €0.05 | Rake €0 
Board [Ts 8s 5h]
Seat 1: crissstal (button) folded before Flop (didn't bet)
Seat 2: kombei63 (small blind) folded before Flop
Seat 3: Figas89 (big blind) folded on the Flop
Seat 4: pipinoelbreve9 folded before Flop (didn't bet)
Seat 5: 77samuel33 folded before Flop (didn't bet)
Seat 6: mgmandi collected (€0.05)



PokerStars Zoom Hand #257438843960:  Hold'em No Limit (€0.01/€0.02) - 2025/08/22 10:18:24 CET [2025/08/22 4:18:24 ET]
Table 'Arneb' 6-max Seat #1 is the button
Seat 1: pipinoelbreve9 (€2.57 in chips) 
Seat 2: Danipro178 (€2.85 in chips) 
Seat 3: FELIPE439 (€1.70 in chips) 
Seat 4: Ctr Alt Surp (€6.16 in chips) 
Seat 5: Figas89 (€5.29 in chips) 
Seat 6: sukocash (€1.98 in chips) 
Danipro178: posts small blind €0.01
FELIPE439: posts big blind €0.02
*** HOLE CARDS ***
Dealt to pipinoelbreve9 [5c 7s]
Ctr Alt Surp: raises €0.04 to €0.06
Figas89: folds 
sukocash: folds 
pipinoelbreve9: folds 
Danipro178: folds 
FELIPE439: folds 
Uncalled bet (€0.04) returned to Ctr Alt Surp
Ctr Alt Surp collected €0.05 from pot
Ctr Alt Surp: doesn't show hand 
*** SUMMARY ***
Total pot €0.05 | Rake €0 
Seat 1: pipinoelbreve9 (button) folded before Flop (didn't bet)
Seat 2: Danipro178 (small blind) folded before Flop
Seat 3: FELIPE439 (big blind) folded before Flop
Seat 4: Ctr Alt Surp collected (€0.05)
Seat 5: Figas89 folded before Flop (didn't bet)
Seat 6: sukocash folded before Flop (didn't bet)



PokerStars Zoom Hand #257438843488:  Hold'em No Limit (€0.01/€0.02) - 2025/08/22 10:18:18 CET [2025/08/22 4:18:18 ET]
Table 'Arneb' 6-max Seat #1 is the button
Seat 1: JENOFONTE73 (€3.95 in chips) 
Seat 2: pipinoelbreve9 (€2.58 in chips) 
Seat 3: kombei63 (€1.89 in chips) 
Seat 4: titinantet (€2.23 in chips) 
Seat 5: FELIPE439 (€1.70 in chips) 
Seat 6: konkrettrec (€1.60 in chips) 
pipinoelbreve9: posts small blind €0.01
kombei63: posts big blind €0.02
*** HOLE CARDS ***
Dealt to pipinoelbreve9 [Ks 4c]
titinantet: folds 
FELIPE439: folds 
konkrettrec: calls €0.02
JENOFONTE73: folds 
pipinoelbreve9: folds 
kombei63: checks 
*** FLOP *** [2h 9c 8h]
kombei63: checks 
konkrettrec: checks 
*** TURN *** [2h 9c 8h] [Tc]
kombei63: checks 
konkrettrec: bets €0.02
kombei63: folds 
Uncalled bet (€0.02) returned to konkrettrec
konkrettrec collected €0.05 from pot
konkrettrec: doesn't show hand 
*** SUMMARY ***
Total pot €0.05 | Rake €0 
Board [2h 9c 8h Tc]
Seat 1: JENOFONTE73 (button) folded before Flop (didn't bet)
Seat 2: pipinoelbreve9 (small blind) folded before Flop
Seat 3: kombei63 (big blind) folded on the Turn
Seat 4: titinantet folded before Flop (didn't bet)
Seat 5: FELIPE439 folded before Flop (didn't bet)
Seat 6: konkrettrec collected (€0.05)



PokerStars Zoom Hand #257438845419:  Hold'em No Limit (€0.01/€0.02) - 2025/08/22 10:18:44 CET [2025/08/22 4:18:44 ET]
Table 'Arneb' 6-max Seat #1 is the button
Seat 1: titinantet (€2.19 in chips) 
Seat 2: hernandS&G (€2.26 in chips) 
Seat 3: Figas89 (€5.29 in chips) 
Seat 4: JENOFONTE73 (€3.94 in chips) 
Seat 5: 77samuel33 (€2 in chips) 
Seat 6: pipinoelbreve9 (€2.55 in chips) 
hernandS&G: posts small blind €0.01
Figas89: posts big blind €0.02
*** HOLE CARDS ***
Dealt to pipinoelbreve9 [7c Kd]
JENOFONTE73: folds 
77samuel33: folds 
pipinoelbreve9: folds 
titinantet: folds 
hernandS&G: folds 
Uncalled bet (€0.01) returned to Figas89
Figas89 collected €0.02 from pot
Figas89: doesn't show hand 
*** SUMMARY ***
Total pot €0.02 | Rake €0 
Seat 1: titinantet (button) folded before Flop (didn't bet)
Seat 2: hernandS&G (small blind) folded before Flop
Seat 3: Figas89 (big blind) collected (€0.02)
Seat 4: JENOFONTE73 folded before Flop (didn't bet)
Seat 5: 77samuel33 folded before Flop (didn't bet)
Seat 6: pipinoelbreve9 folded before Flop (didn't bet)



PokerStars Zoom Hand #257438844642:  Hold'em No Limit (€0.01/€0.02) - 2025/08/22 10:18:34 CET [2025/08/22 4:18:34 ET]
Table 'Arneb' 6-max Seat #1 is the button
Seat 1: axcom69 (€2.02 in chips) 
Seat 2: charlyleon92 (€1.29 in chips) 
Seat 3: pipinoelbreve9 (€2.57 in chips) 
Seat 4: kombei63 (€1.17 in chips) 
Seat 5: nometoquesloshu (€2.62 in chips) 
Seat 6: davidelgnomo747 (€0.65 in chips) 
charlyleon92: posts small blind €0.01
pipinoelbreve9: posts big blind €0.02
*** HOLE CARDS ***
Dealt to pipinoelbreve9 [7c Ts]
kombei63: folds 
nometoquesloshu: folds 
davidelgnomo747: folds 
axcom69: raises €0.02 to €0.04
charlyleon92: calls €0.03
pipinoelbreve9: folds 
*** FLOP *** [8d Ad 6h]
charlyleon92: checks 
axcom69: bets €0.10
charlyleon92: calls €0.10
*** TURN *** [8d Ad 6h] [Jc]
charlyleon92: checks 
axcom69: checks 
*** RIVER *** [8d Ad 6h Jc] [Ac]
charlyleon92: checks 
axcom69: bets €0.14
charlyleon92: calls €0.14
*** SHOW DOWN ***
axcom69: shows [7s Td] (a pair of Aces)
charlyleon92: shows [Jh 9h] (two pair, Aces and Jacks)
charlyleon92 collected €0.55 from pot
*** SUMMARY ***
Total pot €0.58 | Rake €0.03 
Board [8d Ad 6h Jc Ac]
Seat 1: axcom69 (button) showed [7s Td] and lost with a pair of Aces
Seat 2: charlyleon92 (small blind) showed [Jh 9h] and won (€0.55) with two pair, Aces and Jacks
Seat 3: pipinoelbreve9 (big blind) folded before Flop
Seat 4: kombei63 folded before Flop (didn't bet)
Seat 5: nometoquesloshu folded before Flop (didn't bet)
Seat 6: davidelgnomo747 folded before Flop (didn't bet)



PokerStars Zoom Hand #257438843077:  Hold'em No Limit (€0.01/€0.02) - 2025/08/22 10:18:13 CET [2025/08/22 4:18:13 ET]
Table 'Arneb' 6-max Seat #1 is the button
Seat 1: FELIPE439 (€2.24 in chips) 
Seat 2: sukocash (€1.98 in chips) 
Seat 3: POUPIOU65 (€1.11 in chips) 
Seat 4: pipinoelbreve9 (€2.58 in chips) 
Seat 5: kombei63 (€1.16 in chips) 
Seat 6: JENOFONTE73 (€3.95 in chips) 
sukocash: posts small blind €0.01
POUPIOU65: posts big blind €0.02
*** HOLE CARDS ***
Dealt to pipinoelbreve9 [4c 7d]
pipinoelbreve9: folds 
kombei63: folds 
JENOFONTE73: folds 
FELIPE439: raises €0.04 to €0.06
sukocash: folds 
POUPIOU65: calls €0.04
*** FLOP *** [2h Jc Qh]
POUPIOU65: checks 
FELIPE439: bets €0.12
POUPIOU65: calls €0.12
*** TURN *** [2h Jc Qh] [5s]
POUPIOU65: checks 
FELIPE439: checks 
*** RIVER *** [2h Jc Qh 5s] [8h]
POUPIOU65: checks 
FELIPE439: bets €0.18
POUPIOU65: folds 
Uncalled bet (€0.18) returned to FELIPE439
FELIPE439 collected €0.35 from pot
FELIPE439: doesn't show hand 
*** SUMMARY ***
Total pot €0.37 | Rake €0.02 
Board [2h Jc Qh 5s 8h]
Seat 1: FELIPE439 (button) collected (€0.35)
Seat 2: sukocash (small blind) folded before Flop
Seat 3: POUPIOU65 (big blind) folded on the River
Seat 4: pipinoelbreve9 folded before Flop (didn't bet)
Seat 5: kombei63 folded before Flop (didn't bet)
Seat 6: JENOFONTE73 folded before Flop (didn't bet)



PokerStars Zoom Hand #257438845915:  Hold'em No Limit (€0.01/€0.02) - 2025/08/22 10:18:51 CET [2025/08/22 4:18:51 ET]
Table 'Arneb' 6-max Seat #1 is the button
Seat 1: sukocash (€2 in chips) 
Seat 2: titinantet (€2.19 in chips) 
Seat 3: JENOFONTE73 (€3.94 in chips) 
Seat 4: SmOuL123 (€1.89 in chips) 
Seat 5: pipinoelbreve9 (€2.55 in chips) 
Seat 6: nometoquesloshu (€2.60 in chips) 
titinantet: posts small blind €0.01
JENOFONTE73: posts big blind €0.02
*** HOLE CARDS ***
Dealt to pipinoelbreve9 [4h Kc]
SmOuL123: calls €0.02
pipinoelbreve9: folds 
nometoquesloshu: folds 
sukocash: folds 
titinantet: folds 
JENOFONTE73: checks 
*** FLOP *** [2c 5s 8d]
JENOFONTE73: checks 
SmOuL123: checks 
*** TURN *** [2c 5s 8d] [Qh]
JENOFONTE73: checks 
SmOuL123: checks 
*** RIVER *** [2c 5s 8d Qh] [2h]
JENOFONTE73: checks 
SmOuL123: checks 
*** SHOW DOWN ***
JENOFONTE73: shows [9d 3s] (a pair of Deuces)
SmOuL123: shows [Jd As] (a pair of Deuces - Ace kicker)
SmOuL123 collected €0.05 from pot
*** SUMMARY ***
Total pot €0.05 | Rake €0 
Board [2c 5s 8d Qh 2h]
Seat 1: sukocash (button) folded before Flop (didn't bet)
Seat 2: titinantet (small blind) folded before Flop
Seat 3: JENOFONTE73 (big blind) showed [9d 3s] and lost with a pair of Deuces
Seat 4: SmOuL123 showed [Jd As] and won (€0.05) with a pair of Deuces
Seat 5: pipinoelbreve9 folded before Flop (didn't bet)
Seat 6: nometoquesloshu folded before Flop (didn't bet)



PokerStars Zoom Hand #257438846612:  Hold'em No Limit (€0.01/€0.02) - 2025/08/22 10:19:00 CET [2025/08/22 4:19:00 ET]
Table 'Arneb' 6-max Seat #1 is the button
Seat 1: pipinoelbreve9 (€2.55 in chips) 
Seat 2: konkrettrec (€1.64 in chips) 
Seat 3: charlyleon92 (€1.85 in chips) 
Seat 4: nometoquesloshu (€2.60 in chips) 
Seat 5: crissstal (€1.36 in chips) 
Seat 6: ShardeRR (€2.26 in chips) 
konkrettrec: posts small blind €0.01
charlyleon92: posts big blind €0.02
*** HOLE CARDS ***
Dealt to pipinoelbreve9 [6d 7c]
nometoquesloshu: folds 
crissstal: folds 
ShardeRR: folds 
pipinoelbreve9: folds 
konkrettrec: calls €0.01
charlyleon92: checks 
*** FLOP *** [2c As 7h]
konkrettrec: checks 
charlyleon92: bets €0.04
konkrettrec: folds 
Uncalled bet (€0.04) returned to charlyleon92
charlyleon92 collected €0.04 from pot
charlyleon92: doesn't show hand 
*** SUMMARY ***
Total pot €0.04 | Rake €0 
Board [2c As 7h]
Seat 1: pipinoelbreve9 (button) folded before Flop (didn't bet)
Seat 2: konkrettrec (small blind) folded on the Flop
Seat 3: charlyleon92 (big blind) collected (€0.04)
Seat 4: nometoquesloshu folded before Flop (didn't bet)
Seat 5: crissstal folded before Flop (didn't bet)
Seat 6: ShardeRR folded before Flop (didn't bet)



PokerStars Zoom Hand #257438847094:  Hold'em No Limit (€0.01/€0.02) - 2025/08/22 10:19:07 CET [2025/08/22 4:19:07 ET]
Table 'Arneb' 6-max Seat #1 is the button
Seat 1: 34Sirina (€0.93 in chips) 
Seat 2: pipinoelbreve9 (€2.55 in chips) 
Seat 3: nometoquesloshu (€2.60 in chips) 
Seat 4: Figas89 (€2.62 in chips) 
Seat 5: sukocash (€1.98 in chips) 
Seat 6: kombei63 (€1.19 in chips) 
pipinoelbreve9: posts small blind €0.01
nometoquesloshu: posts big blind €0.02
*** HOLE CARDS ***
Dealt to pipinoelbreve9 [6c 6h]
Figas89: folds 
sukocash: folds 
kombei63: folds 
34Sirina: folds 
pipinoelbreve9: raises €0.04 to €0.06
nometoquesloshu: calls €0.04
*** FLOP *** [6s 3d Qc]
pipinoelbreve9: bets €0.04
nometoquesloshu: folds 
Uncalled bet (€0.04) returned to pipinoelbreve9
pipinoelbreve9 collected €0.11 from pot
pipinoelbreve9: doesn't show hand 
*** SUMMARY ***
Total pot €0.12 | Rake €0.01 
Board [6s 3d Qc]
Seat 1: 34Sirina (button) folded before Flop (didn't bet)
Seat 2: pipinoelbreve9 (small blind) collected (€0.11)
Seat 3: nometoquesloshu (big blind) folded on the Flop
Seat 4: Figas89 folded before Flop (didn't bet)
Seat 5: sukocash folded before Flop (didn't bet)
Seat 6: kombei63 folded before Flop (didn't bet)



PokerStars Zoom Hand #257438846392:  Hold'em No Limit (€0.01/€0.02) - 2025/08/22 10:18:57 CET [2025/08/22 4:18:57 ET]
Table 'Arneb' 6-max Seat #1 is the button
Seat 1: sukocash (€2.14 in chips) 
Seat 2: eres_tontito (€1.87 in chips) 
Seat 3: pera6521 (€2 in chips) 
Seat 4: Danipro178 (€2.84 in chips) 
Seat 5: pipinoelbreve9 (€2.55 in chips) 
Seat 6: Figas89 (€2.30 in chips) 
eres_tontito: posts small blind €0.01
pera6521: posts big blind €0.02
*** HOLE CARDS ***
Dealt to pipinoelbreve9 [3c Qs]
Danipro178: raises €0.04 to €0.06
pipinoelbreve9: folds 
Figas89: folds 
sukocash: folds 
eres_tontito: folds 
pera6521: calls €0.04
*** FLOP *** [Jh 6c 2h]
pera6521: checks 
Danipro178: bets €0.04
pera6521: folds 
Uncalled bet (€0.04) returned to Danipro178
Danipro178 collected €0.12 from pot
Danipro178: doesn't show hand 
*** SUMMARY ***
Total pot €0.13 | Rake €0.01 
Board [Jh 6c 2h]
Seat 1: sukocash (button) folded before Flop (didn't bet)
Seat 2: eres_tontito (small blind) folded before Flop
Seat 3: pera6521 (big blind) folded on the Flop
Seat 4: Danipro178 collected (€0.12)
Seat 5: pipinoelbreve9 folded before Flop (didn't bet)
Seat 6: Figas89 folded before Flop (didn't bet)



PokerStars Zoom Hand #257438848504:  Hold'em No Limit (€0.01/€0.02) - 2025/08/22 10:19:26 CET [2025/08/22 4:19:26 ET]
Table 'Arneb' 6-max Seat #1 is the button
Seat 1: mikpepra (€1.13 in chips) 
Seat 2: JENOFONTE73 (€2.72 in chips) 
Seat 3: pipinoelbreve9 (€2.60 in chips) 
Seat 4: pera6521 (€2 in chips) 
Seat 5: Figas89 (€2.29 in chips) 
Seat 6: kombei63 (€1.84 in chips) 
JENOFONTE73: posts small blind €0.01
pipinoelbreve9: posts big blind €0.02
*** HOLE CARDS ***
Dealt to pipinoelbreve9 [3s 3c]
pera6521: folds 
Figas89: folds 
kombei63: folds 
mikpepra: folds 
JENOFONTE73: raises €0.03 to €0.05
pipinoelbreve9: calls €0.03
*** FLOP *** [Th Tc 4s]
JENOFONTE73: bets €0.05
pipinoelbreve9: calls €0.05
*** TURN *** [Th Tc 4s] [Qc]
JENOFONTE73: checks 
pipinoelbreve9: checks 
*** RIVER *** [Th Tc 4s Qc] [8c]
JENOFONTE73: bets €0.10
pipinoelbreve9: calls €0.10
*** SHOW DOWN ***
JENOFONTE73: shows [Ad 8d] (two pair, Tens and Eights)
pipinoelbreve9: mucks hand 
JENOFONTE73 collected €0.38 from pot
*** SUMMARY ***
Total pot €0.40 | Rake €0.02 
Board [Th Tc 4s Qc 8c]
Seat 1: mikpepra (button) folded before Flop (didn't bet)
Seat 2: JENOFONTE73 (small blind) showed [Ad 8d] and won (€0.38) with two pair, Tens and Eights
Seat 3: pipinoelbreve9 (big blind) mucked [3s 3c]
Seat 4: pera6521 folded before Flop (didn't bet)
Seat 5: Figas89 folded before Flop (didn't bet)
Seat 6: kombei63 folded before Flop (didn't bet)



PokerStars Zoom Hand #257438851782:  Hold'em No Limit (€0.01/€0.02) - 2025/08/22 10:20:11 CET [2025/08/22 4:20:11 ET]
Table 'Arneb' 6-max Seat #1 is the button
Seat 1: FELIPE439 (€1.91 in chips) 
Seat 2: pera6521 (€1.98 in chips) 
Seat 3: eres_tontito (€2.12 in chips) 
Seat 4: Danipro178 (€2.02 in chips) 
Seat 5: fallingredstar (€2.01 in chips) 
Seat 6: pipinoelbreve9 (€2.40 in chips) 
pera6521: posts small blind €0.01
eres_tontito: posts big blind €0.02
*** HOLE CARDS ***
Dealt to pipinoelbreve9 [Ks 4s]
Danipro178: folds 
fallingredstar: folds 
pipinoelbreve9: folds 
FELIPE439: folds 
pera6521: folds 
Uncalled bet (€0.01) returned to eres_tontito
eres_tontito collected €0.02 from pot
eres_tontito: doesn't show hand 
*** SUMMARY ***
Total pot €0.02 | Rake €0 
Seat 1: FELIPE439 (button) folded before Flop (didn't bet)
Seat 2: pera6521 (small blind) folded before Flop
Seat 3: eres_tontito (big blind) collected (€0.02)
Seat 4: Danipro178 folded before Flop (didn't bet)
Seat 5: fallingredstar folded before Flop (didn't bet)
Seat 6: pipinoelbreve9 folded before Flop (didn't bet)



PokerStars Zoom Hand #257438851503:  Hold'em No Limit (€0.01/€0.02) - 2025/08/22 10:20:07 CET [2025/08/22 4:20:07 ET]
Table 'Arneb' 6-max Seat #1 is the button
Seat 1: smoking9000 (€1.06 in chips) 
Seat 2: charlyleon92 (€1.50 in chips) 
Seat 3: eres_tontito (€2 in chips) 
Seat 4: pipinoelbreve9 (€2.40 in chips) 
Seat 5: cruass (€2.12 in chips) 
Seat 6: nometoquesloshu (€2.50 in chips) 
charlyleon92: posts small blind €0.01
eres_tontito: posts big blind €0.02
*** HOLE CARDS ***
Dealt to pipinoelbreve9 [5s 3d]
pipinoelbreve9: folds 
cruass: folds 
nometoquesloshu: folds 
smoking9000: folds 
charlyleon92: raises €0.04 to €0.06
eres_tontito: calls €0.04
*** FLOP *** [Ac 8h Kc]
charlyleon92: checks 
eres_tontito: checks 
*** TURN *** [Ac 8h Kc] [9h]
charlyleon92: checks 
eres_tontito: bets €0.07
charlyleon92: folds 
Uncalled bet (€0.07) returned to eres_tontito
eres_tontito collected €0.11 from pot
eres_tontito: doesn't show hand 
*** SUMMARY ***
Total pot €0.12 | Rake €0.01 
Board [Ac 8h Kc 9h]
Seat 1: smoking9000 (button) folded before Flop (didn't bet)
Seat 2: charlyleon92 (small blind) folded on the Turn
Seat 3: eres_tontito (big blind) collected (€0.11)
Seat 4: pipinoelbreve9 folded before Flop (didn't bet)
Seat 5: cruass folded before Flop (didn't bet)
Seat 6: nometoquesloshu folded before Flop (didn't bet)



PokerStars Zoom Hand #257438852674:  Hold'em No Limit (€0.01/€0.02) - 2025/08/22 10:20:23 CET [2025/08/22 4:20:23 ET]
Table 'Arneb' 6-max Seat #1 is the button
Seat 1: HALKIM2001 (€1.98 in chips) 
Seat 2: SirDerius (€2.74 in chips) 
Seat 3: FELIPE439 (€3.27 in chips) 
Seat 4: 77samuel33 (€2 in chips) 
Seat 5: charlyleon92 (€2.02 in chips) 
Seat 6: pipinoelbreve9 (€2.39 in chips) 
SirDerius: posts small blind €0.01
FELIPE439: posts big blind €0.02
*** HOLE CARDS ***
Dealt to pipinoelbreve9 [Td 8s]
77samuel33: folds 
charlyleon92: folds 
pipinoelbreve9: folds 
HALKIM2001: folds 
SirDerius: folds 
Uncalled bet (€0.01) returned to FELIPE439
FELIPE439 collected €0.02 from pot
FELIPE439: doesn't show hand 
*** SUMMARY ***
Total pot €0.02 | Rake €0 
Seat 1: HALKIM2001 (button) folded before Flop (didn't bet)
Seat 2: SirDerius (small blind) folded before Flop
Seat 3: FELIPE439 (big blind) collected (€0.02)
Seat 4: 77samuel33 folded before Flop (didn't bet)
Seat 5: charlyleon92 folded before Flop (didn't bet)
Seat 6: pipinoelbreve9 folded before Flop (didn't bet)



PokerStars Zoom Hand #257438852177:  Hold'em No Limit (€0.01/€0.02) - 2025/08/22 10:20:16 CET [2025/08/22 4:20:16 ET]
Table 'Arneb' 6-max Seat #1 is the button
Seat 1: nometoquesloshu (€2.50 in chips) 
Seat 2: pipinoelbreve9 (€2.40 in chips) 
Seat 3: hernandS&G (€2.37 in chips) 
Seat 4: sukocash (€2 in chips) 
Seat 5: 34Sirina (€0.77 in chips) 
Seat 6: fallingredstar (€2.01 in chips) 
pipinoelbreve9: posts small blind €0.01
hernandS&G: posts big blind €0.02
*** HOLE CARDS ***
Dealt to pipinoelbreve9 [3d Qs]
sukocash: folds 
34Sirina: calls €0.02
fallingredstar: folds 
nometoquesloshu: folds 
pipinoelbreve9: folds 
hernandS&G: checks 
*** FLOP *** [6d 8s 8d]
hernandS&G: checks 
34Sirina: checks 
*** TURN *** [6d 8s 8d] [Jh]
hernandS&G: bets €0.03
34Sirina: folds 
Uncalled bet (€0.03) returned to hernandS&G
hernandS&G collected €0.05 from pot
hernandS&G: doesn't show hand 
*** SUMMARY ***
Total pot €0.05 | Rake €0 
Board [6d 8s 8d Jh]
Seat 1: nometoquesloshu (button) folded before Flop (didn't bet)
Seat 2: pipinoelbreve9 (small blind) folded before Flop
Seat 3: hernandS&G (big blind) collected (€0.05)
Seat 4: sukocash folded before Flop (didn't bet)
Seat 5: 34Sirina folded on the Turn
Seat 6: fallingredstar folded before Flop (didn't bet)



PokerStars Zoom Hand #257438853797:  Hold'em No Limit (€0.01/€0.02) - 2025/08/22 10:20:39 CET [2025/08/22 4:20:39 ET]
Table 'Arneb' 6-max Seat #1 is the button
Seat 1: 77samuel33 (€2 in chips) 
Seat 2: fallingredstar (€2.01 in chips) 
Seat 3: Danipro178 (€2.01 in chips) 
Seat 4: pipinoelbreve9 (€2.39 in chips) 
Seat 5: paul20025 (€1.09 in chips) 
Seat 6: ShardeRR (€2 in chips) 
fallingredstar: posts small blind €0.01
Danipro178: posts big blind €0.02
*** HOLE CARDS ***
Dealt to pipinoelbreve9 [Qh 5s]
pipinoelbreve9: folds 
paul20025: folds 
ShardeRR: raises €0.04 to €0.06
77samuel33: folds 
fallingredstar: folds 
Danipro178: folds 
Uncalled bet (€0.04) returned to ShardeRR
ShardeRR collected €0.05 from pot
ShardeRR: doesn't show hand 
*** SUMMARY ***
Total pot €0.05 | Rake €0 
Seat 1: 77samuel33 (button) folded before Flop (didn't bet)
Seat 2: fallingredstar (small blind) folded before Flop
Seat 3: Danipro178 (big blind) folded before Flop
Seat 4: pipinoelbreve9 folded before Flop (didn't bet)
Seat 5: paul20025 folded before Flop (didn't bet)
Seat 6: ShardeRR collected (€0.05)



PokerStars Zoom Hand #257438854151:  Hold'em No Limit (€0.01/€0.02) - 2025/08/22 10:20:43 CET [2025/08/22 4:20:43 ET]
Table 'Arneb' 6-max Seat #1 is the button
Seat 1: pera6521 (€2 in chips) 
Seat 2: eres_tontito (€1.89 in chips) 
Seat 3: pipinoelbreve9 (€2.39 in chips) 
Seat 4: fallingredstar (€2 in chips) 
Seat 5: paul20025 (€1.09 in chips) 
Seat 6: FELIPE439 (€1.91 in chips) 
eres_tontito: posts small blind €0.01
pipinoelbreve9: posts big blind €0.02
*** HOLE CARDS ***
Dealt to pipinoelbreve9 [6s Qc]
fallingredstar: folds 
paul20025: folds 
FELIPE439: folds 
pera6521: folds 
eres_tontito: raises €0.04 to €0.06
pipinoelbreve9: folds 
Uncalled bet (€0.04) returned to eres_tontito
eres_tontito collected €0.04 from pot
eres_tontito: doesn't show hand 
*** SUMMARY ***
Total pot €0.04 | Rake €0 
Seat 1: pera6521 (button) folded before Flop (didn't bet)
Seat 2: eres_tontito (small blind) collected (€0.04)
Seat 3: pipinoelbreve9 (big blind) folded before Flop
Seat 4: fallingredstar folded before Flop (didn't bet)
Seat 5: paul20025 folded before Flop (didn't bet)
Seat 6: FELIPE439 folded before Flop (didn't bet)



PokerStars Zoom Hand #257438855149:  Hold'em No Limit (€0.01/€0.02) - 2025/08/22 10:20:56 CET [2025/08/22 4:20:56 ET]
Table 'Arneb' 6-max Seat #1 is the button
Seat 1: JENOFONTE73 (€2.86 in chips) 
Seat 2: ShardeRR (€2.11 in chips) 
Seat 3: eres_tontito (€2.13 in chips) 
Seat 4: sukocash (€2.01 in chips) 
Seat 5: pipinoelbreve9 (€2.37 in chips) 
Seat 6: 77samuel33 (€2 in chips) 
ShardeRR: posts small blind €0.01
eres_tontito: posts big blind €0.02
*** HOLE CARDS ***
Dealt to pipinoelbreve9 [Ah 3h]
sukocash: folds 
pipinoelbreve9: raises €0.04 to €0.06
77samuel33: folds 
JENOFONTE73: folds 
ShardeRR: folds 
eres_tontito: folds 
Uncalled bet (€0.04) returned to pipinoelbreve9
pipinoelbreve9 collected €0.05 from pot
pipinoelbreve9: doesn't show hand 
*** SUMMARY ***
Total pot €0.05 | Rake €0 
Seat 1: JENOFONTE73 (button) folded before Flop (didn't bet)
Seat 2: ShardeRR (small blind) folded before Flop
Seat 3: eres_tontito (big blind) folded before Flop
Seat 4: sukocash folded before Flop (didn't bet)
Seat 5: pipinoelbreve9 collected (€0.05)
Seat 6: 77samuel33 folded before Flop (didn't bet)



PokerStars Zoom Hand #257438853445:  Hold'em No Limit (€0.01/€0.02) - 2025/08/22 10:20:34 CET [2025/08/22 4:20:34 ET]
Table 'Arneb' 6-max Seat #1 is the button
Seat 1: pipinoelbreve9 (€2.39 in chips) 
Seat 2: eres_tontito (€2.05 in chips) 
Seat 3: JENOFONTE73 (€3.34 in chips) 
Seat 4: Danipro178 (€2.01 in chips) 
Seat 5: sukocash (€2.03 in chips) 
Seat 6: ShardeRR (€2 in chips) 
eres_tontito: posts small blind €0.01
JENOFONTE73: posts big blind €0.02
*** HOLE CARDS ***
Dealt to pipinoelbreve9 [7d Td]
Danipro178: folds 
sukocash: folds 
ShardeRR: folds 
pipinoelbreve9: folds 
eres_tontito: raises €0.02 to €0.04
JENOFONTE73: calls €0.02
*** FLOP *** [7c 8c 4d]
eres_tontito: bets €0.02
JENOFONTE73: calls €0.02
*** TURN *** [7c 8c 4d] [9s]
eres_tontito: bets €0.02
JENOFONTE73: raises €0.08 to €0.10
eres_tontito: folds 
Uncalled bet (€0.08) returned to JENOFONTE73
JENOFONTE73 collected €0.15 from pot
JENOFONTE73: doesn't show hand 
*** SUMMARY ***
Total pot €0.16 | Rake €0.01 
Board [7c 8c 4d 9s]
Seat 1: pipinoelbreve9 (button) folded before Flop (didn't bet)
Seat 2: eres_tontito (small blind) folded on the Turn
Seat 3: JENOFONTE73 (big blind) collected (€0.15)
Seat 4: Danipro178 folded before Flop (didn't bet)
Seat 5: sukocash folded before Flop (didn't bet)
Seat 6: ShardeRR folded before Flop (didn't bet)



PokerStars Zoom Hand #257438855991:  Hold'em No Limit (€0.01/€0.02) - 2025/08/22 10:21:08 CET [2025/08/22 4:21:08 ET]
Table 'Arneb' 6-max Seat #1 is the button
Seat 1: StrangeNoumena (€2.29 in chips) 
Seat 2: FELIPE439 (€1.82 in chips) 
Seat 3: eres_tontito (€1.91 in chips) 
Seat 4: charlyleon92 (€2 in chips) 
Seat 5: pipinoelbreve9 (€2.40 in chips) 
Seat 6: hernandS&G (€2.86 in chips) 
FELIPE439: posts small blind €0.01
eres_tontito: posts big blind €0.02
*** HOLE CARDS ***
Dealt to pipinoelbreve9 [Qd 5c]
charlyleon92: folds 
pipinoelbreve9: folds 
hernandS&G: raises €0.04 to €0.06
StrangeNoumena: folds 
FELIPE439: folds 
eres_tontito: folds 
Uncalled bet (€0.04) returned to hernandS&G
hernandS&G collected €0.05 from pot
hernandS&G: doesn't show hand 
*** SUMMARY ***
Total pot €0.05 | Rake €0 
Seat 1: StrangeNoumena (button) folded before Flop (didn't bet)
Seat 2: FELIPE439 (small blind) folded before Flop
Seat 3: eres_tontito (big blind) folded before Flop
Seat 4: charlyleon92 folded before Flop (didn't bet)
Seat 5: pipinoelbreve9 folded before Flop (didn't bet)
Seat 6: hernandS&G collected (€0.05)



PokerStars Zoom Hand #257438856390:  Hold'em No Limit (€0.01/€0.02) - 2025/08/22 10:21:13 CET [2025/08/22 4:21:13 ET]
Table 'Arneb' 6-max Seat #1 is the button
Seat 1: Danipro178 (€2.03 in chips) 
Seat 2: pipinoelbreve9 (€2.40 in chips) 
Seat 3: ShardeRR (€2.10 in chips) 
Seat 4: nometoquesloshu (€2.43 in chips) 
Seat 5: SmOuL123 (€1.78 in chips) 
Seat 6: sukocash (€2 in chips) 
pipinoelbreve9: posts small blind €0.01
ShardeRR: posts big blind €0.02
*** HOLE CARDS ***
Dealt to pipinoelbreve9 [Tc Qc]
nometoquesloshu: raises €0.04 to €0.06
SmOuL123: calls €0.06
sukocash: folds 
Danipro178: folds 
pipinoelbreve9: calls €0.05
ShardeRR: folds 
*** FLOP *** [Jh 4s 6c]
pipinoelbreve9: checks 
nometoquesloshu: checks 
SmOuL123: checks 
*** TURN *** [Jh 4s 6c] [2h]
pipinoelbreve9: checks 
nometoquesloshu: checks 
SmOuL123: checks 
*** RIVER *** [Jh 4s 6c 2h] [Js]
pipinoelbreve9: checks 
nometoquesloshu: checks 
SmOuL123: checks 
*** SHOW DOWN ***
pipinoelbreve9: shows [Tc Qc] (a pair of Jacks)
nometoquesloshu: shows [Qs Td] (a pair of Jacks)
SmOuL123: shows [8s Ad] (a pair of Jacks - Ace kicker)
SmOuL123 collected €0.19 from pot
*** SUMMARY ***
Total pot €0.20 | Rake €0.01 
Board [Jh 4s 6c 2h Js]
Seat 1: Danipro178 (button) folded before Flop (didn't bet)
Seat 2: pipinoelbreve9 (small blind) showed [Tc Qc] and lost with a pair of Jacks
Seat 3: ShardeRR (big blind) folded before Flop
Seat 4: nometoquesloshu showed [Qs Td] and lost with a pair of Jacks
Seat 5: SmOuL123 showed [8s Ad] and won (€0.19) with a pair of Jacks
Seat 6: sukocash folded before Flop (didn't bet)



PokerStars Zoom Hand #257438912676:  Hold'em No Limit (€0.01/€0.02) - 2025/08/22 10:33:33 CET [2025/08/22 4:33:33 ET]
Table 'Arneb' 6-max Seat #1 is the button
Seat 1: Encina 99 (€3.67 in chips) 
Seat 2: pipinoelbreve9 (€2.32 in chips) 
Seat 3: pera6521 (€2.02 in chips) 
Seat 4: crissstal (€1.37 in chips) 
Seat 5: 34Sirina (€0.79 in chips) 
Seat 6: MDKristian (€2 in chips) 
pipinoelbreve9: posts small blind €0.01
pera6521: posts big blind €0.02
*** HOLE CARDS ***
Dealt to pipinoelbreve9 [Jc Td]
crissstal: folds 
34Sirina: folds 
MDKristian: folds 
Encina 99: raises €0.02 to €0.04
pipinoelbreve9: folds 
pera6521: calls €0.02
*** FLOP *** [8d 2h 6h]
pera6521: checks 
Encina 99: bets €0.05
pera6521: folds 
Uncalled bet (€0.05) returned to Encina 99
Encina 99 collected €0.09 from pot
Encina 99: doesn't show hand 
*** SUMMARY ***
Total pot €0.09 | Rake €0 
Board [8d 2h 6h]
Seat 1: Encina 99 (button) collected (€0.09)
Seat 2: pipinoelbreve9 (small blind) folded before Flop
Seat 3: pera6521 (big blind) folded on the Flop
Seat 4: crissstal folded before Flop (didn't bet)
Seat 5: 34Sirina folded before Flop (didn't bet)
Seat 6: MDKristian folded before Flop (didn't bet)



PokerStars Zoom Hand #257438912184:  Hold'em No Limit (€0.01/€0.02) - 2025/08/22 10:33:27 CET [2025/08/22 4:33:27 ET]
Table 'Arneb' 6-max Seat #1 is the button
Seat 1: MDKristian (€2.01 in chips) 
Seat 2: PSCL61 (€2.06 in chips) 
Seat 3: pipinoelbreve9 (€2.34 in chips) 
Seat 4: XXILuv (€2 in chips) 
Seat 5: Cactus54130 (€1.01 in chips) 
Seat 6: paul20025 (€1.05 in chips) 
PSCL61: posts small blind €0.01
pipinoelbreve9: posts big blind €0.02
*** HOLE CARDS ***
Dealt to pipinoelbreve9 [9d 5s]
XXILuv: folds 
Cactus54130: raises €0.02 to €0.04
paul20025: raises €0.02 to €0.06
MDKristian: folds 
PSCL61: folds 
pipinoelbreve9: folds 
Cactus54130: calls €0.02
*** FLOP *** [5c 9c 6h]
Cactus54130: checks 
paul20025: bets €0.10
Cactus54130: calls €0.10
*** TURN *** [5c 9c 6h] [3s]
Cactus54130: checks 
paul20025: bets €0.18
Cactus54130: folds 
Uncalled bet (€0.18) returned to paul20025
paul20025 collected €0.33 from pot
paul20025: doesn't show hand 
*** SUMMARY ***
Total pot €0.35 | Rake €0.02 
Board [5c 9c 6h 3s]
Seat 1: MDKristian (button) folded before Flop (didn't bet)
Seat 2: PSCL61 (small blind) folded before Flop
Seat 3: pipinoelbreve9 (big blind) folded before Flop
Seat 4: XXILuv folded before Flop (didn't bet)
Seat 5: Cactus54130 folded on the Turn
Seat 6: paul20025 collected (€0.33)



PokerStars Zoom Hand #257438912910:  Hold'em No Limit (€0.01/€0.02) - 2025/08/22 10:33:36 CET [2025/08/22 4:33:36 ET]
Table 'Arneb' 6-max Seat #1 is the button
Seat 1: pipinoelbreve9 (€2.31 in chips) 
Seat 2: MDKristian (€2.08 in chips) 
Seat 3: Zbiegnew90 (€2 in chips) 
Seat 4: ReyGuto (€0.46 in chips) 
Seat 5: POUPIOU65 (€1 in chips) 
Seat 6: diarouga (€2 in chips) 
MDKristian: posts small blind €0.01
Zbiegnew90: posts big blind €0.02
*** HOLE CARDS ***
Dealt to pipinoelbreve9 [6d 5d]
ReyGuto: folds 
POUPIOU65: folds 
diarouga: folds 
pipinoelbreve9: raises €0.04 to €0.06
MDKristian: folds 
Zbiegnew90: calls €0.04
*** FLOP *** [2h Qd 7h]
Zbiegnew90: checks 
pipinoelbreve9: bets €0.04
Zbiegnew90: calls €0.04
*** TURN *** [2h Qd 7h] [Ac]
Zbiegnew90: checks 
pipinoelbreve9: checks 
*** RIVER *** [2h Qd 7h Ac] [8c]
Zbiegnew90: bets €0.13
pipinoelbreve9: folds 
Uncalled bet (€0.13) returned to Zbiegnew90
Zbiegnew90 collected €0.20 from pot
Zbiegnew90: doesn't show hand 
*** SUMMARY ***
Total pot €0.21 | Rake €0.01 
Board [2h Qd 7h Ac 8c]
Seat 1: pipinoelbreve9 (button) folded on the River
Seat 2: MDKristian (small blind) folded before Flop
Seat 3: Zbiegnew90 (big blind) collected (€0.20)
Seat 4: ReyGuto folded before Flop (didn't bet)
Seat 5: POUPIOU65 folded before Flop (didn't bet)
Seat 6: diarouga folded before Flop (didn't bet)



PokerStars Zoom Hand #257438915170:  Hold'em No Limit (€0.01/€0.02) - 2025/08/22 10:34:05 CET [2025/08/22 4:34:05 ET]
Table 'Arneb' 6-max Seat #1 is the button
Seat 1: Areny_Sole (€2.75 in chips) 
Seat 2: HALKIM2001 (€3.96 in chips) 
Seat 3: juajord26 (€2 in chips) 
Seat 4: Zbiegnew90 (€2.10 in chips) 
Seat 5: Danipro178 (€4.43 in chips) 
Seat 6: pipinoelbreve9 (€2.21 in chips) 
HALKIM2001: posts small blind €0.01
juajord26: posts big blind €0.02
*** HOLE CARDS ***
Dealt to pipinoelbreve9 [Th 2s]
Zbiegnew90: folds 
Danipro178: raises €0.04 to €0.06
pipinoelbreve9: folds 
Areny_Sole: folds 
HALKIM2001: folds 
juajord26: calls €0.04
*** FLOP *** [8h 9h 9d]
juajord26: bets €0.06
Danipro178: folds 
Uncalled bet (€0.06) returned to juajord26
juajord26 collected €0.12 from pot
juajord26: doesn't show hand 
*** SUMMARY ***
Total pot €0.13 | Rake €0.01 
Board [8h 9h 9d]
Seat 1: Areny_Sole (button) folded before Flop (didn't bet)
Seat 2: HALKIM2001 (small blind) folded before Flop
Seat 3: juajord26 (big blind) collected (€0.12)
Seat 4: Zbiegnew90 folded before Flop (didn't bet)
Seat 5: Danipro178 folded on the Flop
Seat 6: pipinoelbreve9 folded before Flop (didn't bet)



PokerStars Zoom Hand #257438916584:  Hold'em No Limit (€0.01/€0.02) - 2025/08/22 10:34:23 CET [2025/08/22 4:34:23 ET]
Table 'Arneb' 6-max Seat #1 is the button
Seat 1: PSCL61 (€1.93 in chips) 
Seat 2: pipinoelbreve9 (€2.21 in chips) 
Seat 3: diarouga (€2 in chips) 
Seat 4: caroleli10 (€2.09 in chips) 
Seat 5: sukocash (€2.09 in chips) 
Seat 6: MDKristian (€2.12 in chips) 
pipinoelbreve9: posts small blind €0.01
diarouga: posts big blind €0.02
*** HOLE CARDS ***
Dealt to pipinoelbreve9 [5d 2d]
caroleli10: raises €0.04 to €0.06
sukocash: folds 
MDKristian: folds 
PSCL61: folds 
pipinoelbreve9: folds 
diarouga: folds 
Uncalled bet (€0.04) returned to caroleli10
caroleli10 collected €0.05 from pot
caroleli10: doesn't show hand 
*** SUMMARY ***
Total pot €0.05 | Rake €0 
Seat 1: PSCL61 (button) folded before Flop (didn't bet)
Seat 2: pipinoelbreve9 (small blind) folded before Flop
Seat 3: diarouga (big blind) folded before Flop
Seat 4: caroleli10 collected (€0.05)
Seat 5: sukocash folded before Flop (didn't bet)
Seat 6: MDKristian folded before Flop (didn't bet)



PokerStars Zoom Hand #257438916171:  Hold'em No Limit (€0.01/€0.02) - 2025/08/22 10:34:18 CET [2025/08/22 4:34:18 ET]
Table 'Arneb' 6-max Seat #1 is the button
Seat 1: Polandrus (€2.76 in chips) 
Seat 2: caroleli10 (€2.10 in chips) 
Seat 3: boulcheat (€3.70 in chips) 
Seat 4: pipinoelbreve9 (€2.21 in chips) 
Seat 5: crissstal (€1.34 in chips) 
Seat 6: berjanok (€2.03 in chips) 
caroleli10: posts small blind €0.01
boulcheat: posts big blind €0.02
*** HOLE CARDS ***
Dealt to pipinoelbreve9 [2d 6d]
pipinoelbreve9: folds 
crissstal: folds 
berjanok: raises €0.04 to €0.06
Polandrus: folds 
caroleli10: folds 
boulcheat: calls €0.04
*** FLOP *** [4d Ac 7c]
boulcheat: checks 
berjanok: checks 
*** TURN *** [4d Ac 7c] [3s]
boulcheat: checks 
berjanok: checks 
*** RIVER *** [4d Ac 7c 3s] [Th]
boulcheat: checks 
berjanok: checks 
*** SHOW DOWN ***
boulcheat: shows [8d 8s] (a pair of Eights)
berjanok: mucks hand 
boulcheat collected €0.12 from pot
*** SUMMARY ***
Total pot €0.13 | Rake €0.01 
Board [4d Ac 7c 3s Th]
Seat 1: Polandrus (button) folded before Flop (didn't bet)
Seat 2: caroleli10 (small blind) folded before Flop
Seat 3: boulcheat (big blind) showed [8d 8s] and won (€0.12) with a pair of Eights
Seat 4: pipinoelbreve9 folded before Flop (didn't bet)
Seat 5: crissstal folded before Flop (didn't bet)
Seat 6: berjanok mucked [Jh 6h]



PokerStars Zoom Hand #257438917585:  Hold'em No Limit (€0.01/€0.02) - 2025/08/22 10:34:37 CET [2025/08/22 4:34:37 ET]
Table 'Arneb' 6-max Seat #1 is the button
Seat 1: diarouga (€2 in chips) 
Seat 2: Polandrus (€2.78 in chips) 
Seat 3: JENOFONTE73 (€1.80 in chips) 
Seat 4: cruass (€2.99 in chips) 
Seat 5: charlyleon92 (€2.38 in chips) 
Seat 6: pipinoelbreve9 (€2.18 in chips) 
Polandrus: posts small blind €0.01
JENOFONTE73: posts big blind €0.02
*** HOLE CARDS ***
Dealt to pipinoelbreve9 [7d Td]
cruass: folds 
charlyleon92: folds 
pipinoelbreve9: folds 
diarouga: folds 
Polandrus: raises €0.04 to €0.06
JENOFONTE73: folds 
Uncalled bet (€0.04) returned to Polandrus
Polandrus collected €0.04 from pot
Polandrus: doesn't show hand 
*** SUMMARY ***
Total pot €0.04 | Rake €0 
Seat 1: diarouga (button) folded before Flop (didn't bet)
Seat 2: Polandrus (small blind) collected (€0.04)
Seat 3: JENOFONTE73 (big blind) folded before Flop
Seat 4: cruass folded before Flop (didn't bet)
Seat 5: charlyleon92 folded before Flop (didn't bet)
Seat 6: pipinoelbreve9 folded before Flop (didn't bet)



PokerStars Zoom Hand #257438917913:  Hold'em No Limit (€0.01/€0.02) - 2025/08/22 10:34:41 CET [2025/08/22 4:34:41 ET]
Table 'Arneb' 6-max Seat #1 is the button
Seat 1: boulcheat (€3.76 in chips) 
Seat 2: cruass (€2.99 in chips) 
Seat 3: berjanok (€2 in chips) 
Seat 4: olazunai (€2.10 in chips) 
Seat 5: pipinoelbreve9 (€2.18 in chips) 
Seat 6: MDKristian (€2.03 in chips) 
cruass: posts small blind €0.01
berjanok: posts big blind €0.02
*** HOLE CARDS ***
Dealt to pipinoelbreve9 [Td 9h]
olazunai: folds 
pipinoelbreve9: folds 
MDKristian: folds 
boulcheat: folds 
cruass: raises €0.02 to €0.04
berjanok: folds 
Uncalled bet (€0.02) returned to cruass
cruass collected €0.04 from pot
cruass: doesn't show hand 
*** SUMMARY ***
Total pot €0.04 | Rake €0 
Seat 1: boulcheat (button) folded before Flop (didn't bet)
Seat 2: cruass (small blind) collected (€0.04)
Seat 3: berjanok (big blind) folded before Flop
Seat 4: olazunai folded before Flop (didn't bet)
Seat 5: pipinoelbreve9 folded before Flop (didn't bet)
Seat 6: MDKristian folded before Flop (didn't bet)



PokerStars Zoom Hand #257438918221:  Hold'em No Limit (€0.01/€0.02) - 2025/08/22 10:34:45 CET [2025/08/22 4:34:45 ET]
Table 'Arneb' 6-max Seat #1 is the button
Seat 1: pipinoelbreve9 (€2.18 in chips) 
Seat 2: StrangeNoumena (€2.28 in chips) 
Seat 3: MDKristian (€2.03 in chips) 
Seat 4: pera6521 (€2.40 in chips) 
Seat 5: diarouga (€2 in chips) 
Seat 6: boulcheat (€3.76 in chips) 
StrangeNoumena: posts small blind €0.01
MDKristian: posts big blind €0.02
*** HOLE CARDS ***
Dealt to pipinoelbreve9 [9h 4h]
pera6521: folds 
diarouga: folds 
boulcheat: folds 
pipinoelbreve9: folds 
StrangeNoumena: raises €0.04 to €0.06
MDKristian: folds 
Uncalled bet (€0.04) returned to StrangeNoumena
StrangeNoumena collected €0.04 from pot
StrangeNoumena: doesn't show hand 
*** SUMMARY ***
Total pot €0.04 | Rake €0 
Seat 1: pipinoelbreve9 (button) folded before Flop (didn't bet)
Seat 2: StrangeNoumena (small blind) collected (€0.04)
Seat 3: MDKristian (big blind) folded before Flop
Seat 4: pera6521 folded before Flop (didn't bet)
Seat 5: diarouga folded before Flop (didn't bet)
Seat 6: boulcheat folded before Flop (didn't bet)



PokerStars Zoom Hand #257438915851:  Hold'em No Limit (€0.01/€0.02) - 2025/08/22 10:34:14 CET [2025/08/22 4:34:14 ET]
Table 'Arneb' 6-max Seat #1 is the button
Seat 1: crissstal (€1.34 in chips) 
Seat 2: KizoMaster (€1.54 in chips) 
Seat 3: tazz adri (€1.30 in chips) 
Seat 4: HALKIM2001 (€2 in chips) 
Seat 5: pipinoelbreve9 (€2.21 in chips) 
Seat 6: MDKristian (€2 in chips) 
KizoMaster: posts small blind €0.01
tazz adri: posts big blind €0.02
*** HOLE CARDS ***
Dealt to pipinoelbreve9 [2h Th]
HALKIM2001: folds 
pipinoelbreve9: folds 
MDKristian: raises €0.02 to €0.04
crissstal: folds 
KizoMaster: raises €0.08 to €0.12
tazz adri: folds 
MDKristian: calls €0.08
*** FLOP *** [6c 5d 4c]
KizoMaster: bets €0.13
MDKristian: raises €0.26 to €0.39
KizoMaster: calls €0.26
*** TURN *** [6c 5d 4c] [8c]
KizoMaster: checks 
MDKristian: bets €0.99
KizoMaster: calls €0.99
*** RIVER *** [6c 5d 4c 8c] [Td]
KizoMaster: checks 
MDKristian: bets €0.50 and is all-in
KizoMaster: calls €0.04 and is all-in
Uncalled bet (€0.46) returned to MDKristian
*** SHOW DOWN ***
MDKristian: shows [4h 4d] (three of a kind, Fours)
KizoMaster: shows [9s 9c] (a pair of Nines)
MDKristian collected €2.94 from pot
*** SUMMARY ***
Total pot €3.10 | Rake €0.16 
Board [6c 5d 4c 8c Td]
Seat 1: crissstal (button) folded before Flop (didn't bet)
Seat 2: KizoMaster (small blind) showed [9s 9c] and lost with a pair of Nines
Seat 3: tazz adri (big blind) folded before Flop
Seat 4: HALKIM2001 folded before Flop (didn't bet)
Seat 5: pipinoelbreve9 folded before Flop (didn't bet)
Seat 6: MDKristian showed [4h 4d] and won (€2.94) with three of a kind, Fours



PokerStars Zoom Hand #257438916828:  Hold'em No Limit (€0.01/€0.02) - 2025/08/22 10:34:26 CET [2025/08/22 4:34:26 ET]
Table 'Arneb' 6-max Seat #1 is the button
Seat 1: eres_tontito (€1.89 in chips) 
Seat 2: 34Sirina (€0.83 in chips) 
Seat 3: pipinoelbreve9 (€2.20 in chips) 
Seat 4: MDKristian (€2.12 in chips) 
Seat 5: paul20025 (€1.20 in chips) 
Seat 6: cruass (€2.99 in chips) 
34Sirina: posts small blind €0.01
pipinoelbreve9: posts big blind €0.02
*** HOLE CARDS ***
Dealt to pipinoelbreve9 [Kd 6h]
MDKristian: folds 
paul20025: raises €0.02 to €0.04
cruass: folds 
eres_tontito: folds 
34Sirina: calls €0.03
pipinoelbreve9: folds 
*** FLOP *** [9d 2d As]
34Sirina: bets €0.02
paul20025: calls €0.02
*** TURN *** [9d 2d As] [Jh]
34Sirina: checks 
paul20025: bets €0.02
34Sirina: calls €0.02
*** RIVER *** [9d 2d As Jh] [Qc]
34Sirina: checks 
paul20025: bets €0.02
34Sirina: folds 
Uncalled bet (€0.02) returned to paul20025
paul20025 collected €0.17 from pot
paul20025: doesn't show hand 
*** SUMMARY ***
Total pot €0.18 | Rake €0.01 
Board [9d 2d As Jh Qc]
Seat 1: eres_tontito (button) folded before Flop (didn't bet)
Seat 2: 34Sirina (small blind) folded on the River
Seat 3: pipinoelbreve9 (big blind) folded before Flop
Seat 4: MDKristian folded before Flop (didn't bet)
Seat 5: paul20025 collected (€0.17)
Seat 6: cruass folded before Flop (didn't bet)



PokerStars Zoom Hand #257438918802:  Hold'em No Limit (€0.01/€0.02) - 2025/08/22 10:34:52 CET [2025/08/22 4:34:52 ET]
Table 'Arneb' 6-max Seat #1 is the button
Seat 1: Ctr Alt Surp (€3.39 in chips) 
Seat 2: kurtconlei14 (€1.98 in chips) 
Seat 3: Danipro178 (€4.37 in chips) 
Seat 4: HALKIM2001 (€3.81 in chips) 
Seat 5: MDKristian (€2.03 in chips) 
Seat 6: pipinoelbreve9 (€2.18 in chips) 
kurtconlei14: posts small blind €0.01
Danipro178: posts big blind €0.02
*** HOLE CARDS ***
Dealt to pipinoelbreve9 [9d 7c]
HALKIM2001: folds 
MDKristian: folds 
pipinoelbreve9: folds 
Ctr Alt Surp: folds 
kurtconlei14: folds 
Uncalled bet (€0.01) returned to Danipro178
Danipro178 collected €0.02 from pot
Danipro178: doesn't show hand 
*** SUMMARY ***
Total pot €0.02 | Rake €0 
Seat 1: Ctr Alt Surp (button) folded before Flop (didn't bet)
Seat 2: kurtconlei14 (small blind) folded before Flop
Seat 3: Danipro178 (big blind) collected (€0.02)
Seat 4: HALKIM2001 folded before Flop (didn't bet)
Seat 5: MDKristian folded before Flop (didn't bet)
Seat 6: pipinoelbreve9 folded before Flop (didn't bet)



PokerStars Zoom Hand #257438918433:  Hold'em No Limit (€0.01/€0.02) - 2025/08/22 10:34:47 CET [2025/08/22 4:34:47 ET]
Table 'Arneb' 6-max Seat #1 is the button
Seat 1: diarouga (€2 in chips) 
Seat 2: eres_tontito (€2.30 in chips) 
Seat 3: 77samuel33 (€2 in chips) 
Seat 4: Danipro178 (€4.37 in chips) 
Seat 5: pipinoelbreve9 (€2.18 in chips) 
Seat 6: sukocash (€2 in chips) 
eres_tontito: posts small blind €0.01
77samuel33: posts big blind €0.02
*** HOLE CARDS ***
Dealt to pipinoelbreve9 [Tc 8h]
Danipro178: folds 
pipinoelbreve9: folds 
sukocash: folds 
diarouga: raises €0.03 to €0.05
eres_tontito: folds 
77samuel33: folds 
Uncalled bet (€0.03) returned to diarouga
diarouga collected €0.05 from pot
diarouga: doesn't show hand 
*** SUMMARY ***
Total pot €0.05 | Rake €0 
Seat 1: diarouga (button) collected (€0.05)
Seat 2: eres_tontito (small blind) folded before Flop
Seat 3: 77samuel33 (big blind) folded before Flop
Seat 4: Danipro178 folded before Flop (didn't bet)
Seat 5: pipinoelbreve9 folded before Flop (didn't bet)
Seat 6: sukocash folded before Flop (didn't bet)



PokerStars Zoom Hand #257438919300:  Hold'em No Limit (€0.01/€0.02) - 2025/08/22 10:34:59 CET [2025/08/22 4:34:59 ET]
Table 'Arneb' 6-max Seat #1 is the button
Seat 1: cruass (€3.01 in chips) 
Seat 2: berjanok (€2 in chips) 
Seat 3: pipinoelbreve9 (€2.18 in chips) 
Seat 4: MDKristian (€2.03 in chips) 
Seat 5: Polandrus (€2.80 in chips) 
Seat 6: samzak232 (€0.87 in chips) 
berjanok: posts small blind €0.01
pipinoelbreve9: posts big blind €0.02
*** HOLE CARDS ***
Dealt to pipinoelbreve9 [Ac 2h]
MDKristian: raises €0.02 to €0.04
Polandrus is disconnected 
Polandrus has timed out while disconnected
Polandrus: folds 
samzak232: raises €0.19 to €0.23
cruass: folds 
berjanok: folds 
pipinoelbreve9: folds 
MDKristian: folds 
Uncalled bet (€0.19) returned to samzak232
samzak232 collected €0.11 from pot
samzak232: doesn't show hand 
*** SUMMARY ***
Total pot €0.11 | Rake €0 
Seat 1: cruass (button) folded before Flop (didn't bet)
Seat 2: berjanok (small blind) folded before Flop
Seat 3: pipinoelbreve9 (big blind) folded before Flop
Seat 4: MDKristian folded before Flop
Seat 5: Polandrus folded before Flop (didn't bet)
Seat 6: samzak232 collected (€0.11)



PokerStars Zoom Hand #257438919976:  Hold'em No Limit (€0.01/€0.02) - 2025/08/22 10:35:08 CET [2025/08/22 4:35:08 ET]
Table 'Arneb' 6-max Seat #1 is the button
Seat 1: kurtconlei14 (€1.95 in chips) 
Seat 2: pipinoelbreve9 (€2.16 in chips) 
Seat 3: cruass (€3.01 in chips) 
Seat 4: titinantet (€2.28 in chips) 
Seat 5: Danipro178 (€2.90 in chips) 
Seat 6: elrusogamer (€2.10 in chips) 
pipinoelbreve9: posts small blind €0.01
cruass: posts big blind €0.02
*** HOLE CARDS ***
Dealt to pipinoelbreve9 [8d 7d]
titinantet: folds 
Danipro178: folds 
elrusogamer: folds 
kurtconlei14: folds 
pipinoelbreve9: raises €0.04 to €0.06
cruass: calls €0.04
*** FLOP *** [8c 9h As]
pipinoelbreve9: bets €0.04
cruass: calls €0.04
*** TURN *** [8c 9h As] [Qs]
pipinoelbreve9: checks 
cruass: bets €0.06
pipinoelbreve9: folds 
Uncalled bet (€0.06) returned to cruass
cruass collected €0.19 from pot
cruass: doesn't show hand 
*** SUMMARY ***
Total pot €0.20 | Rake €0.01 
Board [8c 9h As Qs]
Seat 1: kurtconlei14 (button) folded before Flop (didn't bet)
Seat 2: pipinoelbreve9 (small blind) folded on the Turn
Seat 3: cruass (big blind) collected (€0.19)
Seat 4: titinantet folded before Flop (didn't bet)
Seat 5: Danipro178 folded before Flop (didn't bet)
Seat 6: elrusogamer folded before Flop (didn't bet)



PokerStars Zoom Hand #257438923764:  Hold'em No Limit (€0.01/€0.02) - 2025/08/22 10:35:57 CET [2025/08/22 4:35:57 ET]
Table 'Arneb' 6-max Seat #1 is the button
Seat 1: olazunai (€2.02 in chips) 
Seat 2: sukocash (€1.98 in chips) 
Seat 3: cruass (€3.10 in chips) 
Seat 4: caroleli10 (€2 in chips) 
Seat 5: pipinoelbreve9 (€2.04 in chips) 
Seat 6: juajord26 (€2.05 in chips) 
sukocash: posts small blind €0.01
cruass: posts big blind €0.02
*** HOLE CARDS ***
Dealt to pipinoelbreve9 [As Ac]
caroleli10: folds 
pipinoelbreve9: raises €0.04 to €0.06
juajord26: folds 
olazunai: folds 
sukocash: calls €0.05
cruass: folds 
*** FLOP *** [3s 9s 8h]
sukocash: checks 
pipinoelbreve9: bets €0.04
sukocash: calls €0.04
*** TURN *** [3s 9s 8h] [Qh]
sukocash: checks 
pipinoelbreve9: bets €0.17
sukocash: folds 
Uncalled bet (€0.17) returned to pipinoelbreve9
pipinoelbreve9 collected €0.21 from pot
pipinoelbreve9: doesn't show hand 
*** SUMMARY ***
Total pot €0.22 | Rake €0.01 
Board [3s 9s 8h Qh]
Seat 1: olazunai (button) folded before Flop (didn't bet)
Seat 2: sukocash (small blind) folded on the Turn
Seat 3: cruass (big blind) folded before Flop
Seat 4: caroleli10 folded before Flop (didn't bet)
Seat 5: pipinoelbreve9 collected (€0.21)
Seat 6: juajord26 folded before Flop (didn't bet)



PokerStars Zoom Hand #257438922934:  Hold'em No Limit (€0.01/€0.02) - 2025/08/22 10:35:46 CET [2025/08/22 4:35:46 ET]
Table 'Arneb' 6-max Seat #1 is the button
Seat 1: pipinoelbreve9 (€2.06 in chips) 
Seat 2: Areny_Sole (€2.73 in chips) 
Seat 3: sukocash (€2 in chips) 
Seat 4: XXILuv (€2.09 in chips) 
Seat 5: caroleli10 (€2.15 in chips) 
Seat 6: cruass (€3.10 in chips) 
Areny_Sole: posts small blind €0.01
sukocash: posts big blind €0.02
*** HOLE CARDS ***
Dealt to pipinoelbreve9 [8c 9h]
XXILuv: folds 
caroleli10: raises €0.04 to €0.06
cruass: folds 
pipinoelbreve9: folds 
Areny_Sole: calls €0.05
sukocash: folds 
*** FLOP *** [Qd As 4c]
Areny_Sole: checks 
caroleli10: bets €0.05
Areny_Sole: calls €0.05
*** TURN *** [Qd As 4c] [8h]
Areny_Sole: checks 
caroleli10: bets €0.09
Areny_Sole: calls €0.09
*** RIVER *** [Qd As 4c 8h] [5h]
Areny_Sole: checks 
caroleli10: checks 
*** SHOW DOWN ***
Areny_Sole: shows [Qc Kd] (a pair of Queens)
caroleli10: shows [6c Ac] (a pair of Aces)
caroleli10 collected €0.40 from pot
*** SUMMARY ***
Total pot €0.42 | Rake €0.02 
Board [Qd As 4c 8h 5h]
Seat 1: pipinoelbreve9 (button) folded before Flop (didn't bet)
Seat 2: Areny_Sole (small blind) showed [Qc Kd] and lost with a pair of Queens
Seat 3: sukocash (big blind) folded before Flop
Seat 4: XXILuv folded before Flop (didn't bet)
Seat 5: caroleli10 showed [6c Ac] and won (€0.40) with a pair of Aces
Seat 6: cruass folded before Flop (didn't bet)



PokerStars Zoom Hand #257438923126:  Hold'em No Limit (€0.01/€0.02) - 2025/08/22 10:35:48 CET [2025/08/22 4:35:48 ET]
Table 'Arneb' 6-max Seat #1 is the button
Seat 1: pera6521 (€2.37 in chips) 
Seat 2: KarDpliZ (€3.65 in chips) 
Seat 3: pipinoelbreve9 (€2.06 in chips) 
Seat 4: diarouga (€2.27 in chips) 
Seat 5: berjanok (€2.03 in chips) 
Seat 6: JENOFONTE73 (€1.71 in chips) 
KarDpliZ: posts small blind €0.01
pipinoelbreve9: posts big blind €0.02
*** HOLE CARDS ***
Dealt to pipinoelbreve9 [Tc 8h]
diarouga: folds 
berjanok: folds 
JENOFONTE73: raises €0.03 to €0.05
pera6521: folds 
KarDpliZ: calls €0.04
pipinoelbreve9: folds 
*** FLOP *** [As 6c 9h]
KarDpliZ: checks 
JENOFONTE73: checks 
*** TURN *** [As 6c 9h] [4s]
KarDpliZ: checks 
JENOFONTE73: checks 
*** RIVER *** [As 6c 9h 4s] [Jh]
KarDpliZ: checks 
JENOFONTE73: checks 
*** SHOW DOWN ***
KarDpliZ: shows [Ts Ks] (high card Ace)
JENOFONTE73: shows [Kh Td] (high card Ace)
KarDpliZ collected €0.06 from pot
JENOFONTE73 collected €0.05 from pot
*** SUMMARY ***
Total pot €0.12 | Rake €0.01 
Board [As 6c 9h 4s Jh]
Seat 1: pera6521 (button) folded before Flop (didn't bet)
Seat 2: KarDpliZ (small blind) showed [Ts Ks] and won (€0.06) with high card Ace
Seat 3: pipinoelbreve9 (big blind) folded before Flop
Seat 4: diarouga folded before Flop (didn't bet)
Seat 5: berjanok folded before Flop (didn't bet)
Seat 6: JENOFONTE73 showed [Kh Td] and won (€0.05) with high card Ace



PokerStars Zoom Hand #257438926380:  Hold'em No Limit (€0.01/€0.02) - 2025/08/22 10:36:31 CET [2025/08/22 4:36:31 ET]
Table 'Arneb' 6-max Seat #1 is the button
Seat 1: pipinoelbreve9 (€2.15 in chips) 
Seat 2: MDKristian (€2.10 in chips) 
Seat 3: Polandrus (€2 in chips) 
Seat 4: Danipro178 (€4.43 in chips) 
Seat 5: sukocash (€2.03 in chips) 
Seat 6: elrusogamer (€2.13 in chips) 
MDKristian: posts small blind €0.01
Polandrus: posts big blind €0.02
*** HOLE CARDS ***
Dealt to pipinoelbreve9 [6h Qh]
Danipro178: folds 
sukocash: folds 
elrusogamer: raises €0.04 to €0.06
pipinoelbreve9: folds 
MDKristian: folds 
Polandrus: folds 
Uncalled bet (€0.04) returned to elrusogamer
elrusogamer collected €0.05 from pot
elrusogamer: doesn't show hand 
*** SUMMARY ***
Total pot €0.05 | Rake €0 
Seat 1: pipinoelbreve9 (button) folded before Flop (didn't bet)
Seat 2: MDKristian (small blind) folded before Flop
Seat 3: Polandrus (big blind) folded before Flop
Seat 4: Danipro178 folded before Flop (didn't bet)
Seat 5: sukocash folded before Flop (didn't bet)
Seat 6: elrusogamer collected (€0.05)



PokerStars Zoom Hand #257438927639:  Hold'em No Limit (€0.01/€0.02) - 2025/08/22 10:36:47 CET [2025/08/22 4:36:47 ET]
Table 'Arneb' 6-max Seat #1 is the button
Seat 1: diarouga (€2 in chips) 
Seat 2: MDKristian (€2.10 in chips) 
Seat 3: caroleli10 (€2 in chips) 
Seat 4: Danipro178 (€2.90 in chips) 
Seat 5: kurtconlei14 (€1.66 in chips) 
Seat 6: pipinoelbreve9 (€2.14 in chips) 
MDKristian: posts small blind €0.01
caroleli10: posts big blind €0.02
*** HOLE CARDS ***
Dealt to pipinoelbreve9 [4h 4c]
Danipro178: folds 
kurtconlei14: folds 
pipinoelbreve9: raises €0.04 to €0.06
diarouga: folds 
MDKristian: raises €0.20 to €0.26
caroleli10: folds 
pipinoelbreve9: folds 
Uncalled bet (€0.20) returned to MDKristian
MDKristian collected €0.14 from pot
MDKristian: doesn't show hand 
*** SUMMARY ***
Total pot €0.14 | Rake €0 
Seat 1: diarouga (button) folded before Flop (didn't bet)
Seat 2: MDKristian (small blind) collected (€0.14)
Seat 3: caroleli10 (big blind) folded before Flop
Seat 4: Danipro178 folded before Flop (didn't bet)
Seat 5: kurtconlei14 folded before Flop (didn't bet)
Seat 6: pipinoelbreve9 folded before Flop



PokerStars Zoom Hand #257438927292:  Hold'em No Limit (€0.01/€0.02) - 2025/08/22 10:36:42 CET [2025/08/22 4:36:42 ET]
Table 'Arneb' 6-max Seat #1 is the button
Seat 1: Zbiegnew90 (€2.05 in chips) 
Seat 2: sukocash (€2.10 in chips) 
Seat 3: MDKristian (€2.09 in chips) 
Seat 4: pipinoelbreve9 (€2.14 in chips) 
Seat 5: kurtconlei14 (€1.66 in chips) 
Seat 6: 34Sirina (€0.97 in chips) 
sukocash: posts small blind €0.01
MDKristian: posts big blind €0.02
*** HOLE CARDS ***
Dealt to pipinoelbreve9 [2h 4c]
pipinoelbreve9: folds 
kurtconlei14: folds 
34Sirina: folds 
Zbiegnew90: folds 
sukocash: raises €0.03 to €0.05
MDKristian: calls €0.03
*** FLOP *** [Qc 2s 9h]
sukocash: checks 
MDKristian: checks 
*** TURN *** [Qc 2s 9h] [Ad]
sukocash: bets €0.08
MDKristian: folds 
Uncalled bet (€0.08) returned to sukocash
sukocash collected €0.10 from pot
sukocash: doesn't show hand 
*** SUMMARY ***
Total pot €0.10 | Rake €0 
Board [Qc 2s 9h Ad]
Seat 1: Zbiegnew90 (button) folded before Flop (didn't bet)
Seat 2: sukocash (small blind) collected (€0.10)
Seat 3: MDKristian (big blind) folded on the Turn
Seat 4: pipinoelbreve9 folded before Flop (didn't bet)
Seat 5: kurtconlei14 folded before Flop (didn't bet)
Seat 6: 34Sirina folded before Flop (didn't bet)



PokerStars Zoom Hand #257438926866:  Hold'em No Limit (€0.01/€0.02) - 2025/08/22 10:36:37 CET [2025/08/22 4:36:37 ET]
Table 'Arneb' 6-max Seat #1 is the button
Seat 1: hernandS&G (€4.62 in chips) 
Seat 2: pipinoelbreve9 (€2.15 in chips) 
Seat 3: diarouga (€2 in chips) 
Seat 4: boulcheat (€3.95 in chips) 
Seat 5: eres_tontito (€2.70 in chips) 
Seat 6: POUPIOU65 (€1.12 in chips) 
pipinoelbreve9: posts small blind €0.01
diarouga: posts big blind €0.02
*** HOLE CARDS ***
Dealt to pipinoelbreve9 [3d 9h]
boulcheat: raises €0.03 to €0.05
eres_tontito: calls €0.05
POUPIOU65: calls €0.05
hernandS&G: folds 
pipinoelbreve9: folds 
diarouga: folds 
*** FLOP *** [Qh Ts 2h]
boulcheat: bets €0.05
eres_tontito: folds 
POUPIOU65: calls €0.05
*** TURN *** [Qh Ts 2h] [Ks]
boulcheat: bets €0.09
POUPIOU65: calls €0.09
*** RIVER *** [Qh Ts 2h Ks] [Ad]
boulcheat: bets €0.23
POUPIOU65: raises €0.37 to €0.60
boulcheat: calls €0.37
*** SHOW DOWN ***
POUPIOU65: shows [Jd Kc] (a straight, Ten to Ace)
boulcheat: mucks hand 
POUPIOU65 collected €1.58 from pot
*** SUMMARY ***
Total pot €1.66 | Rake €0.08 
Board [Qh Ts 2h Ks Ad]
Seat 1: hernandS&G (button) folded before Flop (didn't bet)
Seat 2: pipinoelbreve9 (small blind) folded before Flop
Seat 3: diarouga (big blind) folded before Flop
Seat 4: boulcheat mucked [Ac As]
Seat 5: eres_tontito folded on the Flop
Seat 6: POUPIOU65 showed [Jd Kc] and won (€1.58) with a straight, Ten to Ace



PokerStars Zoom Hand #257438930389:  Hold'em No Limit (€0.01/€0.02) - 2025/08/22 10:37:23 CET [2025/08/22 4:37:23 ET]
Table 'Arneb' 6-max Seat #1 is the button
Seat 1: KarDpliZ (€3.61 in chips) 
Seat 2: titinantet (€2.12 in chips) 
Seat 3: pipinoelbreve9 (€2.07 in chips) 
Seat 4: MDKristian (€2.18 in chips) 
Seat 5: kurtconlei14 (€1.91 in chips) 
Seat 6: Zbiegnew90 (€2 in chips) 
titinantet: posts small blind €0.01
pipinoelbreve9: posts big blind €0.02
*** HOLE CARDS ***
Dealt to pipinoelbreve9 [Ad 4s]
MDKristian: folds 
kurtconlei14: folds 
Zbiegnew90: raises €0.03 to €0.05
KarDpliZ: folds 
titinantet: folds 
pipinoelbreve9: folds 
Uncalled bet (€0.03) returned to Zbiegnew90
Zbiegnew90 collected €0.05 from pot
Zbiegnew90: doesn't show hand 
*** SUMMARY ***
Total pot €0.05 | Rake €0 
Seat 1: KarDpliZ (button) folded before Flop (didn't bet)
Seat 2: titinantet (small blind) folded before Flop
Seat 3: pipinoelbreve9 (big blind) folded before Flop
Seat 4: MDKristian folded before Flop (didn't bet)
Seat 5: kurtconlei14 folded before Flop (didn't bet)
Seat 6: Zbiegnew90 collected (€0.05)



PokerStars Zoom Hand #257438929758:  Hold'em No Limit (€0.01/€0.02) - 2025/08/22 10:37:14 CET [2025/08/22 4:37:14 ET]
Table 'Arneb' 6-max Seat #1 is the button
Seat 1: titinantet (€2.12 in chips) 
Seat 2: cruass (€3.08 in chips) 
Seat 3: berjanok (€2.06 in chips) 
Seat 4: pipinoelbreve9 (€2.08 in chips) 
Seat 5: diarouga (€2 in chips) 
Seat 6: MDKristian (€2.04 in chips) 
cruass: posts small blind €0.01
berjanok: posts big blind €0.02
*** HOLE CARDS ***
Dealt to pipinoelbreve9 [3h 4d]
pipinoelbreve9: folds 
diarouga: folds 
MDKristian: folds 
titinantet: folds 
cruass: raises €0.02 to €0.04
berjanok: raises €0.08 to €0.12
cruass: folds 
Uncalled bet (€0.08) returned to berjanok
berjanok collected €0.08 from pot
berjanok: doesn't show hand 
*** SUMMARY ***
Total pot €0.08 | Rake €0 
Seat 1: titinantet (button) folded before Flop (didn't bet)
Seat 2: cruass (small blind) folded before Flop
Seat 3: berjanok (big blind) collected (€0.08)
Seat 4: pipinoelbreve9 folded before Flop (didn't bet)
Seat 5: diarouga folded before Flop (didn't bet)
Seat 6: MDKristian folded before Flop (didn't bet)



PokerStars Zoom Hand #257438929414:  Hold'em No Limit (€0.01/€0.02) - 2025/08/22 10:37:10 CET [2025/08/22 4:37:10 ET]
Table 'Arneb' 6-max Seat #1 is the button
Seat 1: konkrettrec (€3.44 in chips) 
Seat 2: titinantet (€2.13 in chips) 
Seat 3: PSCL61 (€2.04 in chips) 
Seat 4: pipinoelbreve9 (€2.08 in chips) 
Seat 5: Danipro178 (€4.40 in chips) 
Seat 6: StrangeNoumena (€1.85 in chips) 
titinantet: posts small blind €0.01
PSCL61: posts big blind €0.02
*** HOLE CARDS ***
Dealt to pipinoelbreve9 [Kh 4h]
pipinoelbreve9: folds 
Danipro178: folds 
StrangeNoumena: raises €0.04 to €0.06
konkrettrec: calls €0.06
titinantet: folds 
PSCL61: calls €0.04
*** FLOP *** [2s Qc 9s]
PSCL61: bets €0.18
StrangeNoumena: folds 
konkrettrec: folds 
Uncalled bet (€0.18) returned to PSCL61
PSCL61 collected €0.18 from pot
PSCL61: doesn't show hand 
*** SUMMARY ***
Total pot €0.19 | Rake €0.01 
Board [2s Qc 9s]
Seat 1: konkrettrec (button) folded on the Flop
Seat 2: titinantet (small blind) folded before Flop
Seat 3: PSCL61 (big blind) collected (€0.18)
Seat 4: pipinoelbreve9 folded before Flop (didn't bet)
Seat 5: Danipro178 folded before Flop (didn't bet)
Seat 6: StrangeNoumena folded on the Flop



PokerStars Zoom Hand #257438930873:  Hold'em No Limit (€0.01/€0.02) - 2025/08/22 10:37:29 CET [2025/08/22 4:37:29 ET]
Table 'Arneb' 6-max Seat #1 is the button
Seat 1: XXILuv (€2 in chips) 
Seat 2: sukocash (€2.02 in chips) 
Seat 3: eres_tontito (€2.70 in chips) 
Seat 4: caroleli10 (€2.15 in chips) 
Seat 5: JENOFONTE73 (€2.09 in chips) 
Seat 6: pipinoelbreve9 (€2.05 in chips) 
sukocash: posts small blind €0.01
eres_tontito: posts big blind €0.02
*** HOLE CARDS ***
Dealt to pipinoelbreve9 [3c 5s]
caroleli10: folds 
JENOFONTE73 has timed out
JENOFONTE73: folds 
pipinoelbreve9: folds 
XXILuv: folds 
sukocash: folds 
Uncalled bet (€0.01) returned to eres_tontito
eres_tontito collected €0.02 from pot
eres_tontito: doesn't show hand 
*** SUMMARY ***
Total pot €0.02 | Rake €0 
Seat 1: XXILuv (button) folded before Flop (didn't bet)
Seat 2: sukocash (small blind) folded before Flop
Seat 3: eres_tontito (big blind) collected (€0.02)
Seat 4: caroleli10 folded before Flop (didn't bet)
Seat 5: JENOFONTE73 folded before Flop (didn't bet)
Seat 6: pipinoelbreve9 folded before Flop (didn't bet)



PokerStars Zoom Hand #257438930088:  Hold'em No Limit (€0.01/€0.02) - 2025/08/22 10:37:19 CET [2025/08/22 4:37:19 ET]
Table 'Arneb' 6-max Seat #1 is the button
Seat 1: elrusogamer (€2.16 in chips) 
Seat 2: pipinoelbreve9 (€2.08 in chips) 
Seat 3: FELIPE439 (€1.78 in chips) 
Seat 4: sukocash (€2 in chips) 
Seat 5: spirou252 (€1.57 in chips) 
Seat 6: MDKristian (€2.18 in chips) 
pipinoelbreve9: posts small blind €0.01
FELIPE439: posts big blind €0.02
*** HOLE CARDS ***
Dealt to pipinoelbreve9 [3s 2c]
sukocash: folds 
spirou252: folds 
MDKristian: folds 
elrusogamer: calls €0.02
pipinoelbreve9: folds 
FELIPE439: checks 
*** FLOP *** [Qh Ah 4s]
FELIPE439: checks 
elrusogamer: checks 
*** TURN *** [Qh Ah 4s] [Ad]
FELIPE439: checks 
elrusogamer: bets €0.08
FELIPE439: folds 
Uncalled bet (€0.08) returned to elrusogamer
elrusogamer collected €0.05 from pot
elrusogamer: doesn't show hand 
*** SUMMARY ***
Total pot €0.05 | Rake €0 
Board [Qh Ah 4s Ad]
Seat 1: elrusogamer (button) collected (€0.05)
Seat 2: pipinoelbreve9 (small blind) folded before Flop
Seat 3: FELIPE439 (big blind) folded on the Turn
Seat 4: sukocash folded before Flop (didn't bet)
Seat 5: spirou252 folded before Flop (didn't bet)
Seat 6: MDKristian folded before Flop (didn't bet)



PokerStars Zoom Hand #257438931599:  Hold'em No Limit (€0.01/€0.02) - 2025/08/22 10:37:38 CET [2025/08/22 4:37:38 ET]
Table 'Arneb' 6-max Seat #1 is the button
Seat 1: pipinoelbreve9 (€2.05 in chips) 
Seat 2: berjanok (€2.10 in chips) 
Seat 3: Polandrus (€2.02 in chips) 
Seat 4: samzak232 (€1.94 in chips) 
Seat 5: caroleli10 (€2.02 in chips) 
Seat 6: paul20025 (€1.29 in chips) 
berjanok: posts small blind €0.01
Polandrus: posts big blind €0.02
*** HOLE CARDS ***
Dealt to pipinoelbreve9 [Qs 9d]
samzak232: calls €0.02
caroleli10: folds 
paul20025: folds 
pipinoelbreve9: folds 
berjanok: folds 
Polandrus: checks 
*** FLOP *** [6d 6s 9s]
Polandrus: checks 
samzak232: checks 
*** TURN *** [6d 6s 9s] [7h]
Polandrus: checks 
samzak232: bets €0.05
Polandrus: folds 
Uncalled bet (€0.05) returned to samzak232
samzak232 collected €0.05 from pot
samzak232: doesn't show hand 
*** SUMMARY ***
Total pot €0.05 | Rake €0 
Board [6d 6s 9s 7h]
Seat 1: pipinoelbreve9 (button) folded before Flop (didn't bet)
Seat 2: berjanok (small blind) folded before Flop
Seat 3: Polandrus (big blind) folded on the Turn
Seat 4: samzak232 collected (€0.05)
Seat 5: caroleli10 folded before Flop (didn't bet)
Seat 6: paul20025 folded before Flop (didn't bet)



PokerStars Zoom Hand #257438932088:  Hold'em No Limit (€0.01/€0.02) - 2025/08/22 10:37:45 CET [2025/08/22 4:37:45 ET]
Table 'Arneb' 6-max Seat #1 is the button
Seat 1: FELIPE439 (€1.98 in chips) 
Seat 2: Danipro178 (€4.41 in chips) 
Seat 3: StrangeNoumena (€1.79 in chips) 
Seat 4: pipinoelbreve9 (€2.05 in chips) 
Seat 5: XXILuv (€2 in chips) 
Seat 6: PSCL61 (€2.16 in chips) 
Danipro178: posts small blind €0.01
StrangeNoumena: posts big blind €0.02
*** HOLE CARDS ***
Dealt to pipinoelbreve9 [Qh 7s]
pipinoelbreve9: folds 
XXILuv: folds 
PSCL61: calls €0.02
FELIPE439: folds 
Danipro178: folds 
StrangeNoumena: raises €0.04 to €0.06
PSCL61: calls €0.04
*** FLOP *** [7h Ts 4d]
StrangeNoumena: bets €0.06
PSCL61: folds 
Uncalled bet (€0.06) returned to StrangeNoumena
StrangeNoumena collected €0.12 from pot
StrangeNoumena: doesn't show hand 
*** SUMMARY ***
Total pot €0.13 | Rake €0.01 
Board [7h Ts 4d]
Seat 1: FELIPE439 (button) folded before Flop (didn't bet)
Seat 2: Danipro178 (small blind) folded before Flop
Seat 3: StrangeNoumena (big blind) collected (€0.12)
Seat 4: pipinoelbreve9 folded before Flop (didn't bet)
Seat 5: XXILuv folded before Flop (didn't bet)
Seat 6: PSCL61 folded on the Flop



PokerStars Zoom Hand #257438931806:  Hold'em No Limit (€0.01/€0.02) - 2025/08/22 10:37:41 CET [2025/08/22 4:37:41 ET]
Table 'Arneb' 6-max Seat #1 is the button
Seat 1: elrusogamer (€1.93 in chips) 
Seat 2: POUPIOU65 (€1.92 in chips) 
Seat 3: diarouga (€2 in chips) 
Seat 4: paul20025 (€1.29 in chips) 
Seat 5: pipinoelbreve9 (€2.05 in chips) 
Seat 6: kurtconlei14 (€1.82 in chips) 
POUPIOU65: posts small blind €0.01
diarouga: posts big blind €0.02
*** HOLE CARDS ***
Dealt to pipinoelbreve9 [6h 7d]
paul20025: calls €0.02
pipinoelbreve9: folds 
kurtconlei14: folds 
elrusogamer: folds 
POUPIOU65: folds 
diarouga: checks 
*** FLOP *** [Ks 9h 2s]
diarouga: checks 
paul20025: checks 
*** TURN *** [Ks 9h 2s] [Ad]
diarouga: checks 
paul20025: checks 
*** RIVER *** [Ks 9h 2s Ad] [As]
diarouga: checks 
paul20025: bets €0.12
diarouga: folds 
Uncalled bet (€0.12) returned to paul20025
paul20025 collected €0.05 from pot
paul20025: doesn't show hand 
*** SUMMARY ***
Total pot €0.05 | Rake €0 
Board [Ks 9h 2s Ad As]
Seat 1: elrusogamer (button) folded before Flop (didn't bet)
Seat 2: POUPIOU65 (small blind) folded before Flop
Seat 3: diarouga (big blind) folded on the River
Seat 4: paul20025 collected (€0.05)
Seat 5: pipinoelbreve9 folded before Flop (didn't bet)
Seat 6: kurtconlei14 folded before Flop (didn't bet)



PokerStars Zoom Hand #257438932409:  Hold'em No Limit (€0.01/€0.02) - 2025/08/22 10:37:49 CET [2025/08/22 4:37:49 ET]
Table 'Arneb' 6-max Seat #1 is the button
Seat 1: eres_tontito (€2.71 in chips) 
Seat 2: pipinoelbreve9 (€2.05 in chips) 
Seat 3: XXILuv (€2 in chips) 
Seat 4: berjanok (€2.09 in chips) 
Seat 5: kurtconlei14 (€1.82 in chips) 
Seat 6: JENOFONTE73 (€2.46 in chips) 
pipinoelbreve9: posts small blind €0.01
XXILuv: posts big blind €0.02
*** HOLE CARDS ***
Dealt to pipinoelbreve9 [5h 5d]
berjanok: raises €0.04 to €0.06
kurtconlei14: folds 
JENOFONTE73: folds 
eres_tontito: folds 
pipinoelbreve9: calls €0.05
XXILuv: folds 
*** FLOP *** [Qs 7h 9d]
pipinoelbreve9: checks 
berjanok: bets €0.02
pipinoelbreve9: calls €0.02
*** TURN *** [Qs 7h 9d] [Ts]
pipinoelbreve9: checks 
berjanok: bets €0.09
pipinoelbreve9: folds 
Uncalled bet (€0.09) returned to berjanok
berjanok collected €0.17 from pot
berjanok: doesn't show hand 
*** SUMMARY ***
Total pot €0.18 | Rake €0.01 
Board [Qs 7h 9d Ts]
Seat 1: eres_tontito (button) folded before Flop (didn't bet)
Seat 2: pipinoelbreve9 (small blind) folded on the Turn
Seat 3: XXILuv (big blind) folded before Flop
Seat 4: berjanok collected (€0.17)
Seat 5: kurtconlei14 folded before Flop (didn't bet)
Seat 6: JENOFONTE73 folded before Flop (didn't bet)



PokerStars Zoom Hand #257438936289:  Hold'em No Limit (€0.01/€0.02) - 2025/08/22 10:38:39 CET [2025/08/22 4:38:39 ET]
Table 'Arneb' 6-max Seat #1 is the button
Seat 1: caroleli10 (€2.12 in chips) 
Seat 2: MDKristian (€2.09 in chips) 
Seat 3: berjanok (€2.17 in chips) 
Seat 4: diarouga (€2.11 in chips) 
Seat 5: titinantet (€2.94 in chips) 
Seat 6: pipinoelbreve9 (€2 in chips) 
MDKristian: posts small blind €0.01
berjanok: posts big blind €0.02
*** HOLE CARDS ***
Dealt to pipinoelbreve9 [7d Qc]
diarouga: folds 
titinantet: folds 
pipinoelbreve9: folds 
caroleli10: folds 
MDKristian: folds 
Uncalled bet (€0.01) returned to berjanok
berjanok collected €0.02 from pot
berjanok: doesn't show hand 
*** SUMMARY ***
Total pot €0.02 | Rake €0 
Seat 1: caroleli10 (button) folded before Flop (didn't bet)
Seat 2: MDKristian (small blind) folded before Flop
Seat 3: berjanok (big blind) collected (€0.02)
Seat 4: diarouga folded before Flop (didn't bet)
Seat 5: titinantet folded before Flop (didn't bet)
Seat 6: pipinoelbreve9 folded before Flop (didn't bet)



PokerStars Zoom Hand #257438935204:  Hold'em No Limit (€0.01/€0.02) - 2025/08/22 10:38:25 CET [2025/08/22 4:38:25 ET]
Table 'Arneb' 6-max Seat #1 is the button
Seat 1: FELIPE439 (€2.69 in chips) 
Seat 2: berjanok (€2.18 in chips) 
Seat 3: pipinoelbreve9 (€2 in chips) 
Seat 4: POUPIOU65 (€1.77 in chips) 
Seat 5: kurtconlei14 (€1.94 in chips) 
Seat 6: MDKristian (€2 in chips) 
berjanok: posts small blind €0.01
pipinoelbreve9: posts big blind €0.02
*** HOLE CARDS ***
Dealt to pipinoelbreve9 [Qd As]
POUPIOU65: folds 
kurtconlei14: raises €0.04 to €0.06
MDKristian: folds 
FELIPE439: raises €0.14 to €0.20
berjanok: folds 
pipinoelbreve9: folds 
kurtconlei14: calls €0.14
*** FLOP *** [3s 9s 2d]
kurtconlei14: checks 
FELIPE439: bets €0.42
kurtconlei14: folds 
Uncalled bet (€0.42) returned to FELIPE439
FELIPE439 collected €0.41 from pot
FELIPE439: doesn't show hand 
*** SUMMARY ***
Total pot €0.43 | Rake €0.02 
Board [3s 9s 2d]
Seat 1: FELIPE439 (button) collected (€0.41)
Seat 2: berjanok (small blind) folded before Flop
Seat 3: pipinoelbreve9 (big blind) folded before Flop
Seat 4: POUPIOU65 folded before Flop (didn't bet)
Seat 5: kurtconlei14 folded on the Flop
Seat 6: MDKristian folded before Flop (didn't bet)



PokerStars Zoom Hand #257438937470:  Hold'em No Limit (€0.01/€0.02) - 2025/08/22 10:38:54 CET [2025/08/22 4:38:54 ET]
Table 'Arneb' 6-max Seat #1 is the button
Seat 1: berjanok (€2.18 in chips) 
Seat 2: boulcheat (€2.60 in chips) 
Seat 3: kurtconlei14 (€1.26 in chips) 
Seat 4: diarouga (€2 in chips) 
Seat 5: pipinoelbreve9 (€2 in chips) 
Seat 6: olazunai (€2.23 in chips) 
boulcheat: posts small blind €0.01
kurtconlei14: posts big blind €0.02
*** HOLE CARDS ***
Dealt to pipinoelbreve9 [Ad 2s]
diarouga: raises €0.04 to €0.06
pipinoelbreve9: folds 
olazunai: folds 
berjanok: folds 
boulcheat: calls €0.05
kurtconlei14: folds 
*** FLOP *** [6h 4h 5s]
boulcheat: checks 
diarouga: bets €0.09
boulcheat: folds 
Uncalled bet (€0.09) returned to diarouga
diarouga collected €0.13 from pot
diarouga: doesn't show hand 
*** SUMMARY ***
Total pot €0.14 | Rake €0.01 
Board [6h 4h 5s]
Seat 1: berjanok (button) folded before Flop (didn't bet)
Seat 2: boulcheat (small blind) folded on the Flop
Seat 3: kurtconlei14 (big blind) folded before Flop
Seat 4: diarouga collected (€0.13)
Seat 5: pipinoelbreve9 folded before Flop (didn't bet)
Seat 6: olazunai folded before Flop (didn't bet)



PokerStars Zoom Hand #257438936951:  Hold'em No Limit (€0.01/€0.02) - 2025/08/22 10:38:47 CET [2025/08/22 4:38:47 ET]
Table 'Arneb' 6-max Seat #1 is the button
Seat 1: pipinoelbreve9 (€2 in chips) 
Seat 2: elrusogamer (€1.87 in chips) 
Seat 3: Danipro178 (€4.19 in chips) 
Seat 4: Areny_Sole (€2.41 in chips) 
Seat 5: MDKristian (€2.08 in chips) 
Seat 6: XXILuv (€2.25 in chips) 
elrusogamer: posts small blind €0.01
Danipro178: posts big blind €0.02
*** HOLE CARDS ***
Dealt to pipinoelbreve9 [3c Ah]
Areny_Sole: folds 
MDKristian: folds 
XXILuv: folds 
pipinoelbreve9: folds 
elrusogamer: raises €0.04 to €0.06
Danipro178: calls €0.04
*** FLOP *** [Ks 2d As]
elrusogamer: checks 
Danipro178: checks 
*** TURN *** [Ks 2d As] [Qh]
elrusogamer: checks 
Danipro178: checks 
*** RIVER *** [Ks 2d As Qh] [9c]
elrusogamer: checks 
Danipro178: checks 
*** SHOW DOWN ***
elrusogamer: shows [Jc 9h] (a pair of Nines)
Danipro178: shows [Js Qd] (a pair of Queens)
Danipro178 collected €0.11 from pot
*** SUMMARY ***
Total pot €0.12 | Rake €0.01 
Board [Ks 2d As Qh 9c]
Seat 1: pipinoelbreve9 (button) folded before Flop (didn't bet)
Seat 2: elrusogamer (small blind) showed [Jc 9h] and lost with a pair of Nines
Seat 3: Danipro178 (big blind) showed [Js Qd] and won (€0.11) with a pair of Queens
Seat 4: Areny_Sole folded before Flop (didn't bet)
Seat 5: MDKristian folded before Flop (didn't bet)
Seat 6: XXILuv folded before Flop (didn't bet)



PokerStars Zoom Hand #257438937794:  Hold'em No Limit (€0.01/€0.02) - 2025/08/22 10:38:58 CET [2025/08/22 4:38:58 ET]
Table 'Arneb' 6-max Seat #1 is the button
Seat 1: XXILuv (€2.25 in chips) 
Seat 2: zubulin (€1.94 in chips) 
Seat 3: JENOFONTE73 (€2.11 in chips) 
Seat 4: pipinoelbreve9 (€2 in chips) 
Seat 5: FELIPE439 (€2.90 in chips) 
Seat 6: berjanok (€2.18 in chips) 
zubulin: posts small blind €0.01
JENOFONTE73: posts big blind €0.02
*** HOLE CARDS ***
Dealt to pipinoelbreve9 [2s 9c]
pipinoelbreve9: folds 
FELIPE439: folds 
berjanok: raises €0.04 to €0.06
XXILuv: folds 
zubulin: folds 
JENOFONTE73: calls €0.04
*** FLOP *** [8h 3s Qh]
JENOFONTE73: checks 
berjanok: checks 
*** TURN *** [8h 3s Qh] [Qd]
JENOFONTE73: checks 
berjanok: bets €0.04
JENOFONTE73: folds 
Uncalled bet (€0.04) returned to berjanok
berjanok collected €0.12 from pot
berjanok: doesn't show hand 
*** SUMMARY ***
Total pot €0.13 | Rake €0.01 
Board [8h 3s Qh Qd]
Seat 1: XXILuv (button) folded before Flop (didn't bet)
Seat 2: zubulin (small blind) folded before Flop
Seat 3: JENOFONTE73 (big blind) folded on the Turn
Seat 4: pipinoelbreve9 folded before Flop (didn't bet)
Seat 5: FELIPE439 folded before Flop (didn't bet)
Seat 6: berjanok collected (€0.12)



PokerStars Zoom Hand #257438938342:  Hold'em No Limit (€0.01/€0.02) - 2025/08/22 10:39:05 CET [2025/08/22 4:39:05 ET]
Table 'Arneb' 6-max Seat #1 is the button
Seat 1: nukilla888 (€0.88 in chips) 
Seat 2: pera6521 (€2.27 in chips) 
Seat 3: kurtconlei14 (€1.74 in chips) 
Seat 4: KizoMaster (€4.15 in chips) 
Seat 5: spirou252 (€3.02 in chips) 
Seat 6: pipinoelbreve9 (€2 in chips) 
pera6521: posts small blind €0.01
kurtconlei14: posts big blind €0.02
*** HOLE CARDS ***
Dealt to pipinoelbreve9 [Td Ah]
KizoMaster: folds 
spirou252: folds 
pipinoelbreve9: raises €0.04 to €0.06
nukilla888: folds 
pera6521: folds 
kurtconlei14: calls €0.04
*** FLOP *** [6s Th 9c]
kurtconlei14: checks 
pipinoelbreve9: bets €0.04
kurtconlei14: raises €0.06 to €0.10
pipinoelbreve9: calls €0.06
*** TURN *** [6s Th 9c] [As]
kurtconlei14: bets €0.16
pipinoelbreve9: calls €0.16
*** RIVER *** [6s Th 9c As] [3h]
kurtconlei14: bets €1.42 and is all-in
pipinoelbreve9: calls €1.42
*** SHOW DOWN ***
kurtconlei14: shows [7h 8h] (a straight, Six to Ten)
pipinoelbreve9: shows [Td Ah] (two pair, Aces and Tens)
kurtconlei14 collected €3.32 from pot
*** SUMMARY ***
Total pot €3.49 | Rake €0.17 
Board [6s Th 9c As 3h]
Seat 1: nukilla888 (button) folded before Flop (didn't bet)
Seat 2: pera6521 (small blind) folded before Flop
Seat 3: kurtconlei14 (big blind) showed [7h 8h] and won (€3.32) with a straight, Six to Ten
Seat 4: KizoMaster folded before Flop (didn't bet)
Seat 5: spirou252 folded before Flop (didn't bet)
Seat 6: pipinoelbreve9 showed [Td Ah] and lost with two pair, Aces and Tens



PokerStars Zoom Hand #257438942590:  Hold'em No Limit (€0.01/€0.02) - 2025/08/22 10:40:00 CET [2025/08/22 4:40:00 ET]
Table 'Arneb' 6-max Seat #1 is the button
Seat 1: Danipro178 (€2.97 in chips) 
Seat 2: kurtconlei14 (€3.32 in chips) 
Seat 3: pipinoelbreve9 (€2 in chips) 
Seat 4: FELIPE439 (€2.87 in chips) 
Seat 5: MDKristian (€2 in chips) 
Seat 6: mrbroadway1106 (€0.97 in chips) 
kurtconlei14: posts small blind €0.01
pipinoelbreve9: posts big blind €0.02
*** HOLE CARDS ***
Dealt to pipinoelbreve9 [5d Tc]
FELIPE439: folds 
MDKristian: raises €0.02 to €0.04
mrbroadway1106: folds 
Danipro178: folds 
kurtconlei14: folds 
pipinoelbreve9: folds 
Uncalled bet (€0.02) returned to MDKristian
MDKristian collected €0.05 from pot
MDKristian: doesn't show hand 
*** SUMMARY ***
Total pot €0.05 | Rake €0 
Seat 1: Danipro178 (button) folded before Flop (didn't bet)
Seat 2: kurtconlei14 (small blind) folded before Flop
Seat 3: pipinoelbreve9 (big blind) folded before Flop
Seat 4: FELIPE439 folded before Flop (didn't bet)
Seat 5: MDKristian collected (€0.05)
Seat 6: mrbroadway1106 folded before Flop (didn't bet)



PokerStars Zoom Hand #257438943674:  Hold'em No Limit (€0.01/€0.02) - 2025/08/22 10:40:14 CET [2025/08/22 4:40:14 ET]
Table 'Arneb' 6-max Seat #1 is the button
Seat 1: pipinoelbreve9 (€2 in chips) 
Seat 2: PSCL61 (€3.73 in chips) 
Seat 3: JENOFONTE73 (€1.90 in chips) 
Seat 4: XXILuv (€2.20 in chips) 
Seat 5: FELIPE439 (€1.69 in chips) 
Seat 6: kurtconlei14 (€3.31 in chips) 
PSCL61: posts small blind €0.01
JENOFONTE73: posts big blind €0.02
*** HOLE CARDS ***
Dealt to pipinoelbreve9 [Td 7c]
XXILuv: folds 
FELIPE439: raises €0.04 to €0.06
kurtconlei14: folds 
pipinoelbreve9: folds 
PSCL61: folds 
JENOFONTE73: folds 
Uncalled bet (€0.04) returned to FELIPE439
FELIPE439 collected €0.05 from pot
FELIPE439: doesn't show hand 
*** SUMMARY ***
Total pot €0.05 | Rake €0 
Seat 1: pipinoelbreve9 (button) folded before Flop (didn't bet)
Seat 2: PSCL61 (small blind) folded before Flop
Seat 3: JENOFONTE73 (big blind) folded before Flop
Seat 4: XXILuv folded before Flop (didn't bet)
Seat 5: FELIPE439 collected (€0.05)
Seat 6: kurtconlei14 folded before Flop (didn't bet)



PokerStars Zoom Hand #257439387713:  Hold'em No Limit (€0.01/€0.02) - 2025/08/22 12:08:04 CET [2025/08/22 6:08:04 ET]
Table 'Arneb' 6-max Seat #1 is the button
Seat 1: k3lThuza2 (€2.03 in chips) 
Seat 2: gelotes (€2.20 in chips) 
Seat 3: pipinoelbreve9 (€2 in chips) 
Seat 4: flx5757 (€1.98 in chips) 
Seat 5: ReyGuto (€2.80 in chips) 
Seat 6: LittleVerole (€2.07 in chips) 
gelotes: posts small blind €0.01
pipinoelbreve9: posts big blind €0.02
*** HOLE CARDS ***
Dealt to pipinoelbreve9 [7s Qs]
flx5757: folds 
ReyGuto: folds 
LittleVerole: folds 
k3lThuza2: raises €0.04 to €0.06
gelotes: folds 
pipinoelbreve9: calls €0.04
*** FLOP *** [Ad 9c 4c]
pipinoelbreve9: checks 
k3lThuza2: bets €0.04
pipinoelbreve9: folds 
Uncalled bet (€0.04) returned to k3lThuza2
k3lThuza2 collected €0.12 from pot
k3lThuza2: doesn't show hand 
*** SUMMARY ***
Total pot €0.13 | Rake €0.01 
Board [Ad 9c 4c]
Seat 1: k3lThuza2 (button) collected (€0.12)
Seat 2: gelotes (small blind) folded before Flop
Seat 3: pipinoelbreve9 (big blind) folded on the Flop
Seat 4: flx5757 folded before Flop (didn't bet)
Seat 5: ReyGuto folded before Flop (didn't bet)
Seat 6: LittleVerole folded before Flop (didn't bet)



PokerStars Zoom Hand #257439392435:  Hold'em No Limit (€0.01/€0.02) - 2025/08/22 12:08:55 CET [2025/08/22 6:08:55 ET]
Table 'Arneb' 6-max Seat #1 is the button
Seat 1: bega13 (€3.39 in chips) 
Seat 2: Miguelitro66 (€2 in chips) 
Seat 3: EviL_FeeL (€0.69 in chips) 
Seat 4: pipinoelbreve9 (€2 in chips) 
Seat 5: XXILuv (€2.01 in chips) 
Seat 6: Comino79 (€2.42 in chips) 
Miguelitro66: posts small blind €0.01
EviL_FeeL: posts big blind €0.02
*** HOLE CARDS ***
Dealt to pipinoelbreve9 [7s Kd]
pipinoelbreve9: folds 
XXILuv: folds 
Comino79: raises €0.04 to €0.06
bega13: folds 
Miguelitro66: folds 
EviL_FeeL: folds 
Uncalled bet (€0.04) returned to Comino79
Comino79 collected €0.05 from pot
Comino79: doesn't show hand 
*** SUMMARY ***
Total pot €0.05 | Rake €0 
Seat 1: bega13 (button) folded before Flop (didn't bet)
Seat 2: Miguelitro66 (small blind) folded before Flop
Seat 3: EviL_FeeL (big blind) folded before Flop
Seat 4: pipinoelbreve9 folded before Flop (didn't bet)
Seat 5: XXILuv folded before Flop (didn't bet)
Seat 6: Comino79 collected (€0.05)



PokerStars Zoom Hand #257439393092:  Hold'em No Limit (€0.01/€0.02) - 2025/08/22 12:09:02 CET [2025/08/22 6:09:02 ET]
Table 'Arneb' 6-max Seat #1 is the button
Seat 1: bega13 (€2.75 in chips) 
Seat 2: hope201319 (€1.65 in chips) 
Seat 3: Javi_Marri (€2.64 in chips) 
Seat 4: ElPilarAA (€4.74 in chips) 
Seat 5: k3lThuza2 (€2.16 in chips) 
Seat 6: pipinoelbreve9 (€2 in chips) 
hope201319: posts small blind €0.01
Javi_Marri: posts big blind €0.02
*** HOLE CARDS ***
Dealt to pipinoelbreve9 [Th Js]
ElPilarAA: folds 
k3lThuza2: folds 
pipinoelbreve9: folds 
bega13: folds 
hope201319: folds 
Uncalled bet (€0.01) returned to Javi_Marri
Javi_Marri collected €0.02 from pot
Javi_Marri: doesn't show hand 
*** SUMMARY ***
Total pot €0.02 | Rake €0 
Seat 1: bega13 (button) folded before Flop (didn't bet)
Seat 2: hope201319 (small blind) folded before Flop
Seat 3: Javi_Marri (big blind) collected (€0.02)
Seat 4: ElPilarAA folded before Flop (didn't bet)
Seat 5: k3lThuza2 folded before Flop (didn't bet)
Seat 6: pipinoelbreve9 folded before Flop (didn't bet)



PokerStars Zoom Hand #257439391342:  Hold'em No Limit (€0.01/€0.02) - 2025/08/22 12:08:43 CET [2025/08/22 6:08:43 ET]
Table 'Arneb' 6-max Seat #1 is the button
Seat 1: pipinoelbreve9 (€2 in chips) 
Seat 2: juajord26 (€4.07 in chips) 
Seat 3: 77samuel33 (€2.87 in chips) 
Seat 4: hope201319 (€1.16 in chips) 
Seat 5: Lord_Shivaaa (€2.64 in chips) 
Seat 6: Javi_Marri (€2.65 in chips) 
juajord26: posts small blind €0.01
77samuel33: posts big blind €0.02
*** HOLE CARDS ***
Dealt to pipinoelbreve9 [6h Th]
hope201319: folds 
Lord_Shivaaa: folds 
Javi_Marri: folds 
pipinoelbreve9: folds 
juajord26: raises €0.04 to €0.06
77samuel33: calls €0.04
*** FLOP *** [Kh Ks 5h]
juajord26: bets €0.08
77samuel33: folds 
Uncalled bet (€0.08) returned to juajord26
juajord26 collected €0.11 from pot
juajord26: doesn't show hand 
*** SUMMARY ***
Total pot €0.12 | Rake €0.01 
Board [Kh Ks 5h]
Seat 1: pipinoelbreve9 (button) folded before Flop (didn't bet)
Seat 2: juajord26 (small blind) collected (€0.11)
Seat 3: 77samuel33 (big blind) folded on the Flop
Seat 4: hope201319 folded before Flop (didn't bet)
Seat 5: Lord_Shivaaa folded before Flop (didn't bet)
Seat 6: Javi_Marri folded before Flop (didn't bet)



PokerStars Zoom Hand #257439393688:  Hold'em No Limit (€0.01/€0.02) - 2025/08/22 12:09:08 CET [2025/08/22 6:09:08 ET]
Table 'Arneb' 6-max Seat #1 is the button
Seat 1: pipinoelbreve9 (€2 in chips) 
Seat 2: burgoa89 (€1.96 in chips) 
Seat 3: bega13 (€2.22 in chips) 
Seat 4: nofuture69 (€2.21 in chips) 
Seat 5: Lord_Shivaaa (€2 in chips) 
Seat 6: boogychat (€0.82 in chips) 
burgoa89: posts small blind €0.01
bega13: posts big blind €0.02
*** HOLE CARDS ***
Dealt to pipinoelbreve9 [8d 7c]
nofuture69: folds 
Lord_Shivaaa: folds 
boogychat: folds 
pipinoelbreve9: folds 
burgoa89: folds 
Uncalled bet (€0.01) returned to bega13
bega13 collected €0.02 from pot
bega13: doesn't show hand 
*** SUMMARY ***
Total pot €0.02 | Rake €0 
Seat 1: pipinoelbreve9 (button) folded before Flop (didn't bet)
Seat 2: burgoa89 (small blind) folded before Flop
Seat 3: bega13 (big blind) collected (€0.02)
Seat 4: nofuture69 folded before Flop (didn't bet)
Seat 5: Lord_Shivaaa folded before Flop (didn't bet)
Seat 6: boogychat folded before Flop (didn't bet)



PokerStars Zoom Hand #257439391000:  Hold'em No Limit (€0.01/€0.02) - 2025/08/22 12:08:40 CET [2025/08/22 6:08:40 ET]
Table 'Arneb' 6-max Seat #1 is the button
Seat 1: XXILuv (€2.01 in chips) 
Seat 2: pipinoelbreve9 (€2 in chips) 
Seat 3: Martial333 (€2.41 in chips) 
Seat 4: Javi_Marri (€2.65 in chips) 
Seat 5: SousaDstuff (€1.30 in chips) 
Seat 6: JOGARSA (€2.25 in chips) 
pipinoelbreve9: posts small blind €0.01
Martial333: posts big blind €0.02
*** HOLE CARDS ***
Dealt to pipinoelbreve9 [2d Kd]
Javi_Marri: folds 
SousaDstuff: folds 
JOGARSA: raises €0.03 to €0.05
XXILuv: folds 
pipinoelbreve9: folds 
Martial333: calls €0.03
*** FLOP *** [3h Jd 3s]
Martial333: checks 
JOGARSA: checks 
*** TURN *** [3h Jd 3s] [9d]
Martial333: bets €0.08
JOGARSA: raises €0.08 to €0.16
Martial333: calls €0.08
*** RIVER *** [3h Jd 3s 9d] [5d]
Martial333: bets €0.08
JOGARSA: raises €0.12 to €0.20
Martial333: calls €0.12
*** SHOW DOWN ***
JOGARSA: shows [3c 4c] (three of a kind, Threes)
Martial333: mucks hand 
JOGARSA collected €0.79 from pot
*** SUMMARY ***
Total pot €0.83 | Rake €0.04 
Board [3h Jd 3s 9d 5d]
Seat 1: XXILuv (button) folded before Flop (didn't bet)
Seat 2: pipinoelbreve9 (small blind) folded before Flop
Seat 3: Martial333 (big blind) mucked [Jc 2s]
Seat 4: Javi_Marri folded before Flop (didn't bet)
Seat 5: SousaDstuff folded before Flop (didn't bet)
Seat 6: JOGARSA showed [3c 4c] and won (€0.79) with three of a kind, Threes



PokerStars Zoom Hand #257439394101:  Hold'em No Limit (€0.01/€0.02) - 2025/08/22 12:09:13 CET [2025/08/22 6:09:13 ET]
Table 'Arneb' 6-max Seat #1 is the button
Seat 1: k3lThuza2 (€2.16 in chips) 
Seat 2: Vruj0 (€2.89 in chips) 
Seat 3: gelotes (€2.23 in chips) 
Seat 4: Lord_Shivaaa (€2 in chips) 
Seat 5: pipinoelbreve9 (€2 in chips) 
Seat 6: burgoa89 (€1.95 in chips) 
Vruj0: posts small blind €0.01
gelotes: posts big blind €0.02
*** HOLE CARDS ***
Dealt to pipinoelbreve9 [4s 4h]
Lord_Shivaaa: folds 
pipinoelbreve9: raises €0.04 to €0.06
burgoa89: folds 
k3lThuza2: calls €0.06
Vruj0: folds 
gelotes: folds 
*** FLOP *** [6s Qs 5s]
pipinoelbreve9: bets €0.04
k3lThuza2: folds 
Uncalled bet (€0.04) returned to pipinoelbreve9
pipinoelbreve9 collected €0.14 from pot
pipinoelbreve9: doesn't show hand 
*** SUMMARY ***
Total pot €0.15 | Rake €0.01 
Board [6s Qs 5s]
Seat 1: k3lThuza2 (button) folded on the Flop
Seat 2: Vruj0 (small blind) folded before Flop
Seat 3: gelotes (big blind) folded before Flop
Seat 4: Lord_Shivaaa folded before Flop (didn't bet)
Seat 5: pipinoelbreve9 collected (€0.14)
Seat 6: burgoa89 folded before Flop (didn't bet)



PokerStars Zoom Hand #257439396812:  Hold'em No Limit (€0.01/€0.02) - 2025/08/22 12:09:42 CET [2025/08/22 6:09:42 ET]
Table 'Arneb' 6-max Seat #1 is the button
Seat 1: burgoa89 (€1.95 in chips) 
Seat 2: pipinoelbreve9 (€2.08 in chips) 
Seat 3: jeannono24 (€2 in chips) 
Seat 4: Topuluz33 (€3.90 in chips) 
Seat 5: hope201319 (€1.62 in chips) 
Seat 6: olazunai (€1.80 in chips) 
pipinoelbreve9: posts small blind €0.01
jeannono24: posts big blind €0.02
*** HOLE CARDS ***
Dealt to pipinoelbreve9 [9c 7d]
Topuluz33: folds 
hope201319: folds 
olazunai: folds 
burgoa89: folds 
pipinoelbreve9: folds 
Uncalled bet (€0.01) returned to jeannono24
jeannono24 collected €0.02 from pot
jeannono24: doesn't show hand 
*** SUMMARY ***
Total pot €0.02 | Rake €0 
Seat 1: burgoa89 (button) folded before Flop (didn't bet)
Seat 2: pipinoelbreve9 (small blind) folded before Flop
Seat 3: jeannono24 (big blind) collected (€0.02)
Seat 4: Topuluz33 folded before Flop (didn't bet)
Seat 5: hope201319 folded before Flop (didn't bet)
Seat 6: olazunai folded before Flop (didn't bet)



PokerStars Zoom Hand #257439397438:  Hold'em No Limit (€0.01/€0.02) - 2025/08/22 12:09:49 CET [2025/08/22 6:09:49 ET]
Table 'Arneb' 6-max Seat #1 is the button
Seat 1: flx5757 (€1.65 in chips) 
Seat 2: k3lThuza2 (€2.11 in chips) 
Seat 3: pipinoelbreve9 (€2.07 in chips) 
Seat 4: nofuture69 (€2.20 in chips) 
Seat 5: juajord26 (€4.12 in chips) 
Seat 6: ElPilarAA (€4.76 in chips) 
k3lThuza2: posts small blind €0.01
pipinoelbreve9: posts big blind €0.02
*** HOLE CARDS ***
Dealt to pipinoelbreve9 [Td Ks]
nofuture69: folds 
juajord26: folds 
ElPilarAA: folds 
flx5757: raises €0.02 to €0.04
k3lThuza2: folds 
pipinoelbreve9: calls €0.02
*** FLOP *** [2c 4s 8h]
pipinoelbreve9: checks 
flx5757: bets €0.04
pipinoelbreve9: calls €0.04
*** TURN *** [2c 4s 8h] [4c]
pipinoelbreve9: checks 
flx5757: bets €0.08
pipinoelbreve9: folds 
Uncalled bet (€0.08) returned to flx5757
flx5757 collected €0.16 from pot
flx5757: doesn't show hand 
*** SUMMARY ***
Total pot €0.17 | Rake €0.01 
Board [2c 4s 8h 4c]
Seat 1: flx5757 (button) collected (€0.16)
Seat 2: k3lThuza2 (small blind) folded before Flop
Seat 3: pipinoelbreve9 (big blind) folded on the Turn
Seat 4: nofuture69 folded before Flop (didn't bet)
Seat 5: juajord26 folded before Flop (didn't bet)
Seat 6: ElPilarAA folded before Flop (didn't bet)



PokerStars Zoom Hand #257439400081:  Hold'em No Limit (€0.01/€0.02) - 2025/08/22 12:10:18 CET [2025/08/22 6:10:18 ET]
Table 'Arneb' 6-max Seat #1 is the button
Seat 1: pipinoelbreve9 (€2 in chips) 
Seat 2: hope201319 (€1.60 in chips) 
Seat 3: olazunai (€1.83 in chips) 
Seat 4: gangatattoo123 (€2.75 in chips) 
Seat 5: Lord_Shivaaa (€2 in chips) 
Seat 6: juajord26 (€2.16 in chips) 
hope201319: posts small blind €0.01
olazunai: posts big blind €0.02
*** HOLE CARDS ***
Dealt to pipinoelbreve9 [As 8s]
gangatattoo123: folds 
Lord_Shivaaa: folds 
juajord26: folds 
pipinoelbreve9: raises €0.04 to €0.06
hope201319: folds 
olazunai: calls €0.04
*** FLOP *** [Qs 5c 9s]
olazunai: checks 
pipinoelbreve9: bets €0.06
olazunai: calls €0.06
*** TURN *** [Qs 5c 9s] [4c]
olazunai: checks 
pipinoelbreve9: checks 
*** RIVER *** [Qs 5c 9s 4c] [5s]
olazunai: bets €0.16
pipinoelbreve9: raises €0.26 to €0.42
olazunai: folds 
Uncalled bet (€0.26) returned to pipinoelbreve9
pipinoelbreve9 collected €0.54 from pot
pipinoelbreve9: doesn't show hand 
*** SUMMARY ***
Total pot €0.57 | Rake €0.03 
Board [Qs 5c 9s 4c 5s]
Seat 1: pipinoelbreve9 (button) collected (€0.54)
Seat 2: hope201319 (small blind) folded before Flop
Seat 3: olazunai (big blind) folded on the River
Seat 4: gangatattoo123 folded before Flop (didn't bet)
Seat 5: Lord_Shivaaa folded before Flop (didn't bet)
Seat 6: juajord26 folded before Flop (didn't bet)



PokerStars Zoom Hand #257439404672:  Hold'em No Limit (€0.01/€0.02) - 2025/08/22 12:11:07 CET [2025/08/22 6:11:07 ET]
Table 'Arneb' 6-max Seat #1 is the button
Seat 1: XXILuv (€2.37 in chips) 
Seat 2: 77samuel33 (€2.53 in chips) 
Seat 3: nofuture69 (€2.03 in chips) 
Seat 4: xiro_7 (€2.06 in chips) 
Seat 5: bega13 (€2.72 in chips) 
Seat 6: pipinoelbreve9 (€2.26 in chips) 
77samuel33: posts small blind €0.01
nofuture69: posts big blind €0.02
*** HOLE CARDS ***
Dealt to pipinoelbreve9 [8h Jd]
xiro_7 is disconnected 
xiro_7 has timed out while disconnected
xiro_7: folds 
bega13: folds 
pipinoelbreve9: folds 
XXILuv: folds 
77samuel33: folds 
Uncalled bet (€0.01) returned to nofuture69
nofuture69 collected €0.02 from pot
nofuture69: doesn't show hand 
*** SUMMARY ***
Total pot €0.02 | Rake €0 
Seat 1: XXILuv (button) folded before Flop (didn't bet)
Seat 2: 77samuel33 (small blind) folded before Flop
Seat 3: nofuture69 (big blind) collected (€0.02)
Seat 4: xiro_7 folded before Flop (didn't bet)
Seat 5: bega13 folded before Flop (didn't bet)
Seat 6: pipinoelbreve9 folded before Flop (didn't bet)



PokerStars Zoom Hand #257439405142:  Hold'em No Limit (€0.01/€0.02) - 2025/08/22 12:11:11 CET [2025/08/22 6:11:11 ET]
Table 'Arneb' 6-max Seat #1 is the button
Seat 1: jeannono24 (€2.07 in chips) 
Seat 2: olazunai (€1.55 in chips) 
Seat 3: bega13 (€3.41 in chips) 
Seat 4: k3lThuza2 (€2.09 in chips) 
Seat 5: pipinoelbreve9 (€2.26 in chips) 
Seat 6: 77samuel33 (€2.52 in chips) 
olazunai: posts small blind €0.01
bega13: posts big blind €0.02
*** HOLE CARDS ***
Dealt to pipinoelbreve9 [5s Ad]
k3lThuza2: raises €0.04 to €0.06
pipinoelbreve9: folds 
77samuel33: folds 
jeannono24: folds 
olazunai: folds 
bega13: folds 
Uncalled bet (€0.04) returned to k3lThuza2
k3lThuza2 collected €0.05 from pot
k3lThuza2: doesn't show hand 
*** SUMMARY ***
Total pot €0.05 | Rake €0 
Seat 1: jeannono24 (button) folded before Flop (didn't bet)
Seat 2: olazunai (small blind) folded before Flop
Seat 3: bega13 (big blind) folded before Flop
Seat 4: k3lThuza2 collected (€0.05)
Seat 5: pipinoelbreve9 folded before Flop (didn't bet)
Seat 6: 77samuel33 folded before Flop (didn't bet)



PokerStars Zoom Hand #257439405725:  Hold'em No Limit (€0.01/€0.02) - 2025/08/22 12:11:18 CET [2025/08/22 6:11:18 ET]
Table 'Arneb' 6-max Seat #1 is the button
Seat 1: olazunai (€1.54 in chips) 
Seat 2: Lord_Shivaaa (€2.02 in chips) 
Seat 3: pipinoelbreve9 (€2.26 in chips) 
Seat 4: burgoa89 (€2.03 in chips) 
Seat 5: pera6521 (€2 in chips) 
Seat 6: k3lThuza2 (€2.14 in chips) 
Lord_Shivaaa: posts small blind €0.01
pipinoelbreve9: posts big blind €0.02
*** HOLE CARDS ***
Dealt to pipinoelbreve9 [Ah 3d]
burgoa89: folds 
pera6521: folds 
k3lThuza2: folds 
olazunai: folds 
Lord_Shivaaa: folds 
Uncalled bet (€0.01) returned to pipinoelbreve9
pipinoelbreve9 collected €0.02 from pot
pipinoelbreve9: doesn't show hand 
*** SUMMARY ***
Total pot €0.02 | Rake €0 
Seat 1: olazunai (button) folded before Flop (didn't bet)
Seat 2: Lord_Shivaaa (small blind) folded before Flop
Seat 3: pipinoelbreve9 (big blind) collected (€0.02)
Seat 4: burgoa89 folded before Flop (didn't bet)
Seat 5: pera6521 folded before Flop (didn't bet)
Seat 6: k3lThuza2 folded before Flop (didn't bet)



PokerStars Zoom Hand #257439407167:  Hold'em No Limit (€0.01/€0.02) - 2025/08/22 12:11:34 CET [2025/08/22 6:11:34 ET]
Table 'Arneb' 6-max Seat #1 is the button
Seat 1: booster74 (€2 in chips) 
Seat 2: XXILuv (€1.98 in chips) 
Seat 3: jeannono24 (€2 in chips) 
Seat 4: flx5757 (€0.94 in chips) 
Seat 5: pipinoelbreve9 (€2.27 in chips) 
Seat 6: aaronroxi (€2 in chips) 
XXILuv: posts small blind €0.01
jeannono24: posts big blind €0.02
*** HOLE CARDS ***
Dealt to pipinoelbreve9 [6c 3h]
flx5757: raises €0.02 to €0.04
pipinoelbreve9: folds 
aaronroxi: folds 
booster74: folds 
XXILuv: folds 
jeannono24: folds 
Uncalled bet (€0.02) returned to flx5757
flx5757 collected €0.05 from pot
flx5757: doesn't show hand 
*** SUMMARY ***
Total pot €0.05 | Rake €0 
Seat 1: booster74 (button) folded before Flop (didn't bet)
Seat 2: XXILuv (small blind) folded before Flop
Seat 3: jeannono24 (big blind) folded before Flop
Seat 4: flx5757 collected (€0.05)
Seat 5: pipinoelbreve9 folded before Flop (didn't bet)
Seat 6: aaronroxi folded before Flop (didn't bet)



PokerStars Zoom Hand #257439409284:  Hold'em No Limit (€0.01/€0.02) - 2025/08/22 12:11:57 CET [2025/08/22 6:11:57 ET]
Table 'Arneb' 6-max Seat #1 is the button
Seat 1: pipinoelbreve9 (€2.26 in chips) 
Seat 2: LittleVerole (€4.29 in chips) 
Seat 3: 77samuel33 (€2 in chips) 
Seat 4: Pabl0o0Poker (€3.75 in chips) 
Seat 5: k3lThuza2 (€2.78 in chips) 
Seat 6: Topuluz33 (€2 in chips) 
LittleVerole: posts small blind €0.01
77samuel33: posts big blind €0.02
*** HOLE CARDS ***
Dealt to pipinoelbreve9 [5s 2h]
Pabl0o0Poker: folds 
k3lThuza2: folds 
Topuluz33: folds 
pipinoelbreve9: folds 
LittleVerole: folds 
Uncalled bet (€0.01) returned to 77samuel33
77samuel33 collected €0.02 from pot
77samuel33: doesn't show hand 
*** SUMMARY ***
Total pot €0.02 | Rake €0 
Seat 1: pipinoelbreve9 (button) folded before Flop (didn't bet)
Seat 2: LittleVerole (small blind) folded before Flop
Seat 3: 77samuel33 (big blind) collected (€0.02)
Seat 4: Pabl0o0Poker folded before Flop (didn't bet)
Seat 5: k3lThuza2 folded before Flop (didn't bet)
Seat 6: Topuluz33 folded before Flop (didn't bet)



PokerStars Zoom Hand #257439409959:  Hold'em No Limit (€0.01/€0.02) - 2025/08/22 12:12:04 CET [2025/08/22 6:12:04 ET]
Table 'Arneb' 6-max Seat #1 is the button
Seat 1: hope201319 (€2.05 in chips) 
Seat 2: Pabl0o0Poker (€3.75 in chips) 
Seat 3: StrangeNoumena (€1.82 in chips) 
Seat 4: pipinoelbreve9 (€2.26 in chips) 
Seat 5: booster74 (€2.03 in chips) 
Seat 6: Lord_Shivaaa (€2 in chips) 
Pabl0o0Poker: posts small blind €0.01
StrangeNoumena: posts big blind €0.02
*** HOLE CARDS ***
Dealt to pipinoelbreve9 [As 5h]
pipinoelbreve9: folds 
booster74: folds 
Lord_Shivaaa: folds 
hope201319: raises €0.04 to €0.06
Pabl0o0Poker: folds 
StrangeNoumena: folds 
Uncalled bet (€0.04) returned to hope201319
hope201319 collected €0.05 from pot
hope201319: doesn't show hand 
*** SUMMARY ***
Total pot €0.05 | Rake €0 
Seat 1: hope201319 (button) collected (€0.05)
Seat 2: Pabl0o0Poker (small blind) folded before Flop
Seat 3: StrangeNoumena (big blind) folded before Flop
Seat 4: pipinoelbreve9 folded before Flop (didn't bet)
Seat 5: booster74 folded before Flop (didn't bet)
Seat 6: Lord_Shivaaa folded before Flop (didn't bet)



PokerStars Zoom Hand #257439407640:  Hold'em No Limit (€0.01/€0.02) - 2025/08/22 12:11:39 CET [2025/08/22 6:11:39 ET]
Table 'Arneb' 6-max Seat #1 is the button
Seat 1: siddhartasr (€1.98 in chips) 
Seat 2: pipinoelbreve9 (€2.27 in chips) 
Seat 3: JOGARSA (€2.63 in chips) 
Seat 4: Mazebank46 (€4.59 in chips) 
Seat 5: bega13 (€2.70 in chips) 
Seat 6: jeannono24 (€2.08 in chips) 
pipinoelbreve9: posts small blind €0.01
JOGARSA: posts big blind €0.02
*** HOLE CARDS ***
Dealt to pipinoelbreve9 [3h 2c]
Mazebank46: folds 
bega13: folds 
jeannono24: raises €0.03 to €0.05
siddhartasr: folds 
pipinoelbreve9: folds 
JOGARSA: raises €0.11 to €0.16
jeannono24: folds 
Uncalled bet (€0.11) returned to JOGARSA
JOGARSA collected €0.11 from pot
JOGARSA: doesn't show hand 
*** SUMMARY ***
Total pot €0.11 | Rake €0 
Seat 1: siddhartasr (button) folded before Flop (didn't bet)
Seat 2: pipinoelbreve9 (small blind) folded before Flop
Seat 3: JOGARSA (big blind) collected (€0.11)
Seat 4: Mazebank46 folded before Flop (didn't bet)
Seat 5: bega13 folded before Flop (didn't bet)
Seat 6: jeannono24 folded before Flop



PokerStars Zoom Hand #257439410965:  Hold'em No Limit (€0.01/€0.02) - 2025/08/22 12:12:15 CET [2025/08/22 6:12:15 ET]
Table 'Arneb' 6-max Seat #1 is the button
Seat 1: LittleVerole (€4.31 in chips) 
Seat 2: pipinoelbreve9 (€2.26 in chips) 
Seat 3: Vruj0 (€2 in chips) 
Seat 4: Martial333 (€2.05 in chips) 
Seat 5: ReyGuto (€2.78 in chips) 
Seat 6: bega13 (€2.57 in chips) 
pipinoelbreve9: posts small blind €0.01
Vruj0: posts big blind €0.02
*** HOLE CARDS ***
Dealt to pipinoelbreve9 [2h 8d]
Martial333: folds 
ReyGuto: folds 
bega13: folds 
LittleVerole: folds 
pipinoelbreve9: folds 
Uncalled bet (€0.01) returned to Vruj0
Vruj0 collected €0.02 from pot
Vruj0: doesn't show hand 
*** SUMMARY ***
Total pot €0.02 | Rake €0 
Seat 1: LittleVerole (button) folded before Flop (didn't bet)
Seat 2: pipinoelbreve9 (small blind) folded before Flop
Seat 3: Vruj0 (big blind) collected (€0.02)
Seat 4: Martial333 folded before Flop (didn't bet)
Seat 5: ReyGuto folded before Flop (didn't bet)
Seat 6: bega13 folded before Flop (didn't bet)



PokerStars Zoom Hand #257439410601:  Hold'em No Limit (€0.01/€0.02) - 2025/08/22 12:12:11 CET [2025/08/22 6:12:11 ET]
Table 'Arneb' 6-max Seat #1 is the button
Seat 1: 34Sirina (€1.01 in chips) 
Seat 2: bega13 (€2.58 in chips) 
Seat 3: burgoa89 (€2.02 in chips) 
Seat 4: k3lThuza2 (€2.12 in chips) 
Seat 5: aaronroxi (€2.05 in chips) 
Seat 6: pipinoelbreve9 (€2.26 in chips) 
bega13: posts small blind €0.01
burgoa89: posts big blind €0.02
*** HOLE CARDS ***
Dealt to pipinoelbreve9 [6c 2d]
k3lThuza2: folds 
aaronroxi: folds 
pipinoelbreve9: folds 
34Sirina: folds 
bega13: folds 
Uncalled bet (€0.01) returned to burgoa89
burgoa89 collected €0.02 from pot
burgoa89: doesn't show hand 
*** SUMMARY ***
Total pot €0.02 | Rake €0 
Seat 1: 34Sirina (button) folded before Flop (didn't bet)
Seat 2: bega13 (small blind) folded before Flop
Seat 3: burgoa89 (big blind) collected (€0.02)
Seat 4: k3lThuza2 folded before Flop (didn't bet)
Seat 5: aaronroxi folded before Flop (didn't bet)
Seat 6: pipinoelbreve9 folded before Flop (didn't bet)



PokerStars Zoom Hand #257439407929:  Hold'em No Limit (€0.01/€0.02) - 2025/08/22 12:11:42 CET [2025/08/22 6:11:42 ET]
Table 'Arneb' 6-max Seat #1 is the button
Seat 1: bega13 (€2.70 in chips) 
Seat 2: olazunai (€1.52 in chips) 
Seat 3: meruem70 (€1.47 in chips) 
Seat 4: pipinoelbreve9 (€2.26 in chips) 
Seat 5: ReyGuto (€2.75 in chips) 
Seat 6: JENOFONTE73 (€2.78 in chips) 
olazunai: posts small blind €0.01
meruem70: posts big blind €0.02
*** HOLE CARDS ***
Dealt to pipinoelbreve9 [6h Qs]
pipinoelbreve9: folds 
ReyGuto: folds 
JENOFONTE73: folds 
bega13: folds 
olazunai: raises €0.04 to €0.06
meruem70: calls €0.04
*** FLOP *** [9h Kh 4s]
olazunai: bets €0.06
meruem70: raises €0.08 to €0.14
olazunai: raises €1.32 to €1.46 and is all-in
meruem70: calls €1.27 and is all-in
Uncalled bet (€0.05) returned to olazunai
*** TURN *** [9h Kh 4s] [5c]
*** RIVER *** [9h Kh 4s 5c] [9d]
*** SHOW DOWN ***
olazunai: shows [4d 4c] (a full house, Fours full of Nines)
meruem70: shows [3h Jh] (a pair of Nines)
olazunai collected €2.79 from pot
*** SUMMARY ***
Total pot €2.94 | Rake €0.15 
Board [9h Kh 4s 5c 9d]
Seat 1: bega13 (button) folded before Flop (didn't bet)
Seat 2: olazunai (small blind) showed [4d 4c] and won (€2.79) with a full house, Fours full of Nines
Seat 3: meruem70 (big blind) showed [3h Jh] and lost with a pair of Nines
Seat 4: pipinoelbreve9 folded before Flop (didn't bet)
Seat 5: ReyGuto folded before Flop (didn't bet)
Seat 6: JENOFONTE73 folded before Flop (didn't bet)



PokerStars Zoom Hand #257439411351:  Hold'em No Limit (€0.01/€0.02) - 2025/08/22 12:12:19 CET [2025/08/22 6:12:19 ET]
Table 'Arneb' 6-max Seat #1 is the button
Seat 1: StrangeNoumena (€1.80 in chips) 
Seat 2: ReyGuto (€2.78 in chips) 
Seat 3: pipinoelbreve9 (€2.25 in chips) 
Seat 4: k3lThuza2 (€2.12 in chips) 
Seat 5: 33baba33 (€2 in chips) 
Seat 6: XXILuv (€2.06 in chips) 
ReyGuto: posts small blind €0.01
pipinoelbreve9: posts big blind €0.02
*** HOLE CARDS ***
Dealt to pipinoelbreve9 [Qs 6h]
k3lThuza2: folds 
33baba33: folds 
XXILuv: folds 
StrangeNoumena: raises €0.04 to €0.06
ReyGuto: folds 
pipinoelbreve9: folds 
Uncalled bet (€0.04) returned to StrangeNoumena
StrangeNoumena collected €0.05 from pot
StrangeNoumena: doesn't show hand 
*** SUMMARY ***
Total pot €0.05 | Rake €0 
Seat 1: StrangeNoumena (button) collected (€0.05)
Seat 2: ReyGuto (small blind) folded before Flop
Seat 3: pipinoelbreve9 (big blind) folded before Flop
Seat 4: k3lThuza2 folded before Flop (didn't bet)
Seat 5: 33baba33 folded before Flop (didn't bet)
Seat 6: XXILuv folded before Flop (didn't bet)



PokerStars Zoom Hand #257439408763:  Hold'em No Limit (€0.01/€0.02) - 2025/08/22 12:11:51 CET [2025/08/22 6:11:51 ET]
Table 'Arneb' 6-max Seat #1 is the button
Seat 1: LarryLurex72 (€2.04 in chips) 
Seat 2: Lord_Shivaaa (€2 in chips) 
Seat 3: figuerola2323 (€3.07 in chips) 
Seat 4: hope201319 (€1.19 in chips) 
Seat 5: JENOFONTE73 (€2.78 in chips) 
Seat 6: pipinoelbreve9 (€2.26 in chips) 
Lord_Shivaaa: posts small blind €0.01
figuerola2323: posts big blind €0.02
*** HOLE CARDS ***
Dealt to pipinoelbreve9 [6d As]
hope201319: folds 
JENOFONTE73: folds 
pipinoelbreve9: folds 
LarryLurex72: raises €0.02 to €0.04
Lord_Shivaaa: folds 
figuerola2323: calls €0.02
*** FLOP *** [3d 3s 2c]
figuerola2323: checks 
LarryLurex72: checks 
*** TURN *** [3d 3s 2c] [Td]
figuerola2323: bets €0.05
LarryLurex72: calls €0.05
*** RIVER *** [3d 3s 2c Td] [7d]
figuerola2323: bets €0.09
LarryLurex72: raises €0.11 to €0.20
figuerola2323: raises €0.58 to €0.78
LarryLurex72: calls €0.58
*** SHOW DOWN ***
figuerola2323: shows [Js Jd] (two pair, Jacks and Threes)
LarryLurex72: shows [5c 3c] (three of a kind, Threes)
LarryLurex72 collected €1.66 from pot
*** SUMMARY ***
Total pot €1.75 | Rake €0.09 
Board [3d 3s 2c Td 7d]
Seat 1: LarryLurex72 (button) showed [5c 3c] and won (€1.66) with three of a kind, Threes
Seat 2: Lord_Shivaaa (small blind) folded before Flop
Seat 3: figuerola2323 (big blind) showed [Js Jd] and lost with two pair, Jacks and Threes
Seat 4: hope201319 folded before Flop (didn't bet)
Seat 5: JENOFONTE73 folded before Flop (didn't bet)
Seat 6: pipinoelbreve9 folded before Flop (didn't bet)



PokerStars Zoom Hand #257439413055:  Hold'em No Limit (€0.01/€0.02) - 2025/08/22 12:12:37 CET [2025/08/22 6:12:37 ET]
Table 'Arneb' 6-max Seat #1 is the button
Seat 1: pipinoelbreve9 (€2.23 in chips) 
Seat 2: NCabral_SCP (€1.99 in chips) 
Seat 3: Pabl0o0Poker (€1 in chips) 
Seat 4: StrangeNoumena (€1.83 in chips) 
Seat 5: Lord_Shivaaa (€3.90 in chips) 
Seat 6: 77samuel33 (€2 in chips) 
NCabral_SCP: posts small blind €0.01
Pabl0o0Poker: posts big blind €0.02
*** HOLE CARDS ***
Dealt to pipinoelbreve9 [7s 7d]
StrangeNoumena: raises €0.04 to €0.06
Lord_Shivaaa: folds 
77samuel33: folds 
pipinoelbreve9: calls €0.06
NCabral_SCP: folds 
Pabl0o0Poker: folds 
*** FLOP *** [5d 5c 9h]
StrangeNoumena: checks 
pipinoelbreve9: bets €0.07
StrangeNoumena: folds 
Uncalled bet (€0.07) returned to pipinoelbreve9
pipinoelbreve9 collected €0.14 from pot
pipinoelbreve9: doesn't show hand 
*** SUMMARY ***
Total pot €0.15 | Rake €0.01 
Board [5d 5c 9h]
Seat 1: pipinoelbreve9 (button) collected (€0.14)
Seat 2: NCabral_SCP (small blind) folded before Flop
Seat 3: Pabl0o0Poker (big blind) folded before Flop
Seat 4: StrangeNoumena folded on the Flop
Seat 5: Lord_Shivaaa folded before Flop (didn't bet)
Seat 6: 77samuel33 folded before Flop (didn't bet)



PokerStars Zoom Hand #257439415203:  Hold'em No Limit (€0.01/€0.02) - 2025/08/22 12:13:01 CET [2025/08/22 6:13:01 ET]
Table 'Arneb' 6-max Seat #1 is the button
Seat 1: JOGARSA (€2.77 in chips) 
Seat 2: XXILuv (€2.09 in chips) 
Seat 3: pipinoelbreve9 (€2.31 in chips) 
Seat 4: gangatattoo123 (€2.34 in chips) 
Seat 5: 77samuel33 (€8.01 in chips) 
Seat 6: Valencinco (€2.68 in chips) 
XXILuv: posts small blind €0.01
pipinoelbreve9: posts big blind €0.02
*** HOLE CARDS ***
Dealt to pipinoelbreve9 [2s 7h]
gangatattoo123: folds 
77samuel33: folds 
Valencinco: folds 
JOGARSA: raises €0.03 to €0.05
XXILuv: folds 
pipinoelbreve9: folds 
Uncalled bet (€0.03) returned to JOGARSA
JOGARSA collected €0.05 from pot
JOGARSA: doesn't show hand 
*** SUMMARY ***
Total pot €0.05 | Rake €0 
Seat 1: JOGARSA (button) collected (€0.05)
Seat 2: XXILuv (small blind) folded before Flop
Seat 3: pipinoelbreve9 (big blind) folded before Flop
Seat 4: gangatattoo123 folded before Flop (didn't bet)
Seat 5: 77samuel33 folded before Flop (didn't bet)
Seat 6: Valencinco folded before Flop (didn't bet)



PokerStars Zoom Hand #257439416483:  Hold'em No Limit (€0.01/€0.02) - 2025/08/22 12:13:15 CET [2025/08/22 6:13:15 ET]
Table 'Arneb' 6-max Seat #1 is the button
Seat 1: Lord_Shivaaa (€2 in chips) 
Seat 2: 77samuel33 (€2.03 in chips) 
Seat 3: pera6521 (€2.81 in chips) 
Seat 4: bega13 (€2.62 in chips) 
Seat 5: Miguelitro66 (€2.04 in chips) 
Seat 6: pipinoelbreve9 (€2.29 in chips) 
77samuel33: posts small blind €0.01
pera6521: posts big blind €0.02
*** HOLE CARDS ***
Dealt to pipinoelbreve9 [Ts Kd]
bega13: folds 
Miguelitro66: folds 
pipinoelbreve9: raises €0.04 to €0.06
Lord_Shivaaa: raises €0.09 to €0.15
77samuel33: folds 
pera6521: folds 
pipinoelbreve9: folds 
Uncalled bet (€0.09) returned to Lord_Shivaaa
Lord_Shivaaa collected €0.15 from pot
Lord_Shivaaa: doesn't show hand 
*** SUMMARY ***
Total pot €0.15 | Rake €0 
Seat 1: Lord_Shivaaa (button) collected (€0.15)
Seat 2: 77samuel33 (small blind) folded before Flop
Seat 3: pera6521 (big blind) folded before Flop
Seat 4: bega13 folded before Flop (didn't bet)
Seat 5: Miguelitro66 folded before Flop (didn't bet)
Seat 6: pipinoelbreve9 folded before Flop



PokerStars Zoom Hand #257439412462:  Hold'em No Limit (€0.01/€0.02) - 2025/08/22 12:12:31 CET [2025/08/22 6:12:31 ET]
Table 'Arneb' 6-max Seat #1 is the button
Seat 1: burgoa89 (€2.03 in chips) 
Seat 2: flx5757 (€0.94 in chips) 
Seat 3: bega13 (€2.65 in chips) 
Seat 4: hope201319 (€2.08 in chips) 
Seat 5: pipinoelbreve9 (€2.23 in chips) 
Seat 6: k3lThuza2 (€2.08 in chips) 
flx5757: posts small blind €0.01
bega13: posts big blind €0.02
*** HOLE CARDS ***
Dealt to pipinoelbreve9 [Jd 7c]
hope201319: folds 
pipinoelbreve9: folds 
k3lThuza2: raises €0.04 to €0.06
burgoa89: folds 
flx5757: calls €0.05
bega13: folds 
*** FLOP *** [2d As 9h]
flx5757: bets €0.06
k3lThuza2: raises €0.08 to €0.14
flx5757: calls €0.08
*** TURN *** [2d As 9h] [9s]
flx5757: bets €0.02
k3lThuza2: calls €0.02
*** RIVER *** [2d As 9h 9s] [3c]
flx5757: checks 
k3lThuza2: bets €0.15
flx5757: raises €0.57 to €0.72 and is all-in
k3lThuza2: folds 
Uncalled bet (€0.57) returned to flx5757
flx5757 collected €0.72 from pot
flx5757: doesn't show hand 
*** SUMMARY ***
Total pot €0.76 | Rake €0.04 
Board [2d As 9h 9s 3c]
Seat 1: burgoa89 (button) folded before Flop (didn't bet)
Seat 2: flx5757 (small blind) collected (€0.72)
Seat 3: bega13 (big blind) folded before Flop
Seat 4: hope201319 folded before Flop (didn't bet)
Seat 5: pipinoelbreve9 folded before Flop (didn't bet)
Seat 6: k3lThuza2 folded on the River



PokerStars Zoom Hand #257439417712:  Hold'em No Limit (€0.01/€0.02) - 2025/08/22 12:13:28 CET [2025/08/22 6:13:28 ET]
Table 'Arneb' 6-max Seat #1 is the button
Seat 1: Valencinco (€2.71 in chips) 
Seat 2: pipinoelbreve9 (€2.23 in chips) 
Seat 3: k3lThuza2 (€2.78 in chips) 
Seat 4: gangatattoo123 (€2.36 in chips) 
Seat 5: XXILuv (€2.14 in chips) 
Seat 6: Lord_Shivaaa (€2.97 in chips) 
pipinoelbreve9: posts small blind €0.01
k3lThuza2: posts big blind €0.02
*** HOLE CARDS ***
Dealt to pipinoelbreve9 [Jd 2c]
gangatattoo123: folds 
XXILuv: folds 
Lord_Shivaaa: folds 
Valencinco: folds 
pipinoelbreve9: folds 
Uncalled bet (€0.01) returned to k3lThuza2
k3lThuza2 collected €0.02 from pot
k3lThuza2: doesn't show hand 
*** SUMMARY ***
Total pot €0.02 | Rake €0 
Seat 1: Valencinco (button) folded before Flop (didn't bet)
Seat 2: pipinoelbreve9 (small blind) folded before Flop
Seat 3: k3lThuza2 (big blind) collected (€0.02)
Seat 4: gangatattoo123 folded before Flop (didn't bet)
Seat 5: XXILuv folded before Flop (didn't bet)
Seat 6: Lord_Shivaaa folded before Flop (didn't bet)



PokerStars Zoom Hand #257439418167:  Hold'em No Limit (€0.01/€0.02) - 2025/08/22 12:13:33 CET [2025/08/22 6:13:33 ET]
Table 'Arneb' 6-max Seat #1 is the button
Seat 1: ReyGuto (€2.77 in chips) 
Seat 2: Lord_Shivaaa (€2.97 in chips) 
Seat 3: Valencinco (€2.71 in chips) 
Seat 4: XXILuv (€2.14 in chips) 
Seat 5: pipinoelbreve9 (€2.22 in chips) 
Seat 6: MRG1488ADOLF (€1.07 in chips) 
Lord_Shivaaa: posts small blind €0.01
Valencinco: posts big blind €0.02
*** HOLE CARDS ***
Dealt to pipinoelbreve9 [Qd 4s]
XXILuv: folds 
pipinoelbreve9: folds 
MRG1488ADOLF: raises €0.08 to €0.10
ReyGuto: folds 
Lord_Shivaaa: folds 
Valencinco: folds 
Uncalled bet (€0.08) returned to MRG1488ADOLF
MRG1488ADOLF collected €0.05 from pot
MRG1488ADOLF: doesn't show hand 
*** SUMMARY ***
Total pot €0.05 | Rake €0 
Seat 1: ReyGuto (button) folded before Flop (didn't bet)
Seat 2: Lord_Shivaaa (small blind) folded before Flop
Seat 3: Valencinco (big blind) folded before Flop
Seat 4: XXILuv folded before Flop (didn't bet)
Seat 5: pipinoelbreve9 folded before Flop (didn't bet)
Seat 6: MRG1488ADOLF collected (€0.05)



PokerStars Zoom Hand #257439418562:  Hold'em No Limit (€0.01/€0.02) - 2025/08/22 12:13:37 CET [2025/08/22 6:13:37 ET]
Table 'Arneb' 6-max Seat #1 is the button
Seat 1: Vruj0 (€2.16 in chips) 
Seat 2: pera6521 (€2.79 in chips) 
Seat 3: Martial333 (€1.88 in chips) 
Seat 4: pipinoelbreve9 (€2.22 in chips) 
Seat 5: LittleVerole (€4.24 in chips) 
Seat 6: siddhartasr (€2.10 in chips) 
pera6521: posts small blind €0.01
Martial333: posts big blind €0.02
*** HOLE CARDS ***
Dealt to pipinoelbreve9 [9h 9s]
pipinoelbreve9: raises €0.04 to €0.06
LittleVerole: folds 
siddhartasr: folds 
Vruj0: folds 
pera6521: folds 
Martial333: raises €0.16 to €0.22
pipinoelbreve9: calls €0.16
*** FLOP *** [3c 5c 5h]
Martial333: bets €1.66 and is all-in
pipinoelbreve9: folds 
Uncalled bet (€1.66) returned to Martial333
Martial333 collected €0.43 from pot
Martial333: doesn't show hand 
*** SUMMARY ***
Total pot €0.45 | Rake €0.02 
Board [3c 5c 5h]
Seat 1: Vruj0 (button) folded before Flop (didn't bet)
Seat 2: pera6521 (small blind) folded before Flop
Seat 3: Martial333 (big blind) collected (€0.43)
Seat 4: pipinoelbreve9 folded on the Flop
Seat 5: LittleVerole folded before Flop (didn't bet)
Seat 6: siddhartasr folded before Flop (didn't bet)



PokerStars Zoom Hand #257439421506:  Hold'em No Limit (€0.01/€0.02) - 2025/08/22 12:14:08 CET [2025/08/22 6:14:08 ET]
Table 'Arneb' 6-max Seat #1 is the button
Seat 1: Valencinco (€2.22 in chips) 
Seat 2: XXILuv (€2.04 in chips) 
Seat 3: JENOFONTE73 (€2.51 in chips) 
Seat 4: pipinoelbreve9 (€2 in chips) 
Seat 5: Lord_Shivaaa (€2.94 in chips) 
Seat 6: burgoa89 (€2.03 in chips) 
XXILuv: posts small blind €0.01
JENOFONTE73: posts big blind €0.02
*** HOLE CARDS ***
Dealt to pipinoelbreve9 [6h Kh]
pipinoelbreve9: folds 
Lord_Shivaaa: folds 
burgoa89: folds 
Valencinco: folds 
XXILuv: folds 
Uncalled bet (€0.01) returned to JENOFONTE73
JENOFONTE73 collected €0.02 from pot
JENOFONTE73: doesn't show hand 
*** SUMMARY ***
Total pot €0.02 | Rake €0 
Seat 1: Valencinco (button) folded before Flop (didn't bet)
Seat 2: XXILuv (small blind) folded before Flop
Seat 3: JENOFONTE73 (big blind) collected (€0.02)
Seat 4: pipinoelbreve9 folded before Flop (didn't bet)
Seat 5: Lord_Shivaaa folded before Flop (didn't bet)
Seat 6: burgoa89 folded before Flop (didn't bet)



PokerStars Zoom Hand #257439421870:  Hold'em No Limit (€0.01/€0.02) - 2025/08/22 12:14:12 CET [2025/08/22 6:14:12 ET]
Table 'Arneb' 6-max Seat #1 is the button
Seat 1: booster74 (€2.07 in chips) 
Seat 2: pipinoelbreve9 (€2 in chips) 
Seat 3: Jonah Brt (€1.29 in chips) 
Seat 4: juajord26 (€2.30 in chips) 
Seat 5: Valencinco (€2.22 in chips) 
Seat 6: gangatattoo123 (€2.29 in chips) 
pipinoelbreve9: posts small blind €0.01
Jonah Brt: posts big blind €0.02
*** HOLE CARDS ***
Dealt to pipinoelbreve9 [9c 9h]
juajord26: folds 
Valencinco: folds 
gangatattoo123: raises €0.02 to €0.04
booster74: folds 
pipinoelbreve9: raises €0.10 to €0.14
Jonah Brt: folds 
gangatattoo123: folds 
Uncalled bet (€0.10) returned to pipinoelbreve9
pipinoelbreve9 collected €0.10 from pot
pipinoelbreve9: doesn't show hand 
*** SUMMARY ***
Total pot €0.10 | Rake €0 
Seat 1: booster74 (button) folded before Flop (didn't bet)
Seat 2: pipinoelbreve9 (small blind) collected (€0.10)
Seat 3: Jonah Brt (big blind) folded before Flop
Seat 4: juajord26 folded before Flop (didn't bet)
Seat 5: Valencinco folded before Flop (didn't bet)
Seat 6: gangatattoo123 folded before Flop



PokerStars Zoom Hand #257439424651:  Hold'em No Limit (€0.01/€0.02) - 2025/08/22 12:14:42 CET [2025/08/22 6:14:42 ET]
Table 'Arneb' 6-max Seat #1 is the button
Seat 1: pipinoelbreve9 (€2.06 in chips) 
Seat 2: LittleVerole (€4.21 in chips) 
Seat 3: bega13 (€2.39 in chips) 
Seat 4: XXILuv (€2.03 in chips) 
Seat 5: RudeBoy23 (€2.02 in chips) 
Seat 6: Miguelitro66 (€2 in chips) 
LittleVerole: posts small blind €0.01
bega13: posts big blind €0.02
*** HOLE CARDS ***
Dealt to pipinoelbreve9 [Ks Jc]
XXILuv: folds 
RudeBoy23: folds 
Miguelitro66: raises €0.03 to €0.05
pipinoelbreve9: calls €0.05
LittleVerole: folds 
bega13: folds 
*** FLOP *** [7c 9h 2d]
Miguelitro66: checks 
pipinoelbreve9: checks 
*** TURN *** [7c 9h 2d] [Ad]
Miguelitro66: bets €0.06
pipinoelbreve9: folds 
Uncalled bet (€0.06) returned to Miguelitro66
Miguelitro66 collected €0.12 from pot
Miguelitro66: doesn't show hand 
*** SUMMARY ***
Total pot €0.13 | Rake €0.01 
Board [7c 9h 2d Ad]
Seat 1: pipinoelbreve9 (button) folded on the Turn
Seat 2: LittleVerole (small blind) folded before Flop
Seat 3: bega13 (big blind) folded before Flop
Seat 4: XXILuv folded before Flop (didn't bet)
Seat 5: RudeBoy23 folded before Flop (didn't bet)
Seat 6: Miguelitro66 collected (€0.12)



PokerStars Zoom Hand #257439427441:  Hold'em No Limit (€0.01/€0.02) - 2025/08/22 12:15:12 CET [2025/08/22 6:15:12 ET]
Table 'Arneb' 6-max Seat #1 is the button
Seat 1: 77samuel33 (€2 in chips) 
Seat 2: Lord_Shivaaa (€2.06 in chips) 
Seat 3: pipinoelbreve9 (€2.01 in chips) 
Seat 4: Miguelitro66 (€2.07 in chips) 
Seat 5: Ksunm (€1.77 in chips) 
Seat 6: jeannono24 (€3.11 in chips) 
Lord_Shivaaa: posts small blind €0.01
pipinoelbreve9: posts big blind €0.02
*** HOLE CARDS ***
Dealt to pipinoelbreve9 [7c 3h]
Miguelitro66: folds 
Ksunm: folds 
jeannono24: folds 
77samuel33: folds 
Lord_Shivaaa: folds 
Uncalled bet (€0.01) returned to pipinoelbreve9
pipinoelbreve9 collected €0.02 from pot
pipinoelbreve9: doesn't show hand 
*** SUMMARY ***
Total pot €0.02 | Rake €0 
Seat 1: 77samuel33 (button) folded before Flop (didn't bet)
Seat 2: Lord_Shivaaa (small blind) folded before Flop
Seat 3: pipinoelbreve9 (big blind) collected (€0.02)
Seat 4: Miguelitro66 folded before Flop (didn't bet)
Seat 5: Ksunm folded before Flop (didn't bet)
Seat 6: jeannono24 folded before Flop (didn't bet)



PokerStars Zoom Hand #257439428756:  Hold'em No Limit (€0.01/€0.02) - 2025/08/22 12:15:26 CET [2025/08/22 6:15:26 ET]
Table 'Arneb' 6-max Seat #1 is the button
Seat 1: meruem70 (€0.95 in chips) 
Seat 2: boogychat (€1 in chips) 
Seat 3: LarryLurex72 (€2.65 in chips) 
Seat 4: StrangeNoumena (€1.66 in chips) 
Seat 5: pipinoelbreve9 (€2.02 in chips) 
Seat 6: JENOFONTE73 (€2.69 in chips) 
boogychat: posts small blind €0.01
LarryLurex72: posts big blind €0.02
*** HOLE CARDS ***
Dealt to pipinoelbreve9 [Jc 4s]
StrangeNoumena: folds 
pipinoelbreve9: folds 
JENOFONTE73: folds 
meruem70: folds 
boogychat: folds 
Uncalled bet (€0.01) returned to LarryLurex72
LarryLurex72 collected €0.02 from pot
LarryLurex72: doesn't show hand 
*** SUMMARY ***
Total pot €0.02 | Rake €0 
Seat 1: meruem70 (button) folded before Flop (didn't bet)
Seat 2: boogychat (small blind) folded before Flop
Seat 3: LarryLurex72 (big blind) collected (€0.02)
Seat 4: StrangeNoumena folded before Flop (didn't bet)
Seat 5: pipinoelbreve9 folded before Flop (didn't bet)
Seat 6: JENOFONTE73 folded before Flop (didn't bet)



PokerStars Zoom Hand #257439429021:  Hold'em No Limit (€0.01/€0.02) - 2025/08/22 12:15:29 CET [2025/08/22 6:15:29 ET]
Table 'Arneb' 6-max Seat #1 is the button
Seat 1: boogychat (€0.99 in chips) 
Seat 2: pipinoelbreve9 (€2.02 in chips) 
Seat 3: XXILuv (€2.04 in chips) 
Seat 4: k3lThuza2 (€3.07 in chips) 
Seat 5: 77samuel33 (€2 in chips) 
Seat 6: Ksunm (€1.76 in chips) 
pipinoelbreve9: posts small blind €0.01
XXILuv: posts big blind €0.02
*** HOLE CARDS ***
Dealt to pipinoelbreve9 [9s 4d]
k3lThuza2: folds 
77samuel33: folds 
Ksunm: folds 
boogychat: raises €0.04 to €0.06
pipinoelbreve9: folds 
XXILuv: folds 
Uncalled bet (€0.04) returned to boogychat
boogychat collected €0.05 from pot
boogychat: doesn't show hand 
*** SUMMARY ***
Total pot €0.05 | Rake €0 
Seat 1: boogychat (button) collected (€0.05)
Seat 2: pipinoelbreve9 (small blind) folded before Flop
Seat 3: XXILuv (big blind) folded before Flop
Seat 4: k3lThuza2 folded before Flop (didn't bet)
Seat 5: 77samuel33 folded before Flop (didn't bet)
Seat 6: Ksunm folded before Flop (didn't bet)



PokerStars Zoom Hand #257439429316:  Hold'em No Limit (€0.01/€0.02) - 2025/08/22 12:15:32 CET [2025/08/22 6:15:32 ET]
Table 'Arneb' 6-max Seat #1 is the button
Seat 1: k3lThuza2 (€3.07 in chips) 
Seat 2: JENOFONTE73 (€2.69 in chips) 
Seat 3: pipinoelbreve9 (€2.01 in chips) 
Seat 4: dreamer11111 (€4.76 in chips) 
Seat 5: Lord_Shivaaa (€2.11 in chips) 
Seat 6: Vruj0 (€3.12 in chips) 
JENOFONTE73: posts small blind €0.01
pipinoelbreve9: posts big blind €0.02
*** HOLE CARDS ***
Dealt to pipinoelbreve9 [9h 5d]
dreamer11111: folds 
Lord_Shivaaa: folds 
Vruj0: raises €0.04 to €0.06
k3lThuza2: folds 
JENOFONTE73: folds 
pipinoelbreve9: folds 
Uncalled bet (€0.04) returned to Vruj0
Vruj0 collected €0.05 from pot
Vruj0: doesn't show hand 
*** SUMMARY ***
Total pot €0.05 | Rake €0 
Seat 1: k3lThuza2 (button) folded before Flop (didn't bet)
Seat 2: JENOFONTE73 (small blind) folded before Flop
Seat 3: pipinoelbreve9 (big blind) folded before Flop
Seat 4: dreamer11111 folded before Flop (didn't bet)
Seat 5: Lord_Shivaaa folded before Flop (didn't bet)
Seat 6: Vruj0 collected (€0.05)



PokerStars Zoom Hand #257439428426:  Hold'em No Limit (€0.01/€0.02) - 2025/08/22 12:15:22 CET [2025/08/22 6:15:22 ET]
Table 'Arneb' 6-max Seat #1 is the button
Seat 1: LittleVerole (€1.39 in chips) 
Seat 2: k3lThuza2 (€3.08 in chips) 
Seat 3: jeannono24 (€2.15 in chips) 
Seat 4: bega13 (€2.54 in chips) 
Seat 5: hope201319 (€1.15 in chips) 
Seat 6: pipinoelbreve9 (€2.02 in chips) 
k3lThuza2: posts small blind €0.01
jeannono24: posts big blind €0.02
*** HOLE CARDS ***
Dealt to pipinoelbreve9 [3h 8c]
bega13: raises €0.04 to €0.06
hope201319 has timed out
hope201319: folds 
pipinoelbreve9: folds 
LittleVerole: folds 
k3lThuza2: folds 
jeannono24: folds 
Uncalled bet (€0.04) returned to bega13
bega13 collected €0.05 from pot
bega13: doesn't show hand 
*** SUMMARY ***
Total pot €0.05 | Rake €0 
Seat 1: LittleVerole (button) folded before Flop (didn't bet)
Seat 2: k3lThuza2 (small blind) folded before Flop
Seat 3: jeannono24 (big blind) folded before Flop
Seat 4: bega13 collected (€0.05)
Seat 5: hope201319 folded before Flop (didn't bet)
Seat 6: pipinoelbreve9 folded before Flop (didn't bet)



PokerStars Zoom Hand #257439430159:  Hold'em No Limit (€0.01/€0.02) - 2025/08/22 12:15:41 CET [2025/08/22 6:15:41 ET]
Table 'Arneb' 6-max Seat #1 is the button
Seat 1: 77samuel33 (€2 in chips) 
Seat 2: StrangeNoumena (€1.66 in chips) 
Seat 3: Lord_Shivaaa (€2.04 in chips) 
Seat 4: pipinoelbreve9 (€2 in chips) 
Seat 5: ElPilarAA (€4.73 in chips) 
Seat 6: XXILuv (€2.02 in chips) 
StrangeNoumena: posts small blind €0.01
Lord_Shivaaa: posts big blind €0.02
*** HOLE CARDS ***
Dealt to pipinoelbreve9 [6d 4s]
pipinoelbreve9: folds 
ElPilarAA: raises €0.02 to €0.04
XXILuv: folds 
77samuel33: folds 
StrangeNoumena: folds 
Lord_Shivaaa: folds 
Uncalled bet (€0.02) returned to ElPilarAA
ElPilarAA collected €0.05 from pot
ElPilarAA: doesn't show hand 
*** SUMMARY ***
Total pot €0.05 | Rake €0 
Seat 1: 77samuel33 (button) folded before Flop (didn't bet)
Seat 2: StrangeNoumena (small blind) folded before Flop
Seat 3: Lord_Shivaaa (big blind) folded before Flop
Seat 4: pipinoelbreve9 folded before Flop (didn't bet)
Seat 5: ElPilarAA collected (€0.05)
Seat 6: XXILuv folded before Flop (didn't bet)



PokerStars Zoom Hand #257439430950:  Hold'em No Limit (€0.01/€0.02) - 2025/08/22 12:15:49 CET [2025/08/22 6:15:49 ET]
Table 'Arneb' 6-max Seat #1 is the button
Seat 1: pipinoelbreve9 (€2 in chips) 
Seat 2: bega13 (€2.57 in chips) 
Seat 3: Martial333 (€2.17 in chips) 
Seat 4: meruem70 (€0.94 in chips) 
Seat 5: XXILuv (€2.03 in chips) 
Seat 6: dreamer11111 (€4.76 in chips) 
bega13: posts small blind €0.01
Martial333: posts big blind €0.02
*** HOLE CARDS ***
Dealt to pipinoelbreve9 [Qd 3s]
meruem70: folds 
XXILuv: folds 
dreamer11111: raises €0.04 to €0.06
pipinoelbreve9: folds 
bega13: folds 
Martial333: folds 
Uncalled bet (€0.04) returned to dreamer11111
dreamer11111 collected €0.05 from pot
dreamer11111: doesn't show hand 
*** SUMMARY ***
Total pot €0.05 | Rake €0 
Seat 1: pipinoelbreve9 (button) folded before Flop (didn't bet)
Seat 2: bega13 (small blind) folded before Flop
Seat 3: Martial333 (big blind) folded before Flop
Seat 4: meruem70 folded before Flop (didn't bet)
Seat 5: XXILuv folded before Flop (didn't bet)
Seat 6: dreamer11111 collected (€0.05)



PokerStars Zoom Hand #257439431199:  Hold'em No Limit (€0.01/€0.02) - 2025/08/22 12:15:52 CET [2025/08/22 6:15:52 ET]
Table 'Arneb' 6-max Seat #1 is the button
Seat 1: meruem70 (€0.94 in chips) 
Seat 2: juajord26 (€2.67 in chips) 
Seat 3: hope201319 (€1.15 in chips) 
Seat 4: LittleVerole (€4.43 in chips) 
Seat 5: RudeBoy23 (€2 in chips) 
Seat 6: pipinoelbreve9 (€2 in chips) 
juajord26: posts small blind €0.01
hope201319: posts big blind €0.02
*** HOLE CARDS ***
Dealt to pipinoelbreve9 [Tc As]
LittleVerole: folds 
RudeBoy23: folds 
pipinoelbreve9: raises €0.04 to €0.06
meruem70: folds 
juajord26: folds 
hope201319: folds 
Uncalled bet (€0.04) returned to pipinoelbreve9
pipinoelbreve9 collected €0.05 from pot
pipinoelbreve9: doesn't show hand 
*** SUMMARY ***
Total pot €0.05 | Rake €0 
Seat 1: meruem70 (button) folded before Flop (didn't bet)
Seat 2: juajord26 (small blind) folded before Flop
Seat 3: hope201319 (big blind) folded before Flop
Seat 4: LittleVerole folded before Flop (didn't bet)
Seat 5: RudeBoy23 folded before Flop (didn't bet)
Seat 6: pipinoelbreve9 collected (€0.05)



PokerStars Zoom Hand #257439432604:  Hold'em No Limit (€0.01/€0.02) - 2025/08/22 12:16:07 CET [2025/08/22 6:16:07 ET]
Table 'Arneb' 6-max Seat #1 is the button
Seat 1: bega13 (€2.56 in chips) 
Seat 2: pipinoelbreve9 (€2.03 in chips) 
Seat 3: meruem70 (€0.57 in chips) 
Seat 4: XXILuv (€2.04 in chips) 
Seat 5: siddhartasr (€1.97 in chips) 
Seat 6: jeannono24 (€2 in chips) 
pipinoelbreve9: posts small blind €0.01
meruem70: posts big blind €0.02
*** HOLE CARDS ***
Dealt to pipinoelbreve9 [6h 9d]
XXILuv: folds 
siddhartasr: folds 
jeannono24: folds 
bega13: folds 
pipinoelbreve9: folds 
Uncalled bet (€0.01) returned to meruem70
meruem70 collected €0.02 from pot
meruem70: doesn't show hand 
*** SUMMARY ***
Total pot €0.02 | Rake €0 
Seat 1: bega13 (button) folded before Flop (didn't bet)
Seat 2: pipinoelbreve9 (small blind) folded before Flop
Seat 3: meruem70 (big blind) collected (€0.02)
Seat 4: XXILuv folded before Flop (didn't bet)
Seat 5: siddhartasr folded before Flop (didn't bet)
Seat 6: jeannono24 folded before Flop (didn't bet)



PokerStars Zoom Hand #257439434961:  Hold'em No Limit (€0.01/€0.02) - 2025/08/22 12:16:32 CET [2025/08/22 6:16:32 ET]
Table 'Arneb' 6-max Seat #1 is the button
Seat 1: pipinoelbreve9 (€2.02 in chips) 
Seat 2: meruem70 (€0.91 in chips) 
Seat 3: nofuture69 (€2.03 in chips) 
Seat 4: Lord_Shivaaa (€2.02 in chips) 
Seat 5: stromera (€1.16 in chips) 
Seat 6: burgoa89 (€1.93 in chips) 
meruem70: posts small blind €0.01
nofuture69: posts big blind €0.02
*** HOLE CARDS ***
Dealt to pipinoelbreve9 [Js 8s]
Lord_Shivaaa: folds 
stromera: folds 
burgoa89: folds 
pipinoelbreve9: folds 
meruem70: folds 
Uncalled bet (€0.01) returned to nofuture69
nofuture69 collected €0.02 from pot
nofuture69: doesn't show hand 
*** SUMMARY ***
Total pot €0.02 | Rake €0 
Seat 1: pipinoelbreve9 (button) folded before Flop (didn't bet)
Seat 2: meruem70 (small blind) folded before Flop
Seat 3: nofuture69 (big blind) collected (€0.02)
Seat 4: Lord_Shivaaa folded before Flop (didn't bet)
Seat 5: stromera folded before Flop (didn't bet)
Seat 6: burgoa89 folded before Flop (didn't bet)



PokerStars Zoom Hand #257439435631:  Hold'em No Limit (€0.01/€0.02) - 2025/08/22 12:16:39 CET [2025/08/22 6:16:39 ET]
Table 'Arneb' 6-max Seat #1 is the button
Seat 1: bega13 (€2.45 in chips) 
Seat 2: XXILuv (€2.27 in chips) 
Seat 3: pipinoelbreve9 (€2.02 in chips) 
Seat 4: 33baba33 (€2.30 in chips) 
Seat 5: pera6521 (€2 in chips) 
Seat 6: 77samuel33 (€2.20 in chips) 
XXILuv: posts small blind €0.01
pipinoelbreve9: posts big blind €0.02
*** HOLE CARDS ***
Dealt to pipinoelbreve9 [3s 7d]
33baba33: folds 
pera6521: folds 
77samuel33: folds 
bega13: folds 
XXILuv: folds 
Uncalled bet (€0.01) returned to pipinoelbreve9
pipinoelbreve9 collected €0.02 from pot
pipinoelbreve9: doesn't show hand 
*** SUMMARY ***
Total pot €0.02 | Rake €0 
Seat 1: bega13 (button) folded before Flop (didn't bet)
Seat 2: XXILuv (small blind) folded before Flop
Seat 3: pipinoelbreve9 (big blind) collected (€0.02)
Seat 4: 33baba33 folded before Flop (didn't bet)
Seat 5: pera6521 folded before Flop (didn't bet)
Seat 6: 77samuel33 folded before Flop (didn't bet)



PokerStars Zoom Hand #257439434695:  Hold'em No Limit (€0.01/€0.02) - 2025/08/22 12:16:29 CET [2025/08/22 6:16:29 ET]
Table 'Arneb' 6-max Seat #1 is the button
Seat 1: StrangeNoumena (€1.57 in chips) 
Seat 2: FELIPE439 (€1.73 in chips) 
Seat 3: Mazebank46 (€2.73 in chips) 
Seat 4: pipinoelbreve9 (€2.02 in chips) 
Seat 5: Lord_Shivaaa (€3.91 in chips) 
Seat 6: burgoa89 (€2.01 in chips) 
FELIPE439: posts small blind €0.01
Mazebank46: posts big blind €0.02
*** HOLE CARDS ***
Dealt to pipinoelbreve9 [7s 3s]
pipinoelbreve9: folds 
Lord_Shivaaa: folds 
burgoa89: folds 
StrangeNoumena: folds 
FELIPE439: raises €0.04 to €0.06
Mazebank46: calls €0.04
*** FLOP *** [Tc Jh Ks]
FELIPE439: bets €0.11
Mazebank46: folds 
Uncalled bet (€0.11) returned to FELIPE439
FELIPE439 collected €0.11 from pot
FELIPE439: doesn't show hand 
*** SUMMARY ***
Total pot €0.12 | Rake €0.01 
Board [Tc Jh Ks]
Seat 1: StrangeNoumena (button) folded before Flop (didn't bet)
Seat 2: FELIPE439 (small blind) collected (€0.11)
Seat 3: Mazebank46 (big blind) folded on the Flop
Seat 4: pipinoelbreve9 folded before Flop (didn't bet)
Seat 5: Lord_Shivaaa folded before Flop (didn't bet)
Seat 6: burgoa89 folded before Flop (didn't bet)



PokerStars Zoom Hand #257439434282:  Hold'em No Limit (€0.01/€0.02) - 2025/08/22 12:16:25 CET [2025/08/22 6:16:25 ET]
Table 'Arneb' 6-max Seat #1 is the button
Seat 1: ReyGuto (€2.55 in chips) 
Seat 2: RudeBoy23 (€2.01 in chips) 
Seat 3: Valencinco (€2.31 in chips) 
Seat 4: LarryLurex72 (€2.26 in chips) 
Seat 5: pipinoelbreve9 (€2.02 in chips) 
Seat 6: 77samuel33 (€7.73 in chips) 
RudeBoy23: posts small blind €0.01
Valencinco: posts big blind €0.02
*** HOLE CARDS ***
Dealt to pipinoelbreve9 [6s Ad]
LarryLurex72: calls €0.02
pipinoelbreve9: folds 
77samuel33: folds 
ReyGuto: folds 
RudeBoy23: calls €0.01
Valencinco: checks 
*** FLOP *** [Ts 2h Ah]
RudeBoy23: checks 
Valencinco: checks 
LarryLurex72: checks 
*** TURN *** [Ts 2h Ah] [3h]
RudeBoy23: checks 
Valencinco: checks 
LarryLurex72: checks 
*** RIVER *** [Ts 2h Ah 3h] [7s]
RudeBoy23: bets €0.06
Valencinco: folds 
LarryLurex72: calls €0.06
*** SHOW DOWN ***
RudeBoy23: shows [Ac Td] (two pair, Aces and Tens)
LarryLurex72: mucks hand 
RudeBoy23 collected €0.17 from pot
*** SUMMARY ***
Total pot €0.18 | Rake €0.01 
Board [Ts 2h Ah 3h 7s]
Seat 1: ReyGuto (button) folded before Flop (didn't bet)
Seat 2: RudeBoy23 (small blind) showed [Ac Td] and won (€0.17) with two pair, Aces and Tens
Seat 3: Valencinco (big blind) folded on the River
Seat 4: LarryLurex72 mucked [8c 7d]
Seat 5: pipinoelbreve9 folded before Flop (didn't bet)
Seat 6: 77samuel33 folded before Flop (didn't bet)



PokerStars Zoom Hand #257439436565:  Hold'em No Limit (€0.01/€0.02) - 2025/08/22 12:16:49 CET [2025/08/22 6:16:49 ET]
Table 'Arneb' 6-max Seat #1 is the button
Seat 1: burgoa89 (€2 in chips) 
Seat 2: JENOFONTE73 (€2.98 in chips) 
Seat 3: jeannono24 (€2.70 in chips) 
Seat 4: Valencinco (€2.64 in chips) 
Seat 5: nofuture69 (€3.89 in chips) 
Seat 6: pipinoelbreve9 (€2.03 in chips) 
JENOFONTE73: posts small blind €0.01
jeannono24: posts big blind €0.02
*** HOLE CARDS ***
Dealt to pipinoelbreve9 [As Ac]
Valencinco: raises €0.03 to €0.05
nofuture69: folds 
pipinoelbreve9: raises €0.09 to €0.14
burgoa89: folds 
JENOFONTE73: folds 
jeannono24: folds 
Valencinco: folds 
Uncalled bet (€0.09) returned to pipinoelbreve9
pipinoelbreve9 collected €0.13 from pot
pipinoelbreve9: doesn't show hand 
*** SUMMARY ***
Total pot €0.13 | Rake €0 
Seat 1: burgoa89 (button) folded before Flop (didn't bet)
Seat 2: JENOFONTE73 (small blind) folded before Flop
Seat 3: jeannono24 (big blind) folded before Flop
Seat 4: Valencinco folded before Flop
Seat 5: nofuture69 folded before Flop (didn't bet)
Seat 6: pipinoelbreve9 collected (€0.13)



PokerStars Zoom Hand #257439441690:  Hold'em No Limit (€0.01/€0.02) - 2025/08/22 12:17:42 CET [2025/08/22 6:17:42 ET]
Table 'Arneb' 6-max Seat #1 is the button
Seat 1: Lord_Shivaaa (€3.88 in chips) 
Seat 2: jeannono24 (€2.68 in chips) 
Seat 3: dreamer11111 (€4.75 in chips) 
Seat 4: burgoa89 (€1.90 in chips) 
Seat 5: pipinoelbreve9 (€2.11 in chips) 
Seat 6: hope201319 (€2.33 in chips) 
jeannono24: posts small blind €0.01
dreamer11111: posts big blind €0.02
*** HOLE CARDS ***
Dealt to pipinoelbreve9 [7h Jc]
burgoa89: folds 
pipinoelbreve9: folds 
hope201319: folds 
Lord_Shivaaa: folds 
jeannono24: folds 
Uncalled bet (€0.01) returned to dreamer11111
dreamer11111 collected €0.02 from pot
dreamer11111: doesn't show hand 
*** SUMMARY ***
Total pot €0.02 | Rake €0 
Seat 1: Lord_Shivaaa (button) folded before Flop (didn't bet)
Seat 2: jeannono24 (small blind) folded before Flop
Seat 3: dreamer11111 (big blind) collected (€0.02)
Seat 4: burgoa89 folded before Flop (didn't bet)
Seat 5: pipinoelbreve9 folded before Flop (didn't bet)
Seat 6: hope201319 folded before Flop (didn't bet)



PokerStars Zoom Hand #257439441999:  Hold'em No Limit (€0.01/€0.02) - 2025/08/22 12:17:45 CET [2025/08/22 6:17:45 ET]
Table 'Arneb' 6-max Seat #1 is the button
Seat 1: jeannono24 (€2.67 in chips) 
Seat 2: pipinoelbreve9 (€2.11 in chips) 
Seat 3: burgoa89 (€1.90 in chips) 
Seat 4: LittleVerole (€4.44 in chips) 
Seat 5: aaronroxi (€2.25 in chips) 
Seat 6: FELIPE439 (€1.35 in chips) 
pipinoelbreve9: posts small blind €0.01
burgoa89: posts big blind €0.02
*** HOLE CARDS ***
Dealt to pipinoelbreve9 [Js As]
LittleVerole: folds 
aaronroxi: folds 
FELIPE439: raises €0.04 to €0.06
jeannono24: folds 
pipinoelbreve9: raises €0.16 to €0.22
burgoa89: folds 
FELIPE439: calls €0.16
*** FLOP *** [2c Td Kh]
pipinoelbreve9: bets €0.10
FELIPE439: calls €0.10
*** TURN *** [2c Td Kh] [8s]
pipinoelbreve9: checks 
FELIPE439: bets €0.34
pipinoelbreve9: folds 
Uncalled bet (€0.34) returned to FELIPE439
FELIPE439 collected €0.63 from pot
FELIPE439: doesn't show hand 
*** SUMMARY ***
Total pot €0.66 | Rake €0.03 
Board [2c Td Kh 8s]
Seat 1: jeannono24 (button) folded before Flop (didn't bet)
Seat 2: pipinoelbreve9 (small blind) folded on the Turn
Seat 3: burgoa89 (big blind) folded before Flop
Seat 4: LittleVerole folded before Flop (didn't bet)
Seat 5: aaronroxi folded before Flop (didn't bet)
Seat 6: FELIPE439 collected (€0.63)



PokerStars Zoom Hand #257439447981:  Hold'em No Limit (€0.01/€0.02) - 2025/08/22 12:18:47 CET [2025/08/22 6:18:47 ET]
Table 'Arneb' 6-max Seat #1 is the button
Seat 1: jeannono24 (€2 in chips) 
Seat 2: nofuture69 (€2.29 in chips) 
Seat 3: pipinoelbreve9 (€2 in chips) 
Seat 4: flx5757 (€3.69 in chips) 
Seat 5: XXILuv (€1.98 in chips) 
Seat 6: gomera30 (€2.10 in chips) 
nofuture69: posts small blind €0.01
pipinoelbreve9: posts big blind €0.02
*** HOLE CARDS ***
Dealt to pipinoelbreve9 [9s 7d]
flx5757: folds 
XXILuv: folds 
gomera30: folds 
jeannono24: raises €0.04 to €0.06
nofuture69: folds 
pipinoelbreve9: folds 
Uncalled bet (€0.04) returned to jeannono24
jeannono24 collected €0.05 from pot
jeannono24: doesn't show hand 
*** SUMMARY ***
Total pot €0.05 | Rake €0 
Seat 1: jeannono24 (button) collected (€0.05)
Seat 2: nofuture69 (small blind) folded before Flop
Seat 3: pipinoelbreve9 (big blind) folded before Flop
Seat 4: flx5757 folded before Flop (didn't bet)
Seat 5: XXILuv folded before Flop (didn't bet)
Seat 6: gomera30 folded before Flop (didn't bet)



PokerStars Zoom Hand #257439447432:  Hold'em No Limit (€0.01/€0.02) - 2025/08/22 12:18:42 CET [2025/08/22 6:18:42 ET]
Table 'Arneb' 6-max Seat #1 is the button
Seat 1: Vruj0 (€3.10 in chips) 
Seat 2: LittleVerole (€1.32 in chips) 
Seat 3: Lord_Shivaaa (€2.17 in chips) 
Seat 4: meruem70 (€0.83 in chips) 
Seat 5: pipinoelbreve9 (€2 in chips) 
Seat 6: vaznaval (€1.46 in chips) 
LittleVerole: posts small blind €0.01
Lord_Shivaaa: posts big blind €0.02
*** HOLE CARDS ***
Dealt to pipinoelbreve9 [8h Th]
meruem70: raises €0.02 to €0.04
pipinoelbreve9: folds 
vaznaval: folds 
Vruj0: folds 
LittleVerole: folds 
Lord_Shivaaa: calls €0.02
*** FLOP *** [9c Qs 6d]
Lord_Shivaaa: checks 
meruem70: bets €0.04
Lord_Shivaaa: calls €0.04
*** TURN *** [9c Qs 6d] [4d]
Lord_Shivaaa: checks 
meruem70: bets €0.08
Lord_Shivaaa: folds 
Uncalled bet (€0.08) returned to meruem70
meruem70 collected €0.16 from pot
meruem70: doesn't show hand 
*** SUMMARY ***
Total pot €0.17 | Rake €0.01 
Board [9c Qs 6d 4d]
Seat 1: Vruj0 (button) folded before Flop (didn't bet)
Seat 2: LittleVerole (small blind) folded before Flop
Seat 3: Lord_Shivaaa (big blind) folded on the Turn
Seat 4: meruem70 collected (€0.16)
Seat 5: pipinoelbreve9 folded before Flop (didn't bet)
Seat 6: vaznaval folded before Flop (didn't bet)



PokerStars Zoom Hand #257439449165:  Hold'em No Limit (€0.01/€0.02) - 2025/08/22 12:19:00 CET [2025/08/22 6:19:00 ET]
Table 'Arneb' 6-max Seat #1 is the button
Seat 1: pipinoelbreve9 (€2 in chips) 
Seat 2: XXILuv (€2.67 in chips) 
Seat 3: JENOFONTE73 (€2.92 in chips) 
Seat 4: burgoa89 (€1.92 in chips) 
Seat 5: Miguelitro66 (€2.10 in chips) 
Seat 6: Pabl0o0Poker (€3.24 in chips) 
XXILuv: posts small blind €0.01
JENOFONTE73: posts big blind €0.02
*** HOLE CARDS ***
Dealt to pipinoelbreve9 [Ks Jd]
burgoa89: folds 
Miguelitro66: raises €0.03 to €0.05
Pabl0o0Poker: folds 
pipinoelbreve9: calls €0.05
XXILuv: folds 
JENOFONTE73: folds 
*** FLOP *** [Qs Kc 8h]
Miguelitro66: checks 
pipinoelbreve9: bets €0.06
Miguelitro66: calls €0.06
*** TURN *** [Qs Kc 8h] [As]
Miguelitro66: checks 
pipinoelbreve9: checks 
*** RIVER *** [Qs Kc 8h As] [4c]
Miguelitro66: bets €0.16
pipinoelbreve9: calls €0.16
*** SHOW DOWN ***
Miguelitro66: shows [Ad Qc] (two pair, Aces and Queens)
pipinoelbreve9: mucks hand 
Miguelitro66 collected €0.54 from pot
*** SUMMARY ***
Total pot €0.57 | Rake €0.03 
Board [Qs Kc 8h As 4c]
Seat 1: pipinoelbreve9 (button) mucked [Ks Jd]
Seat 2: XXILuv (small blind) folded before Flop
Seat 3: JENOFONTE73 (big blind) folded before Flop
Seat 4: burgoa89 folded before Flop (didn't bet)
Seat 5: Miguelitro66 showed [Ad Qc] and won (€0.54) with two pair, Aces and Queens
Seat 6: Pabl0o0Poker folded before Flop (didn't bet)



PokerStars Zoom Hand #257439454198:  Hold'em No Limit (€0.01/€0.02) - 2025/08/22 12:19:52 CET [2025/08/22 6:19:52 ET]
Table 'Arneb' 6-max Seat #1 is the button
Seat 1: Miguelitro66 (€2.37 in chips) 
Seat 2: FELIPE439 (€1.61 in chips) 
Seat 3: Pabl0o0Poker (€0.75 in chips) 
Seat 4: pipinoelbreve9 (€2 in chips) 
Seat 5: Lord_Shivaaa (€2.08 in chips) 
Seat 6: jeannono24 (€2.41 in chips) 
FELIPE439: posts small blind €0.01
Pabl0o0Poker: posts big blind €0.02
*** HOLE CARDS ***
Dealt to pipinoelbreve9 [4d 7c]
pipinoelbreve9: folds 
Lord_Shivaaa: folds 
jeannono24: raises €0.04 to €0.06
Miguelitro66: folds 
FELIPE439: folds 
Pabl0o0Poker: folds 
Uncalled bet (€0.04) returned to jeannono24
jeannono24 collected €0.05 from pot
jeannono24: doesn't show hand 
*** SUMMARY ***
Total pot €0.05 | Rake €0 
Seat 1: Miguelitro66 (button) folded before Flop (didn't bet)
Seat 2: FELIPE439 (small blind) folded before Flop
Seat 3: Pabl0o0Poker (big blind) folded before Flop
Seat 4: pipinoelbreve9 folded before Flop (didn't bet)
Seat 5: Lord_Shivaaa folded before Flop (didn't bet)
Seat 6: jeannono24 collected (€0.05)



PokerStars Zoom Hand #257439455225:  Hold'em No Limit (€0.01/€0.02) - 2025/08/22 12:20:03 CET [2025/08/22 6:20:03 ET]
Table 'Arneb' 6-max Seat #1 is the button
Seat 1: gomera30 (€2.10 in chips) 
Seat 2: jeannono24 (€2.53 in chips) 
Seat 3: Lord_Shivaaa (€2.08 in chips) 
Seat 4: nofuture69 (€2.19 in chips) 
Seat 5: stromera (€1.19 in chips) 
Seat 6: pipinoelbreve9 (€2 in chips) 
jeannono24: posts small blind €0.01
Lord_Shivaaa: posts big blind €0.02
*** HOLE CARDS ***
Dealt to pipinoelbreve9 [Ah Kh]
nofuture69: folds 
stromera: folds 
pipinoelbreve9: raises €0.04 to €0.06
gomera30: folds 
jeannono24: folds 
Lord_Shivaaa: folds 
Uncalled bet (€0.04) returned to pipinoelbreve9
pipinoelbreve9 collected €0.05 from pot
pipinoelbreve9: doesn't show hand 
*** SUMMARY ***
Total pot €0.05 | Rake €0 
Seat 1: gomera30 (button) folded before Flop (didn't bet)
Seat 2: jeannono24 (small blind) folded before Flop
Seat 3: Lord_Shivaaa (big blind) folded before Flop
Seat 4: nofuture69 folded before Flop (didn't bet)
Seat 5: stromera folded before Flop (didn't bet)
Seat 6: pipinoelbreve9 collected (€0.05)



PokerStars Zoom Hand #257439456577:  Hold'em No Limit (€0.01/€0.02) - 2025/08/22 12:20:17 CET [2025/08/22 6:20:17 ET]
Table 'Arneb' 6-max Seat #1 is the button
Seat 1: pipinoelbreve9 (€2.03 in chips) 
Seat 2: Ksunm (€2.71 in chips) 
Seat 3: 33baba33 (€2.76 in chips) 
Seat 4: gomera30 (€2.03 in chips) 
Seat 5: vaznaval (€1.61 in chips) 
Seat 6: Valencinco (€2.50 in chips) 
Ksunm: posts small blind €0.01
33baba33: posts big blind €0.02
*** HOLE CARDS ***
Dealt to pipinoelbreve9 [4d Kd]
gomera30: folds 
vaznaval: folds 
Valencinco: folds 
pipinoelbreve9: folds 
Ksunm: raises €0.06 to €0.08
33baba33: folds 
Uncalled bet (€0.06) returned to Ksunm
Ksunm collected €0.04 from pot
Ksunm: doesn't show hand 
*** SUMMARY ***
Total pot €0.04 | Rake €0 
Seat 1: pipinoelbreve9 (button) folded before Flop (didn't bet)
Seat 2: Ksunm (small blind) collected (€0.04)
Seat 3: 33baba33 (big blind) folded before Flop
Seat 4: gomera30 folded before Flop (didn't bet)
Seat 5: vaznaval folded before Flop (didn't bet)
Seat 6: Valencinco folded before Flop (didn't bet)



PokerStars Zoom Hand #257439454693:  Hold'em No Limit (€0.01/€0.02) - 2025/08/22 12:19:57 CET [2025/08/22 6:19:57 ET]
Table 'Arneb' 6-max Seat #1 is the button
Seat 1: bega13 (€2.53 in chips) 
Seat 2: pipinoelbreve9 (€2 in chips) 
Seat 3: burgoa89 (€2.11 in chips) 
Seat 4: jeannono24 (€2 in chips) 
Seat 5: inasio69420 (€1.35 in chips) 
Seat 6: Pabl0o0Poker (€3.24 in chips) 
pipinoelbreve9: posts small blind €0.01
burgoa89: posts big blind €0.02
*** HOLE CARDS ***
Dealt to pipinoelbreve9 [Qd 6h]
jeannono24: folds 
inasio69420 is disconnected 
inasio69420 has timed out while disconnected
inasio69420: folds 
Pabl0o0Poker: raises €0.03 to €0.05
bega13: folds 
pipinoelbreve9: folds 
burgoa89: calls €0.03
*** FLOP *** [6d 5d Ah]
burgoa89: checks 
Pabl0o0Poker: bets €0.03
burgoa89: folds 
Uncalled bet (€0.03) returned to Pabl0o0Poker
Pabl0o0Poker collected €0.10 from pot
Pabl0o0Poker: doesn't show hand 
*** SUMMARY ***
Total pot €0.11 | Rake €0.01 
Board [6d 5d Ah]
Seat 1: bega13 (button) folded before Flop (didn't bet)
Seat 2: pipinoelbreve9 (small blind) folded before Flop
Seat 3: burgoa89 (big blind) folded on the Flop
Seat 4: jeannono24 folded before Flop (didn't bet)
Seat 5: inasio69420 folded before Flop (didn't bet)
Seat 6: Pabl0o0Poker collected (€0.10)



PokerStars Zoom Hand #257439457017:  Hold'em No Limit (€0.01/€0.02) - 2025/08/22 12:20:22 CET [2025/08/22 6:20:22 ET]
Table 'Arneb' 6-max Seat #1 is the button
Seat 1: gelotes (€1.45 in chips) 
Seat 2: lorocontento (€1.08 in chips) 
Seat 3: Valencinco (€2.50 in chips) 
Seat 4: pipinoelbreve9 (€2.03 in chips) 
Seat 5: vaznaval (€1.61 in chips) 
Seat 6: JENOFONTE73 (€2.80 in chips) 
lorocontento: posts small blind €0.01
Valencinco: posts big blind €0.02
*** HOLE CARDS ***
Dealt to pipinoelbreve9 [8c 8h]
pipinoelbreve9: raises €0.04 to €0.06
vaznaval: folds 
JENOFONTE73: folds 
gelotes: calls €0.06
lorocontento: folds 
Valencinco: calls €0.04
*** FLOP *** [7c 3h 5d]
Valencinco: checks 
pipinoelbreve9: bets €0.09
gelotes: calls €0.09
Valencinco: folds 
*** TURN *** [7c 3h 5d] [4d]
pipinoelbreve9: checks 
gelotes: checks 
*** RIVER *** [7c 3h 5d 4d] [Kc]
pipinoelbreve9: bets €0.18
gelotes: raises €0.71 to €0.89
pipinoelbreve9: folds 
Uncalled bet (€0.71) returned to gelotes
gelotes collected €0.69 from pot
gelotes: doesn't show hand 
*** SUMMARY ***
Total pot €0.73 | Rake €0.04 
Board [7c 3h 5d 4d Kc]
Seat 1: gelotes (button) collected (€0.69)
Seat 2: lorocontento (small blind) folded before Flop
Seat 3: Valencinco (big blind) folded on the Flop
Seat 4: pipinoelbreve9 folded on the River
Seat 5: vaznaval folded before Flop (didn't bet)
Seat 6: JENOFONTE73 folded before Flop (didn't bet)



PokerStars Zoom Hand #257439461364:  Hold'em No Limit (€0.01/€0.02) - 2025/08/22 12:21:07 CET [2025/08/22 6:21:07 ET]
Table 'Arneb' 6-max Seat #1 is the button
Seat 1: nofuture69 (€2.05 in chips) 
Seat 2: bega13 (€2.96 in chips) 
Seat 3: jeannono24 (€2 in chips) 
Seat 4: Lord_Shivaaa (€4.07 in chips) 
Seat 5: pipinoelbreve9 (€2 in chips) 
Seat 6: gelotes (€1.81 in chips) 
bega13: posts small blind €0.01
jeannono24: posts big blind €0.02
*** HOLE CARDS ***
Dealt to pipinoelbreve9 [Qd Kh]
Lord_Shivaaa: folds 
pipinoelbreve9: raises €0.04 to €0.06
gelotes: calls €0.06
nofuture69: folds 
bega13: folds 
jeannono24: folds 
*** FLOP *** [5s 9h 5d]
pipinoelbreve9: checks 
gelotes: checks 
*** TURN *** [5s 9h 5d] [Th]
pipinoelbreve9: checks 
gelotes: checks 
*** RIVER *** [5s 9h 5d Th] [Ac]
pipinoelbreve9: checks 
gelotes: bets €0.14
pipinoelbreve9: folds 
Uncalled bet (€0.14) returned to gelotes
gelotes collected €0.14 from pot
gelotes: doesn't show hand 
*** SUMMARY ***
Total pot €0.15 | Rake €0.01 
Board [5s 9h 5d Th Ac]
Seat 1: nofuture69 (button) folded before Flop (didn't bet)
Seat 2: bega13 (small blind) folded before Flop
Seat 3: jeannono24 (big blind) folded before Flop
Seat 4: Lord_Shivaaa folded before Flop (didn't bet)
Seat 5: pipinoelbreve9 folded on the River
Seat 6: gelotes collected (€0.14)



PokerStars Zoom Hand #257439464731:  Hold'em No Limit (€0.01/€0.02) - 2025/08/22 12:21:42 CET [2025/08/22 6:21:42 ET]
Table 'Arneb' 6-max Seat #1 is the button
Seat 1: Vruj0 (€2.70 in chips) 
Seat 2: gomera30 (€2.04 in chips) 
Seat 3: pipinoelbreve9 (€2 in chips) 
Seat 4: Lord_Shivaaa (€2.05 in chips) 
Seat 5: Abrelatas787 (€1.92 in chips) 
Seat 6: JENOFONTE73 (€2.53 in chips) 
gomera30: posts small blind €0.01
pipinoelbreve9: posts big blind €0.02
*** HOLE CARDS ***
Dealt to pipinoelbreve9 [7c 6h]
Lord_Shivaaa: folds 
Abrelatas787: folds 
JENOFONTE73: folds 
Vruj0: raises €0.04 to €0.06
gomera30: raises €0.16 to €0.22
pipinoelbreve9: folds 
Vruj0: calls €0.16
*** FLOP *** [9h 4s Qd]
gomera30: checks 
Vruj0: bets €0.15
gomera30: calls €0.15
*** TURN *** [9h 4s Qd] [Tc]
gomera30: checks 
Vruj0: bets €0.60
gomera30: raises €1.07 to €1.67 and is all-in
Vruj0: calls €1.07
*** RIVER *** [9h 4s Qd Tc] [As]
*** SHOW DOWN ***
gomera30: shows [Ts Td] (three of a kind, Tens)
Vruj0: shows [Jh Ks] (a straight, Ten to Ace)
Vruj0 collected €3.90 from pot
*** SUMMARY ***
Total pot €4.10 | Rake €0.20 
Board [9h 4s Qd Tc As]
Seat 1: Vruj0 (button) showed [Jh Ks] and won (€3.90) with a straight, Ten to Ace
Seat 2: gomera30 (small blind) showed [Ts Td] and lost with three of a kind, Tens
Seat 3: pipinoelbreve9 (big blind) folded before Flop
Seat 4: Lord_Shivaaa folded before Flop (didn't bet)
Seat 5: Abrelatas787 folded before Flop (didn't bet)
Seat 6: JENOFONTE73 folded before Flop (didn't bet)



PokerStars Zoom Hand #257439465431:  Hold'em No Limit (€0.01/€0.02) - 2025/08/22 12:21:49 CET [2025/08/22 6:21:49 ET]
Table 'Arneb' 6-max Seat #1 is the button
Seat 1: pipinoelbreve9 (€2 in chips) 
Seat 2: kombei63 (€0.85 in chips) 
Seat 3: bega13 (€2.80 in chips) 
Seat 4: LittleVerole (€1.55 in chips) 
Seat 5: nofuture69 (€2.10 in chips) 
Seat 6: jeannono24 (€2.11 in chips) 
kombei63: posts small blind €0.01
bega13: posts big blind €0.02
*** HOLE CARDS ***
Dealt to pipinoelbreve9 [7s 7h]
LittleVerole: folds 
nofuture69: folds 
jeannono24: folds 
pipinoelbreve9: raises €0.04 to €0.06
kombei63: calls €0.05
bega13: folds 
*** FLOP *** [7d 6c 2h]
kombei63: checks 
pipinoelbreve9: bets €0.04
kombei63: calls €0.04
*** TURN *** [7d 6c 2h] [8c]
kombei63: checks 
pipinoelbreve9: bets €0.17
kombei63: calls €0.17
*** RIVER *** [7d 6c 2h 8c] [Th]
kombei63: checks 
pipinoelbreve9: bets €0.58
kombei63: calls €0.58 and is all-in
*** SHOW DOWN ***
pipinoelbreve9: shows [7s 7h] (three of a kind, Sevens)
kombei63: shows [3c 3d] (a pair of Threes)
pipinoelbreve9 collected €1.63 from pot
*** SUMMARY ***
Total pot €1.72 | Rake €0.09 
Board [7d 6c 2h 8c Th]
Seat 1: pipinoelbreve9 (button) showed [7s 7h] and won (€1.63) with three of a kind, Sevens
Seat 2: kombei63 (small blind) showed [3c 3d] and lost with a pair of Threes
Seat 3: bega13 (big blind) folded before Flop
Seat 4: LittleVerole folded before Flop (didn't bet)
Seat 5: nofuture69 folded before Flop (didn't bet)
Seat 6: jeannono24 folded before Flop (didn't bet)



PokerStars Zoom Hand #257439471762:  Hold'em No Limit (€0.01/€0.02) - 2025/08/22 12:22:55 CET [2025/08/22 6:22:55 ET]
Table 'Arneb' 6-max Seat #1 is the button
Seat 1: LittleVerole (€1.52 in chips) 
Seat 2: pipinoelbreve9 (€2.78 in chips) 
Seat 3: ursu1957 (€1.73 in chips) 
Seat 4: bega13 (€2.80 in chips) 
Seat 5: gomera30 (€2.47 in chips) 
Seat 6: booster74 (€2.01 in chips) 
pipinoelbreve9: posts small blind €0.01
ursu1957: posts big blind €0.02
*** HOLE CARDS ***
Dealt to pipinoelbreve9 [6h Ac]
bega13: folds 
gomera30: folds 
booster74: raises €0.05 to €0.07
LittleVerole: folds 
pipinoelbreve9: folds 
ursu1957: folds 
Uncalled bet (€0.05) returned to booster74
booster74 collected €0.05 from pot
booster74: doesn't show hand 
*** SUMMARY ***
Total pot €0.05 | Rake €0 
Seat 1: LittleVerole (button) folded before Flop (didn't bet)
Seat 2: pipinoelbreve9 (small blind) folded before Flop
Seat 3: ursu1957 (big blind) folded before Flop
Seat 4: bega13 folded before Flop (didn't bet)
Seat 5: gomera30 folded before Flop (didn't bet)
Seat 6: booster74 collected (€0.05)



PokerStars Zoom Hand #257439472179:  Hold'em No Limit (€0.01/€0.02) - 2025/08/22 12:22:59 CET [2025/08/22 6:22:59 ET]
Table 'Arneb' 6-max Seat #1 is the button
Seat 1: stromera (€1.45 in chips) 
Seat 2: nofuture69 (€2 in chips) 
Seat 3: NCabral_SCP (€2.82 in chips) 
Seat 4: pera6521 (€2.06 in chips) 
Seat 5: JENOFONTE73 (€2.51 in chips) 
Seat 6: pipinoelbreve9 (€2.77 in chips) 
nofuture69: posts small blind €0.01
NCabral_SCP: posts big blind €0.02
*** HOLE CARDS ***
Dealt to pipinoelbreve9 [9d 4d]
pera6521: raises €0.03 to €0.05
JENOFONTE73: calls €0.05
pipinoelbreve9: folds 
stromera: folds 
nofuture69: folds 
NCabral_SCP: folds 
*** FLOP *** [9s 7c 7h]
pera6521: checks 
JENOFONTE73: checks 
*** TURN *** [9s 7c 7h] [2c]
pera6521: bets €0.09
JENOFONTE73: folds 
Uncalled bet (€0.09) returned to pera6521
pera6521 collected €0.12 from pot
pera6521: doesn't show hand 
*** SUMMARY ***
Total pot €0.13 | Rake €0.01 
Board [9s 7c 7h 2c]
Seat 1: stromera (button) folded before Flop (didn't bet)
Seat 2: nofuture69 (small blind) folded before Flop
Seat 3: NCabral_SCP (big blind) folded before Flop
Seat 4: pera6521 collected (€0.12)
Seat 5: JENOFONTE73 folded on the Turn
Seat 6: pipinoelbreve9 folded before Flop (didn't bet)



PokerStars Zoom Hand #257439472561:  Hold'em No Limit (€0.01/€0.02) - 2025/08/22 12:23:03 CET [2025/08/22 6:23:03 ET]
Table 'Arneb' 6-max Seat #1 is the button
Seat 1: FELIPE439 (€2.20 in chips) 
Seat 2: stromera (€1.45 in chips) 
Seat 3: pipinoelbreve9 (€2.77 in chips) 
Seat 4: Lord_Shivaaa (€2.40 in chips) 
Seat 5: jeannono24 (€2.53 in chips) 
Seat 6: nofuture69 (€2 in chips) 
stromera: posts small blind €0.01
pipinoelbreve9: posts big blind €0.02
*** HOLE CARDS ***
Dealt to pipinoelbreve9 [3d 9d]
Lord_Shivaaa: raises €0.03 to €0.05
jeannono24: calls €0.05
nofuture69: folds 
FELIPE439: calls €0.05
stromera: folds 
pipinoelbreve9: folds 
*** FLOP *** [2c 8d Ad]
Lord_Shivaaa: bets €0.13
jeannono24: calls €0.13
FELIPE439: folds 
*** TURN *** [2c 8d Ad] [Jc]
Lord_Shivaaa: bets €0.21
jeannono24: calls €0.21
*** RIVER *** [2c 8d Ad Jc] [4h]
Lord_Shivaaa: checks 
jeannono24: checks 
*** SHOW DOWN ***
Lord_Shivaaa: shows [6h Ah] (a pair of Aces)
jeannono24: shows [Ac Qh] (a pair of Aces - Queen kicker)
jeannono24 collected €0.82 from pot
*** SUMMARY ***
Total pot €0.86 | Rake €0.04 
Board [2c 8d Ad Jc 4h]
Seat 1: FELIPE439 (button) folded on the Flop
Seat 2: stromera (small blind) folded before Flop
Seat 3: pipinoelbreve9 (big blind) folded before Flop
Seat 4: Lord_Shivaaa showed [6h Ah] and lost with a pair of Aces
Seat 5: jeannono24 showed [Ac Qh] and won (€0.82) with a pair of Aces
Seat 6: nofuture69 folded before Flop (didn't bet)



PokerStars Zoom Hand #257439474204:  Hold'em No Limit (€0.01/€0.02) - 2025/08/22 12:23:21 CET [2025/08/22 6:23:21 ET]
Table 'Arneb' 6-max Seat #1 is the button
Seat 1: pipinoelbreve9 (€2.74 in chips) 
Seat 2: FELIPE439 (€2.06 in chips) 
Seat 3: gomera30 (€2.35 in chips) 
Seat 4: nofuture69 (€2.28 in chips) 
Seat 5: burgoa89 (€1.94 in chips) 
Seat 6: ursu1957 (€1.71 in chips) 
FELIPE439: posts small blind €0.01
gomera30: posts big blind €0.02
*** HOLE CARDS ***
Dealt to pipinoelbreve9 [8s 3s]
nofuture69: folds 
burgoa89: folds 
ursu1957: folds 
pipinoelbreve9: folds 
FELIPE439: folds 
Uncalled bet (€0.01) returned to gomera30
gomera30 collected €0.02 from pot
gomera30: doesn't show hand 
*** SUMMARY ***
Total pot €0.02 | Rake €0 
Seat 1: pipinoelbreve9 (button) folded before Flop (didn't bet)
Seat 2: FELIPE439 (small blind) folded before Flop
Seat 3: gomera30 (big blind) collected (€0.02)
Seat 4: nofuture69 folded before Flop (didn't bet)
Seat 5: burgoa89 folded before Flop (didn't bet)
Seat 6: ursu1957 folded before Flop (didn't bet)



PokerStars Zoom Hand #257439473763:  Hold'em No Limit (€0.01/€0.02) - 2025/08/22 12:23:16 CET [2025/08/22 6:23:16 ET]
Table 'Arneb' 6-max Seat #1 is the button
Seat 1: ursu1957 (€1.71 in chips) 
Seat 2: pipinoelbreve9 (€2.75 in chips) 
Seat 3: Ksunm (€2.62 in chips) 
Seat 4: gomera30 (€2.35 in chips) 
Seat 5: gelotes (€1.99 in chips) 
Seat 6: kombei63 (€1.17 in chips) 
pipinoelbreve9: posts small blind €0.01
Ksunm: posts big blind €0.02
*** HOLE CARDS ***
Dealt to pipinoelbreve9 [3d 9s]
gomera30: folds 
gelotes: calls €0.02
kombei63: folds 
ursu1957: folds 
pipinoelbreve9: folds 
Ksunm: raises €0.08 to €0.10
gelotes: calls €0.08
*** FLOP *** [3h 6h 8d]
Ksunm: bets €0.09
gelotes: calls €0.09
*** TURN *** [3h 6h 8d] [6d]
Ksunm: bets €0.16
gelotes: folds 
Uncalled bet (€0.16) returned to Ksunm
Ksunm collected €0.37 from pot
Ksunm: doesn't show hand 
*** SUMMARY ***
Total pot €0.39 | Rake €0.02 
Board [3h 6h 8d 6d]
Seat 1: ursu1957 (button) folded before Flop (didn't bet)
Seat 2: pipinoelbreve9 (small blind) folded before Flop
Seat 3: Ksunm (big blind) collected (€0.37)
Seat 4: gomera30 folded before Flop (didn't bet)
Seat 5: gelotes folded on the Turn
Seat 6: kombei63 folded before Flop (didn't bet)



PokerStars Zoom Hand #257439472951:  Hold'em No Limit (€0.01/€0.02) - 2025/08/22 12:23:07 CET [2025/08/22 6:23:07 ET]
Table 'Arneb' 6-max Seat #1 is the button
Seat 1: LittleVerole (€1.52 in chips) 
Seat 2: Abrelatas787 (€1.84 in chips) 
Seat 3: marsatack28 (€1.73 in chips) 
Seat 4: pipinoelbreve9 (€2.75 in chips) 
Seat 5: Decomou (€1.47 in chips) 
Seat 6: stromera (€1.44 in chips) 
Abrelatas787: posts small blind €0.01
marsatack28: posts big blind €0.02
*** HOLE CARDS ***
Dealt to pipinoelbreve9 [2h 4c]
pipinoelbreve9: folds 
Decomou: folds 
stromera: folds 
LittleVerole: folds 
Abrelatas787: raises €0.04 to €0.06
marsatack28: calls €0.04
*** FLOP *** [Kc 3d Kd]
Abrelatas787: checks 
marsatack28: checks 
*** TURN *** [Kc 3d Kd] [3c]
Abrelatas787: bets €0.04
marsatack28: calls €0.04
*** RIVER *** [Kc 3d Kd 3c] [8h]
Abrelatas787: bets €0.06
marsatack28: raises €0.16 to €0.22
Abrelatas787: raises €0.32 to €0.54
marsatack28: calls €0.32
*** SHOW DOWN ***
Abrelatas787: shows [Kh 7h] (a full house, Kings full of Threes)
marsatack28: shows [Ks As] (a full house, Kings full of Threes)
Abrelatas787 collected €0.61 from pot
marsatack28 collected €0.61 from pot
*** SUMMARY ***
Total pot €1.28 | Rake €0.06 
Board [Kc 3d Kd 3c 8h]
Seat 1: LittleVerole (button) folded before Flop (didn't bet)
Seat 2: Abrelatas787 (small blind) showed [Kh 7h] and won (€0.61) with a full house, Kings full of Threes
Seat 3: marsatack28 (big blind) showed [Ks As] and won (€0.61) with a full house, Kings full of Threes
Seat 4: pipinoelbreve9 folded before Flop (didn't bet)
Seat 5: Decomou folded before Flop (didn't bet)
Seat 6: stromera folded before Flop (didn't bet)



PokerStars Zoom Hand #257439478769:  Hold'em No Limit (€0.01/€0.02) - 2025/08/22 12:24:08 CET [2025/08/22 6:24:08 ET]
Table 'Arneb' 6-max Seat #1 is the button
Seat 1: Lord_Shivaaa (€3.48 in chips) 
Seat 2: kombei63 (€0.72 in chips) 
Seat 3: LarryLurex72 (€1.52 in chips) 
Seat 4: Vruj0 (€4.53 in chips) 
Seat 5: pipinoelbreve9 (€2.70 in chips) 
Seat 6: 33baba33 (€2.01 in chips) 
kombei63: posts small blind €0.01
LarryLurex72: posts big blind €0.02
*** HOLE CARDS ***
Dealt to pipinoelbreve9 [Ah Js]
Vruj0: folds 
pipinoelbreve9: raises €0.04 to €0.06
33baba33: folds 
Lord_Shivaaa: folds 
kombei63: folds 
LarryLurex72: folds 
Uncalled bet (€0.04) returned to pipinoelbreve9
pipinoelbreve9 collected €0.05 from pot
pipinoelbreve9: doesn't show hand 
*** SUMMARY ***
Total pot €0.05 | Rake €0 
Seat 1: Lord_Shivaaa (button) folded before Flop (didn't bet)
Seat 2: kombei63 (small blind) folded before Flop
Seat 3: LarryLurex72 (big blind) folded before Flop
Seat 4: Vruj0 folded before Flop (didn't bet)
Seat 5: pipinoelbreve9 collected (€0.05)
Seat 6: 33baba33 folded before Flop (didn't bet)



PokerStars Zoom Hand #257439475343:  Hold'em No Limit (€0.01/€0.02) - 2025/08/22 12:23:33 CET [2025/08/22 6:23:33 ET]
Table 'Arneb' 6-max Seat #1 is the button
Seat 1: bega13 (€2.47 in chips) 
Seat 2: kombei63 (€1.17 in chips) 
Seat 3: allmike78 (€2 in chips) 
Seat 4: NCabral_SCP (€2.80 in chips) 
Seat 5: pipinoelbreve9 (€2.74 in chips) 
Seat 6: nofuture69 (€2.28 in chips) 
kombei63: posts small blind €0.01
allmike78: posts big blind €0.02
*** HOLE CARDS ***
Dealt to pipinoelbreve9 [5h 5c]
NCabral_SCP: calls €0.02
pipinoelbreve9: calls €0.02
nofuture69: folds 
bega13: folds 
kombei63: calls €0.01
allmike78: checks 
*** FLOP *** [Kh Tc 4s]
kombei63: checks 
allmike78: checks 
NCabral_SCP: bets €0.02
pipinoelbreve9: calls €0.02
kombei63: raises €0.06 to €0.08
allmike78: folds 
NCabral_SCP: calls €0.06
pipinoelbreve9: folds 
*** TURN *** [Kh Tc 4s] [Td]
kombei63: checks 
NCabral_SCP: checks 
*** RIVER *** [Kh Tc 4s Td] [9c]
kombei63: checks 
NCabral_SCP: bets €0.13
kombei63: calls €0.13
*** SHOW DOWN ***
NCabral_SCP: shows [Js Kd] (two pair, Kings and Tens)
kombei63: shows [Qc Ks] (two pair, Kings and Tens - Queen kicker)
kombei63 collected €0.49 from pot
*** SUMMARY ***
Total pot €0.52 | Rake €0.03 
Board [Kh Tc 4s Td 9c]
Seat 1: bega13 (button) folded before Flop (didn't bet)
Seat 2: kombei63 (small blind) showed [Qc Ks] and won (€0.49) with two pair, Kings and Tens
Seat 3: allmike78 (big blind) folded on the Flop
Seat 4: NCabral_SCP showed [Js Kd] and lost with two pair, Kings and Tens
Seat 5: pipinoelbreve9 folded on the Flop
Seat 6: nofuture69 folded before Flop (didn't bet)



PokerStars Zoom Hand #257439474538:  Hold'em No Limit (€0.01/€0.02) - 2025/08/22 12:23:24 CET [2025/08/22 6:23:24 ET]
Table 'Arneb' 6-max Seat #1 is the button
Seat 1: kombei63 (€1.17 in chips) 
Seat 2: bega13 (€2.48 in chips) 
Seat 3: Decomou (€1.46 in chips) 
Seat 4: LittleVerole (€1.55 in chips) 
Seat 5: ursu1957 (€1.71 in chips) 
Seat 6: pipinoelbreve9 (€2.74 in chips) 
bega13: posts small blind €0.01
Decomou: posts big blind €0.02
*** HOLE CARDS ***
Dealt to pipinoelbreve9 [5s Jh]
LittleVerole: raises €0.02 to €0.04
ursu1957: calls €0.04
pipinoelbreve9: folds 
kombei63: folds 
bega13: folds 
Decomou: calls €0.02
*** FLOP *** [8d 5c 5h]
Decomou: checks 
LittleVerole: checks 
ursu1957: checks 
*** TURN *** [8d 5c 5h] [Js]
Decomou: bets €0.03
LittleVerole: folds 
ursu1957: calls €0.03
*** RIVER *** [8d 5c 5h Js] [Ah]
Decomou: checks 
ursu1957: bets €0.18
Decomou: calls €0.18
*** SHOW DOWN ***
ursu1957: shows [Ad Kd] (two pair, Aces and Fives)
Decomou: mucks hand 
ursu1957 collected €0.52 from pot
*** SUMMARY ***
Total pot €0.55 | Rake €0.03 
Board [8d 5c 5h Js Ah]
Seat 1: kombei63 (button) folded before Flop (didn't bet)
Seat 2: bega13 (small blind) folded before Flop
Seat 3: Decomou (big blind) mucked [Jc 9d]
Seat 4: LittleVerole folded on the Turn
Seat 5: ursu1957 showed [Ad Kd] and won (€0.52) with two pair, Aces and Fives
Seat 6: pipinoelbreve9 folded before Flop (didn't bet)



PokerStars Zoom Hand #257439480052:  Hold'em No Limit (€0.01/€0.02) - 2025/08/22 12:24:22 CET [2025/08/22 6:24:22 ET]
Table 'Arneb' 6-max Seat #1 is the button
Seat 1: gelotes (€1.63 in chips) 
Seat 2: pipinoelbreve9 (€2.73 in chips) 
Seat 3: 33baba33 (€2 in chips) 
Seat 4: jeannono24 (€2.59 in chips) 
Seat 5: gomera30 (€2.38 in chips) 
Seat 6: aaronroxi (€3.42 in chips) 
pipinoelbreve9: posts small blind €0.01
33baba33: posts big blind €0.02
*** HOLE CARDS ***
Dealt to pipinoelbreve9 [Qd 6s]
jeannono24: folds 
gomera30: folds 
aaronroxi: folds 
gelotes: folds 
pipinoelbreve9: folds 
Uncalled bet (€0.01) returned to 33baba33
33baba33 collected €0.02 from pot
33baba33: doesn't show hand 
*** SUMMARY ***
Total pot €0.02 | Rake €0 
Seat 1: gelotes (button) folded before Flop (didn't bet)
Seat 2: pipinoelbreve9 (small blind) folded before Flop
Seat 3: 33baba33 (big blind) collected (€0.02)
Seat 4: jeannono24 folded before Flop (didn't bet)
Seat 5: gomera30 folded before Flop (didn't bet)
Seat 6: aaronroxi folded before Flop (didn't bet)



PokerStars Zoom Hand #257439480623:  Hold'em No Limit (€0.01/€0.02) - 2025/08/22 12:24:27 CET [2025/08/22 6:24:27 ET]
Table 'Arneb' 6-max Seat #1 is the button
Seat 1: Vruj0 (€3.54 in chips) 
Seat 2: burgoa89 (€2.09 in chips) 
Seat 3: pipinoelbreve9 (€2.72 in chips) 
Seat 4: Pabl0o0Poker (€0.84 in chips) 
Seat 5: FELIPE439 (€2.15 in chips) 
Seat 6: Mazebank46 (€4.99 in chips) 
burgoa89: posts small blind €0.01
pipinoelbreve9: posts big blind €0.02
*** HOLE CARDS ***
Dealt to pipinoelbreve9 [9c 8h]
Pabl0o0Poker: folds 
FELIPE439: folds 
Mazebank46: folds 
Vruj0: folds 
burgoa89: raises €0.04 to €0.06
pipinoelbreve9: folds 
Uncalled bet (€0.04) returned to burgoa89
burgoa89 collected €0.04 from pot
burgoa89: doesn't show hand 
*** SUMMARY ***
Total pot €0.04 | Rake €0 
Seat 1: Vruj0 (button) folded before Flop (didn't bet)
Seat 2: burgoa89 (small blind) collected (€0.04)
Seat 3: pipinoelbreve9 (big blind) folded before Flop
Seat 4: Pabl0o0Poker folded before Flop (didn't bet)
Seat 5: FELIPE439 folded before Flop (didn't bet)
Seat 6: Mazebank46 folded before Flop (didn't bet)



PokerStars Zoom Hand #257439481995:  Hold'em No Limit (€0.01/€0.02) - 2025/08/22 12:24:42 CET [2025/08/22 6:24:42 ET]
Table 'Arneb' 6-max Seat #1 is the button
Seat 1: pipinoelbreve9 (€2.70 in chips) 
Seat 2: flx5757 (€1.07 in chips) 
Seat 3: booster74 (€2.26 in chips) 
Seat 4: Abrelatas787 (€1.73 in chips) 
Seat 5: Ksunm (€2.83 in chips) 
Seat 6: StrangeNoumena (€2.08 in chips) 
flx5757: posts small blind €0.01
booster74: posts big blind €0.02
*** HOLE CARDS ***
Dealt to pipinoelbreve9 [3d Qd]
Abrelatas787: raises €0.04 to €0.06
Ksunm: folds 
StrangeNoumena: folds 
pipinoelbreve9: folds 
flx5757: calls €0.05
booster74: folds 
*** FLOP *** [3c Td 9c]
flx5757: checks 
Abrelatas787: bets €0.07
flx5757: calls €0.07
*** TURN *** [3c Td 9c] [Ad]
flx5757: checks 
Abrelatas787: bets €0.18
flx5757: raises €0.18 to €0.36
Abrelatas787: calls €0.18
*** RIVER *** [3c Td 9c Ad] [2c]
flx5757: checks 
Abrelatas787: bets €0.48
flx5757: folds 
Uncalled bet (€0.48) returned to Abrelatas787
Abrelatas787 collected €0.95 from pot
Abrelatas787: doesn't show hand 
*** SUMMARY ***
Total pot €1 | Rake €0.05 
Board [3c Td 9c Ad 2c]
Seat 1: pipinoelbreve9 (button) folded before Flop (didn't bet)
Seat 2: flx5757 (small blind) folded on the River
Seat 3: booster74 (big blind) folded before Flop
Seat 4: Abrelatas787 collected (€0.95)
Seat 5: Ksunm folded before Flop (didn't bet)
Seat 6: StrangeNoumena folded before Flop (didn't bet)



PokerStars Zoom Hand #257439482646:  Hold'em No Limit (€0.01/€0.02) - 2025/08/22 12:24:49 CET [2025/08/22 6:24:49 ET]
Table 'Arneb' 6-max Seat #1 is the button
Seat 1: burgoa89 (€2.11 in chips) 
Seat 2: FELIPE439 (€2.15 in chips) 
Seat 3: StrangeNoumena (€2.08 in chips) 
Seat 4: kombei63 (€1 in chips) 
Seat 5: Carlosalvaro42 (€1.89 in chips) 
Seat 6: pipinoelbreve9 (€2.70 in chips) 
FELIPE439: posts small blind €0.01
StrangeNoumena: posts big blind €0.02
*** HOLE CARDS ***
Dealt to pipinoelbreve9 [Ac 8c]
kombei63: folds 
Carlosalvaro42: calls €0.02
pipinoelbreve9: raises €0.10 to €0.12
burgoa89: folds 
FELIPE439: folds 
StrangeNoumena: folds 
Carlosalvaro42: calls €0.10
*** FLOP *** [Qh 4c 4d]
Carlosalvaro42: checks 
pipinoelbreve9: checks 
*** TURN *** [Qh 4c 4d] [Tc]
Carlosalvaro42: bets €0.04
pipinoelbreve9: calls €0.04
*** RIVER *** [Qh 4c 4d Tc] [9d]
Carlosalvaro42: checks 
pipinoelbreve9: checks 
*** SHOW DOWN ***
Carlosalvaro42: shows [5h 3s] (a pair of Fours)
pipinoelbreve9: shows [Ac 8c] (a pair of Fours - Ace kicker)
pipinoelbreve9 collected €0.33 from pot
*** SUMMARY ***
Total pot €0.35 | Rake €0.02 
Board [Qh 4c 4d Tc 9d]
Seat 1: burgoa89 (button) folded before Flop (didn't bet)
Seat 2: FELIPE439 (small blind) folded before Flop
Seat 3: StrangeNoumena (big blind) folded before Flop
Seat 4: kombei63 folded before Flop (didn't bet)
Seat 5: Carlosalvaro42 showed [5h 3s] and lost with a pair of Fours
Seat 6: pipinoelbreve9 showed [Ac 8c] and won (€0.33) with a pair of Fours



PokerStars Zoom Hand #257439481498:  Hold'em No Limit (€0.01/€0.02) - 2025/08/22 12:24:37 CET [2025/08/22 6:24:37 ET]
Table 'Arneb' 6-max Seat #1 is the button
Seat 1: ReyGuto (€2.29 in chips) 
Seat 2: adrian1984x (€1.75 in chips) 
Seat 3: LittleVerole (€4.06 in chips) 
Seat 4: pipinoelbreve9 (€2.70 in chips) 
Seat 5: vaznaval (€1.52 in chips) 
Seat 6: Vruj0 (€4.53 in chips) 
adrian1984x: posts small blind €0.01
LittleVerole: posts big blind €0.02
*** HOLE CARDS ***
Dealt to pipinoelbreve9 [3s Kh]
pipinoelbreve9: folds 
vaznaval: raises €0.04 to €0.06
Vruj0: folds 
ReyGuto: raises €0.08 to €0.14
adrian1984x: folds 
LittleVerole: folds 
vaznaval: raises €0.26 to €0.40
ReyGuto: calls €0.26
*** FLOP *** [5h 9h 2c]
vaznaval: bets €1.12 and is all-in
ReyGuto: folds 
Uncalled bet (€1.12) returned to vaznaval
vaznaval collected €0.79 from pot
vaznaval: doesn't show hand 
*** SUMMARY ***
Total pot €0.83 | Rake €0.04 
Board [5h 9h 2c]
Seat 1: ReyGuto (button) folded on the Flop
Seat 2: adrian1984x (small blind) folded before Flop
Seat 3: LittleVerole (big blind) folded before Flop
Seat 4: pipinoelbreve9 folded before Flop (didn't bet)
Seat 5: vaznaval collected (€0.79)
Seat 6: Vruj0 folded before Flop (didn't bet)



PokerStars Zoom Hand #257439487866:  Hold'em No Limit (€0.01/€0.02) - 2025/08/22 12:25:41 CET [2025/08/22 6:25:41 ET]
Table 'Arneb' 6-max Seat #1 is the button
Seat 1: FELIPE439 (€1.63 in chips) 
Seat 2: kombei63 (€1.04 in chips) 
Seat 3: Lord_Shivaaa (€2.02 in chips) 
Seat 4: Miguelitro66 (€2 in chips) 
Seat 5: pipinoelbreve9 (€2.87 in chips) 
Seat 6: gomera30 (€2.05 in chips) 
kombei63: posts small blind €0.01
Lord_Shivaaa: posts big blind €0.02
*** HOLE CARDS ***
Dealt to pipinoelbreve9 [7d Th]
Miguelitro66: folds 
pipinoelbreve9: folds 
gomera30: folds 
FELIPE439: folds 
kombei63: folds 
Uncalled bet (€0.01) returned to Lord_Shivaaa
Lord_Shivaaa collected €0.02 from pot
Lord_Shivaaa: doesn't show hand 
*** SUMMARY ***
Total pot €0.02 | Rake €0 
Seat 1: FELIPE439 (button) folded before Flop (didn't bet)
Seat 2: kombei63 (small blind) folded before Flop
Seat 3: Lord_Shivaaa (big blind) collected (€0.02)
Seat 4: Miguelitro66 folded before Flop (didn't bet)
Seat 5: pipinoelbreve9 folded before Flop (didn't bet)
Seat 6: gomera30 folded before Flop (didn't bet)



PokerStars Zoom Hand #257439487327:  Hold'em No Limit (€0.01/€0.02) - 2025/08/22 12:25:36 CET [2025/08/22 6:25:36 ET]
Table 'Arneb' 6-max Seat #1 is the button
Seat 1: kombei63 (€1.04 in chips) 
Seat 2: StrangeNoumena (€2 in chips) 
Seat 3: 77samuel33 (€2.06 in chips) 
Seat 4: pipinoelbreve9 (€2.87 in chips) 
Seat 5: Decomou (€1.01 in chips) 
Seat 6: Carlosalvaro42 (€1.73 in chips) 
StrangeNoumena: posts small blind €0.01
77samuel33: posts big blind €0.02
*** HOLE CARDS ***
Dealt to pipinoelbreve9 [9c 2d]
pipinoelbreve9: folds 
Decomou: folds 
Carlosalvaro42: calls €0.02
kombei63: folds 
StrangeNoumena: folds 
77samuel33: checks 
*** FLOP *** [8s Qc 7s]
77samuel33: bets €0.04
Carlosalvaro42: folds 
Uncalled bet (€0.04) returned to 77samuel33
77samuel33 collected €0.05 from pot
77samuel33: doesn't show hand 
*** SUMMARY ***
Total pot €0.05 | Rake €0 
Board [8s Qc 7s]
Seat 1: kombei63 (button) folded before Flop (didn't bet)
Seat 2: StrangeNoumena (small blind) folded before Flop
Seat 3: 77samuel33 (big blind) collected (€0.05)
Seat 4: pipinoelbreve9 folded before Flop (didn't bet)
Seat 5: Decomou folded before Flop (didn't bet)
Seat 6: Carlosalvaro42 folded on the Flop



PokerStars Zoom Hand #257439488173:  Hold'em No Limit (€0.01/€0.02) - 2025/08/22 12:25:45 CET [2025/08/22 6:25:45 ET]
Table 'Arneb' 6-max Seat #1 is the button
Seat 1: nofuture69 (€2.18 in chips) 
Seat 2: FELIPE439 (€2.43 in chips) 
Seat 3: pipinoelbreve9 (€2.87 in chips) 
Seat 4: Miguelitro66 (€2 in chips) 
Seat 5: kombei63 (€1 in chips) 
Seat 6: LarryLurex72 (€1.39 in chips) 
FELIPE439: posts small blind €0.01
pipinoelbreve9: posts big blind €0.02
*** HOLE CARDS ***
Dealt to pipinoelbreve9 [7c 8h]
Miguelitro66: folds 
kombei63: folds 
LarryLurex72: folds 
nofuture69: raises €0.03 to €0.05
FELIPE439: folds 
pipinoelbreve9: folds 
Uncalled bet (€0.03) returned to nofuture69
nofuture69 collected €0.05 from pot
nofuture69: doesn't show hand 
*** SUMMARY ***
Total pot €0.05 | Rake €0 
Seat 1: nofuture69 (button) collected (€0.05)
Seat 2: FELIPE439 (small blind) folded before Flop
Seat 3: pipinoelbreve9 (big blind) folded before Flop
Seat 4: Miguelitro66 folded before Flop (didn't bet)
Seat 5: kombei63 folded before Flop (didn't bet)
Seat 6: LarryLurex72 folded before Flop (didn't bet)



PokerStars Zoom Hand #257439488706:  Hold'em No Limit (€0.01/€0.02) - 2025/08/22 12:25:50 CET [2025/08/22 6:25:50 ET]
Table 'Arneb' 6-max Seat #1 is the button
Seat 1: flx5757 (€5.76 in chips) 
Seat 2: dreamer11111 (€5.07 in chips) 
Seat 3: gelotes (€2.01 in chips) 
Seat 4: pipinoelbreve9 (€2.85 in chips) 
Seat 5: ReyGuto (€1.88 in chips) 
Seat 6: kombei63 (€0.94 in chips) 
dreamer11111: posts small blind €0.01
gelotes: posts big blind €0.02
*** HOLE CARDS ***
Dealt to pipinoelbreve9 [Qs 4h]
pipinoelbreve9: folds 
ReyGuto: folds 
kombei63: folds 
flx5757: folds 
dreamer11111: folds 
Uncalled bet (€0.01) returned to gelotes
gelotes collected €0.02 from pot
gelotes: doesn't show hand 
*** SUMMARY ***
Total pot €0.02 | Rake €0 
Seat 1: flx5757 (button) folded before Flop (didn't bet)
Seat 2: dreamer11111 (small blind) folded before Flop
Seat 3: gelotes (big blind) collected (€0.02)
Seat 4: pipinoelbreve9 folded before Flop (didn't bet)
Seat 5: ReyGuto folded before Flop (didn't bet)
Seat 6: kombei63 folded before Flop (didn't bet)



PokerStars Zoom Hand #257439489427:  Hold'em No Limit (€0.01/€0.02) - 2025/08/22 12:25:58 CET [2025/08/22 6:25:58 ET]
Table 'Arneb' 6-max Seat #1 is the button
Seat 1: 77samuel33 (€2.08 in chips) 
Seat 2: pipinoelbreve9 (€2.85 in chips) 
Seat 3: aaronroxi (€3.39 in chips) 
Seat 4: kombei63 (€0.74 in chips) 
Seat 5: pera6521 (€2.09 in chips) 
Seat 6: FELIPE439 (€2.42 in chips) 
pipinoelbreve9: posts small blind €0.01
aaronroxi: posts big blind €0.02
*** HOLE CARDS ***
Dealt to pipinoelbreve9 [Kc Ts]
kombei63: folds 
pera6521: folds 
FELIPE439: folds 
77samuel33: folds 
pipinoelbreve9: folds 
Uncalled bet (€0.01) returned to aaronroxi
aaronroxi collected €0.02 from pot
aaronroxi: doesn't show hand 
*** SUMMARY ***
Total pot €0.02 | Rake €0 
Seat 1: 77samuel33 (button) folded before Flop (didn't bet)
Seat 2: pipinoelbreve9 (small blind) folded before Flop
Seat 3: aaronroxi (big blind) collected (€0.02)
Seat 4: kombei63 folded before Flop (didn't bet)
Seat 5: pera6521 folded before Flop (didn't bet)
Seat 6: FELIPE439 folded before Flop (didn't bet)



PokerStars Zoom Hand #257439490950:  Hold'em No Limit (€0.01/€0.02) - 2025/08/22 12:26:13 CET [2025/08/22 6:26:13 ET]
Table 'Arneb' 6-max Seat #1 is the button
Seat 1: pipinoelbreve9 (€2.84 in chips) 
Seat 2: Ksunm (€2.78 in chips) 
Seat 3: Vruj0 (€4.91 in chips) 
Seat 4: dreamer11111 (€5.06 in chips) 
Seat 5: Lord_Shivaaa (€2.02 in chips) 
Seat 6: XXILuv (€1.99 in chips) 
Ksunm: posts small blind €0.01
Vruj0: posts big blind €0.02
*** HOLE CARDS ***
Dealt to pipinoelbreve9 [Jh 5c]
dreamer11111: raises €0.05 to €0.07
Lord_Shivaaa: folds 
XXILuv: folds 
pipinoelbreve9: folds 
Ksunm: folds 
Vruj0: raises €0.19 to €0.26
dreamer11111: folds 
Uncalled bet (€0.19) returned to Vruj0
Vruj0 collected €0.15 from pot
Vruj0: doesn't show hand 
*** SUMMARY ***
Total pot €0.15 | Rake €0 
Seat 1: pipinoelbreve9 (button) folded before Flop (didn't bet)
Seat 2: Ksunm (small blind) folded before Flop
Seat 3: Vruj0 (big blind) collected (€0.15)
Seat 4: dreamer11111 folded before Flop
Seat 5: Lord_Shivaaa folded before Flop (didn't bet)
Seat 6: XXILuv folded before Flop (didn't bet)



PokerStars Zoom Hand #257439492766:  Hold'em No Limit (€0.01/€0.02) - 2025/08/22 12:26:33 CET [2025/08/22 6:26:33 ET]
Table 'Arneb' 6-max Seat #1 is the button
Seat 1: boogychat (€1.17 in chips) 
Seat 2: Abrelatas787 (€2.14 in chips) 
Seat 3: pipinoelbreve9 (€2.84 in chips) 
Seat 4: gomera30 (€3.83 in chips) 
Seat 5: adrian1984x (€1.99 in chips) 
Seat 6: bega13 (€2.63 in chips) 
Abrelatas787: posts small blind €0.01
pipinoelbreve9: posts big blind €0.02
*** HOLE CARDS ***
Dealt to pipinoelbreve9 [As 6c]
gomera30: folds 
adrian1984x: folds 
bega13: raises €0.03 to €0.05
boogychat: folds 
Abrelatas787: folds 
pipinoelbreve9: folds 
Uncalled bet (€0.03) returned to bega13
bega13 collected €0.05 from pot
bega13: doesn't show hand 
*** SUMMARY ***
Total pot €0.05 | Rake €0 
Seat 1: boogychat (button) folded before Flop (didn't bet)
Seat 2: Abrelatas787 (small blind) folded before Flop
Seat 3: pipinoelbreve9 (big blind) folded before Flop
Seat 4: gomera30 folded before Flop (didn't bet)
Seat 5: adrian1984x folded before Flop (didn't bet)
Seat 6: bega13 collected (€0.05)



PokerStars Zoom Hand #257439492374:  Hold'em No Limit (€0.01/€0.02) - 2025/08/22 12:26:29 CET [2025/08/22 6:26:29 ET]
Table 'Arneb' 6-max Seat #1 is the button
Seat 1: aaronroxi (€3.39 in chips) 
Seat 2: XXILuv (€1.99 in chips) 
Seat 3: meruem70 (€1.32 in chips) 
Seat 4: bega13 (€2.45 in chips) 
Seat 5: FELIPE439 (€1.60 in chips) 
Seat 6: pipinoelbreve9 (€2.84 in chips) 
XXILuv: posts small blind €0.01
meruem70: posts big blind €0.02
*** HOLE CARDS ***
Dealt to pipinoelbreve9 [4h 9c]
bega13: folds 
meruem70 is disconnected 
FELIPE439: folds 
pipinoelbreve9: folds 
aaronroxi: raises €0.04 to €0.06
XXILuv: folds 
meruem70 has timed out while disconnected
meruem70: folds 
Uncalled bet (€0.04) returned to aaronroxi
aaronroxi collected €0.05 from pot
aaronroxi: doesn't show hand 
*** SUMMARY ***
Total pot €0.05 | Rake €0 
Seat 1: aaronroxi (button) collected (€0.05)
Seat 2: XXILuv (small blind) folded before Flop
Seat 3: meruem70 (big blind) folded before Flop
Seat 4: bega13 folded before Flop (didn't bet)
Seat 5: FELIPE439 folded before Flop (didn't bet)
Seat 6: pipinoelbreve9 folded before Flop (didn't bet)



PokerStars Zoom Hand #257439494470:  Hold'em No Limit (€0.01/€0.02) - 2025/08/22 12:26:50 CET [2025/08/22 6:26:50 ET]
Table 'Arneb' 6-max Seat #1 is the button
Seat 1: kombei63 (€1.15 in chips) 
Seat 2: pipinoelbreve9 (€2.82 in chips) 
Seat 3: adrian1984x (€2.02 in chips) 
Seat 4: JENOFONTE73 (€2.55 in chips) 
Seat 5: jeannono24 (€2.61 in chips) 
Seat 6: ReyGuto (€1.85 in chips) 
pipinoelbreve9: posts small blind €0.01
adrian1984x: posts big blind €0.02
*** HOLE CARDS ***
Dealt to pipinoelbreve9 [3s 3c]
JENOFONTE73: folds 
jeannono24: folds 
ReyGuto: folds 
kombei63: folds 
pipinoelbreve9: raises €0.04 to €0.06
adrian1984x: raises €1.96 to €2.02 and is all-in
pipinoelbreve9: folds 
Uncalled bet (€1.96) returned to adrian1984x
adrian1984x collected €0.12 from pot
adrian1984x: doesn't show hand 
*** SUMMARY ***
Total pot €0.12 | Rake €0 
Seat 1: kombei63 (button) folded before Flop (didn't bet)
Seat 2: pipinoelbreve9 (small blind) folded before Flop
Seat 3: adrian1984x (big blind) collected (€0.12)
Seat 4: JENOFONTE73 folded before Flop (didn't bet)
Seat 5: jeannono24 folded before Flop (didn't bet)
Seat 6: ReyGuto folded before Flop (didn't bet)



PokerStars Zoom Hand #257439491581:  Hold'em No Limit (€0.01/€0.02) - 2025/08/22 12:26:20 CET [2025/08/22 6:26:20 ET]
Table 'Arneb' 6-max Seat #1 is the button
Seat 1: allmike78 (€2.09 in chips) 
Seat 2: 77samuel33 (€7.71 in chips) 
Seat 3: Miguelitro66 (€2.08 in chips) 
Seat 4: jeannono24 (€2.81 in chips) 
Seat 5: XXILuv (€1.99 in chips) 
Seat 6: pipinoelbreve9 (€2.84 in chips) 
77samuel33: posts small blind €0.01
Miguelitro66: posts big blind €0.02
*** HOLE CARDS ***
Dealt to pipinoelbreve9 [7h 4h]
jeannono24: folds 
XXILuv: folds 
pipinoelbreve9: folds 
allmike78: folds 
77samuel33: raises €0.04 to €0.06
Miguelitro66: calls €0.04
*** FLOP *** [2d 6d 5s]
77samuel33: bets €0.04
Miguelitro66: calls €0.04
*** TURN *** [2d 6d 5s] [6s]
77samuel33: checks 
Miguelitro66: bets €0.08
77samuel33: calls €0.08
*** RIVER *** [2d 6d 5s 6s] [Tc]
77samuel33: checks 
Miguelitro66: checks 
*** SHOW DOWN ***
77samuel33: shows [9d Qd] (a pair of Sixes)
Miguelitro66: mucks hand 
77samuel33 collected €0.34 from pot
*** SUMMARY ***
Total pot €0.36 | Rake €0.02 
Board [2d 6d 5s 6s Tc]
Seat 1: allmike78 (button) folded before Flop (didn't bet)
Seat 2: 77samuel33 (small blind) showed [9d Qd] and won (€0.34) with a pair of Sixes
Seat 3: Miguelitro66 (big blind) mucked [7d Qh]
Seat 4: jeannono24 folded before Flop (didn't bet)
Seat 5: XXILuv folded before Flop (didn't bet)
Seat 6: pipinoelbreve9 folded before Flop (didn't bet)



PokerStars Zoom Hand #257439496456:  Hold'em No Limit (€0.01/€0.02) - 2025/08/22 12:27:11 CET [2025/08/22 6:27:11 ET]
Table 'Arneb' 6-max Seat #1 is the button
Seat 1: bega13 (€2.73 in chips) 
Seat 2: XXILuv (€2.63 in chips) 
Seat 3: Pabl0o0Poker (€4.92 in chips) 
Seat 4: adrian1984x (€2.08 in chips) 
Seat 5: pipinoelbreve9 (€2.76 in chips) 
Seat 6: JENOFONTE73 (€2.83 in chips) 
XXILuv: posts small blind €0.01
Pabl0o0Poker: posts big blind €0.02
*** HOLE CARDS ***
Dealt to pipinoelbreve9 [2c Js]
adrian1984x: folds 
pipinoelbreve9: folds 
JENOFONTE73: raises €0.03 to €0.05
bega13: folds 
XXILuv: folds 
Pabl0o0Poker: folds 
Uncalled bet (€0.03) returned to JENOFONTE73
JENOFONTE73 collected €0.05 from pot
JENOFONTE73: doesn't show hand 
*** SUMMARY ***
Total pot €0.05 | Rake €0 
Seat 1: bega13 (button) folded before Flop (didn't bet)
Seat 2: XXILuv (small blind) folded before Flop
Seat 3: Pabl0o0Poker (big blind) folded before Flop
Seat 4: adrian1984x folded before Flop (didn't bet)
Seat 5: pipinoelbreve9 folded before Flop (didn't bet)
Seat 6: JENOFONTE73 collected (€0.05)



PokerStars Zoom Hand #257439497226:  Hold'em No Limit (€0.01/€0.02) - 2025/08/22 12:27:19 CET [2025/08/22 6:27:19 ET]
Table 'Arneb' 6-max Seat #1 is the button
Seat 1: aaronroxi (€3.39 in chips) 
Seat 2: XXILuv (€2 in chips) 
Seat 3: jeannono24 (€2 in chips) 
Seat 4: pipinoelbreve9 (€2.76 in chips) 
Seat 5: Valencinco (€2.24 in chips) 
Seat 6: ursu1957 (€2.89 in chips) 
XXILuv: posts small blind €0.01
jeannono24: posts big blind €0.02
*** HOLE CARDS ***
Dealt to pipinoelbreve9 [7s 6d]
pipinoelbreve9: folds 
Valencinco: folds 
ursu1957: folds 
aaronroxi: folds 
XXILuv: folds 
Uncalled bet (€0.01) returned to jeannono24
jeannono24 collected €0.02 from pot
jeannono24: doesn't show hand 
*** SUMMARY ***
Total pot €0.02 | Rake €0 
Seat 1: aaronroxi (button) folded before Flop (didn't bet)
Seat 2: XXILuv (small blind) folded before Flop
Seat 3: jeannono24 (big blind) collected (€0.02)
Seat 4: pipinoelbreve9 folded before Flop (didn't bet)
Seat 5: Valencinco folded before Flop (didn't bet)
Seat 6: ursu1957 folded before Flop (didn't bet)



PokerStars Zoom Hand #257439497721:  Hold'em No Limit (€0.01/€0.02) - 2025/08/22 12:27:24 CET [2025/08/22 6:27:24 ET]
Table 'Arneb' 6-max Seat #1 is the button
Seat 1: pipinoelbreve9 (€2.76 in chips) 
Seat 2: JENOFONTE73 (€2.86 in chips) 
Seat 3: ReyGuto (€1.84 in chips) 
Seat 4: XXILuv (€2.62 in chips) 
Seat 5: Valencinco (€2 in chips) 
Seat 6: bega13 (€2.02 in chips) 
JENOFONTE73: posts small blind €0.01
ReyGuto: posts big blind €0.02
*** HOLE CARDS ***
Dealt to pipinoelbreve9 [Ah Th]
XXILuv: folds 
Valencinco: folds 
bega13: folds 
pipinoelbreve9: raises €0.04 to €0.06
JENOFONTE73: folds 
ReyGuto: folds 
Uncalled bet (€0.04) returned to pipinoelbreve9
pipinoelbreve9 collected €0.05 from pot
pipinoelbreve9: doesn't show hand 
*** SUMMARY ***
Total pot €0.05 | Rake €0 
Seat 1: pipinoelbreve9 (button) collected (€0.05)
Seat 2: JENOFONTE73 (small blind) folded before Flop
Seat 3: ReyGuto (big blind) folded before Flop
Seat 4: XXILuv folded before Flop (didn't bet)
Seat 5: Valencinco folded before Flop (didn't bet)
Seat 6: bega13 folded before Flop (didn't bet)



PokerStars Zoom Hand #257439500348:  Hold'em No Limit (€0.01/€0.02) - 2025/08/22 12:27:51 CET [2025/08/22 6:27:51 ET]
Table 'Arneb' 6-max Seat #1 is the button
Seat 1: gomera30 (€2.34 in chips) 
Seat 2: JENOFONTE73 (€2.50 in chips) 
Seat 3: pipinoelbreve9 (€2.79 in chips) 
Seat 4: FELIPE439 (€1.53 in chips) 
Seat 5: jeannono24 (€2 in chips) 
Seat 6: nofuture69 (€2 in chips) 
JENOFONTE73: posts small blind €0.01
pipinoelbreve9: posts big blind €0.02
*** HOLE CARDS ***
Dealt to pipinoelbreve9 [4c Qh]
FELIPE439: folds 
jeannono24: folds 
nofuture69: folds 
gomera30: folds 
JENOFONTE73: folds 
Uncalled bet (€0.01) returned to pipinoelbreve9
pipinoelbreve9 collected €0.02 from pot
pipinoelbreve9: doesn't show hand 
*** SUMMARY ***
Total pot €0.02 | Rake €0 
Seat 1: gomera30 (button) folded before Flop (didn't bet)
Seat 2: JENOFONTE73 (small blind) folded before Flop
Seat 3: pipinoelbreve9 (big blind) collected (€0.02)
Seat 4: FELIPE439 folded before Flop (didn't bet)
Seat 5: jeannono24 folded before Flop (didn't bet)
Seat 6: nofuture69 folded before Flop (didn't bet)



PokerStars Zoom Hand #257439499688:  Hold'em No Limit (€0.01/€0.02) - 2025/08/22 12:27:44 CET [2025/08/22 6:27:44 ET]
Table 'Arneb' 6-max Seat #1 is the button
Seat 1: kombei63 (€0.88 in chips) 
Seat 2: FELIPE439 (€2.02 in chips) 
Seat 3: Alejandro9494 (€2 in chips) 
Seat 4: JENOFONTE73 (€2.85 in chips) 
Seat 5: pipinoelbreve9 (€2.79 in chips) 
Seat 6: gomera30 (€3.80 in chips) 
FELIPE439: posts small blind €0.01
Alejandro9494: posts big blind €0.02
*** HOLE CARDS ***
Dealt to pipinoelbreve9 [Kc 5h]
JENOFONTE73: folds 
pipinoelbreve9: folds 
gomera30: folds 
kombei63: raises €0.04 to €0.06
FELIPE439: folds 
Alejandro9494: folds 
Uncalled bet (€0.04) returned to kombei63
kombei63 collected €0.05 from pot
kombei63: doesn't show hand 
*** SUMMARY ***
Total pot €0.05 | Rake €0 
Seat 1: kombei63 (button) collected (€0.05)
Seat 2: FELIPE439 (small blind) folded before Flop
Seat 3: Alejandro9494 (big blind) folded before Flop
Seat 4: JENOFONTE73 folded before Flop (didn't bet)
Seat 5: pipinoelbreve9 folded before Flop (didn't bet)
Seat 6: gomera30 folded before Flop (didn't bet)



PokerStars Zoom Hand #257439501377:  Hold'em No Limit (€0.01/€0.02) - 2025/08/22 12:28:01 CET [2025/08/22 6:28:01 ET]
Table 'Arneb' 6-max Seat #1 is the button
Seat 1: bega13 (€2.66 in chips) 
Seat 2: aaronroxi (€3.37 in chips) 
Seat 3: kombei63 (€1.02 in chips) 
Seat 4: Alejandro9494 (€1.98 in chips) 
Seat 5: FELIPE439 (€2.01 in chips) 
Seat 6: pipinoelbreve9 (€2.80 in chips) 
aaronroxi: posts small blind €0.01
kombei63: posts big blind €0.02
*** HOLE CARDS ***
Dealt to pipinoelbreve9 [Qd Jd]
Alejandro9494: raises €0.04 to €0.06
FELIPE439: folds 
pipinoelbreve9: raises €0.10 to €0.16
bega13: folds 
aaronroxi: folds 
kombei63: folds 
Alejandro9494: calls €0.10
*** FLOP *** [Kd Ts 6c]
Alejandro9494: checks 
pipinoelbreve9: bets €0.21
Alejandro9494: calls €0.21
*** TURN *** [Kd Ts 6c] [Kc]
Alejandro9494: checks 
pipinoelbreve9: checks 
*** RIVER *** [Kd Ts 6c Kc] [Tc]
Alejandro9494: checks 
pipinoelbreve9: checks 
*** SHOW DOWN ***
Alejandro9494: shows [Jc Qc] (a flush, King high)
pipinoelbreve9: mucks hand 
Alejandro9494 collected €0.73 from pot
*** SUMMARY ***
Total pot €0.77 | Rake €0.04 
Board [Kd Ts 6c Kc Tc]
Seat 1: bega13 (button) folded before Flop (didn't bet)
Seat 2: aaronroxi (small blind) folded before Flop
Seat 3: kombei63 (big blind) folded before Flop
Seat 4: Alejandro9494 showed [Jc Qc] and won (€0.73) with a flush, King high
Seat 5: FELIPE439 folded before Flop (didn't bet)
Seat 6: pipinoelbreve9 mucked [Qd Jd]



PokerStars Zoom Hand #257439505706:  Hold'em No Limit (€0.01/€0.02) - 2025/08/22 12:28:46 CET [2025/08/22 6:28:46 ET]
Table 'Arneb' 6-max Seat #1 is the button
Seat 1: kombei63 (€0.91 in chips) 
Seat 2: pipinoelbreve9 (€2.43 in chips) 
Seat 3: FELIPE439 (€2.08 in chips) 
Seat 4: NCabral_SCP (€2.44 in chips) 
Seat 5: StrangeNoumena (€1.94 in chips) 
Seat 6: nofuture69 (€2.06 in chips) 
pipinoelbreve9: posts small blind €0.01
FELIPE439: posts big blind €0.02
*** HOLE CARDS ***
Dealt to pipinoelbreve9 [Ad Qh]
NCabral_SCP: folds 
StrangeNoumena: folds 
nofuture69: folds 
kombei63: folds 
pipinoelbreve9: raises €0.04 to €0.06
FELIPE439: folds 
Uncalled bet (€0.04) returned to pipinoelbreve9
pipinoelbreve9 collected €0.04 from pot
pipinoelbreve9: doesn't show hand 
*** SUMMARY ***
Total pot €0.04 | Rake €0 
Seat 1: kombei63 (button) folded before Flop (didn't bet)
Seat 2: pipinoelbreve9 (small blind) collected (€0.04)
Seat 3: FELIPE439 (big blind) folded before Flop
Seat 4: NCabral_SCP folded before Flop (didn't bet)
Seat 5: StrangeNoumena folded before Flop (didn't bet)
Seat 6: nofuture69 folded before Flop (didn't bet)



PokerStars Zoom Hand #257439507304:  Hold'em No Limit (€0.01/€0.02) - 2025/08/22 12:29:03 CET [2025/08/22 6:29:03 ET]
Table 'Arneb' 6-max Seat #1 is the button
Seat 1: grenha1972 (€1.74 in chips) 
Seat 2: Abrelatas787 (€3.25 in chips) 
Seat 3: StrangeNoumena (€1.94 in chips) 
Seat 4: pipinoelbreve9 (€2.45 in chips) 
Seat 5: FELIPE439 (€2.06 in chips) 
Seat 6: Lord_Shivaaa (€2 in chips) 
Abrelatas787: posts small blind €0.01
StrangeNoumena: posts big blind €0.02
*** HOLE CARDS ***
Dealt to pipinoelbreve9 [4s 3h]
pipinoelbreve9: folds 
FELIPE439: folds 
Lord_Shivaaa: folds 
grenha1972: folds 
Abrelatas787: folds 
Uncalled bet (€0.01) returned to StrangeNoumena
StrangeNoumena collected €0.02 from pot
StrangeNoumena: doesn't show hand 
*** SUMMARY ***
Total pot €0.02 | Rake €0 
Seat 1: grenha1972 (button) folded before Flop (didn't bet)
Seat 2: Abrelatas787 (small blind) folded before Flop
Seat 3: StrangeNoumena (big blind) collected (€0.02)
Seat 4: pipinoelbreve9 folded before Flop (didn't bet)
Seat 5: FELIPE439 folded before Flop (didn't bet)
Seat 6: Lord_Shivaaa folded before Flop (didn't bet)



PokerStars Zoom Hand #257439507897:  Hold'em No Limit (€0.01/€0.02) - 2025/08/22 12:29:09 CET [2025/08/22 6:29:09 ET]
Table 'Arneb' 6-max Seat #1 is the button
Seat 1: pipinoelbreve9 (€2.45 in chips) 
Seat 2: Martial333 (€1.99 in chips) 
Seat 3: allmike78 (€1.14 in chips) 
Seat 4: flx5757 (€1.04 in chips) 
Seat 5: jeannono24 (€2.56 in chips) 
Seat 6: Lord_Shivaaa (€2 in chips) 
Martial333: posts small blind €0.01
allmike78: posts big blind €0.02
*** HOLE CARDS ***
Dealt to pipinoelbreve9 [7c Kc]
flx5757: folds 
jeannono24: raises €0.04 to €0.06
Lord_Shivaaa: folds 
pipinoelbreve9: folds 
Martial333: calls €0.05
allmike78: folds 
*** FLOP *** [Ts 2d 7h]
Martial333: checks 
jeannono24: checks 
*** TURN *** [Ts 2d 7h] [4d]
Martial333: bets €0.02
jeannono24: folds 
Uncalled bet (€0.02) returned to Martial333
Martial333 collected €0.13 from pot
Martial333: doesn't show hand 
*** SUMMARY ***
Total pot €0.14 | Rake €0.01 
Board [Ts 2d 7h 4d]
Seat 1: pipinoelbreve9 (button) folded before Flop (didn't bet)
Seat 2: Martial333 (small blind) collected (€0.13)
Seat 3: allmike78 (big blind) folded before Flop
Seat 4: flx5757 folded before Flop (didn't bet)
Seat 5: jeannono24 folded on the Turn
Seat 6: Lord_Shivaaa folded before Flop (didn't bet)



PokerStars Zoom Hand #257439508799:  Hold'em No Limit (€0.01/€0.02) - 2025/08/22 12:29:18 CET [2025/08/22 6:29:18 ET]
Table 'Arneb' 6-max Seat #1 is the button
Seat 1: skorpia1988 (€2 in chips) 
Seat 2: StrangeNoumena (€1.95 in chips) 
Seat 3: kombei63 (€0.90 in chips) 
Seat 4: pipinoelbreve9 (€2.45 in chips) 
Seat 5: Lord_Shivaaa (€2 in chips) 
Seat 6: Alejandro9494 (€2.36 in chips) 
StrangeNoumena: posts small blind €0.01
kombei63: posts big blind €0.02
*** HOLE CARDS ***
Dealt to pipinoelbreve9 [8c 6d]
pipinoelbreve9: folds 
Lord_Shivaaa: raises €0.03 to €0.05
Alejandro9494: calls €0.05
skorpia1988: folds 
StrangeNoumena: folds 
kombei63: folds 
*** FLOP *** [Ad 8h 5s]
Lord_Shivaaa: checks 
Alejandro9494: bets €0.02
Lord_Shivaaa: calls €0.02
*** TURN *** [Ad 8h 5s] [7h]
Lord_Shivaaa: checks 
Alejandro9494: bets €0.06
Lord_Shivaaa: folds 
Uncalled bet (€0.06) returned to Alejandro9494
Alejandro9494 collected €0.16 from pot
Alejandro9494: doesn't show hand 
*** SUMMARY ***
Total pot €0.17 | Rake €0.01 
Board [Ad 8h 5s 7h]
Seat 1: skorpia1988 (button) folded before Flop (didn't bet)
Seat 2: StrangeNoumena (small blind) folded before Flop
Seat 3: kombei63 (big blind) folded before Flop
Seat 4: pipinoelbreve9 folded before Flop (didn't bet)
Seat 5: Lord_Shivaaa folded on the Turn
Seat 6: Alejandro9494 collected (€0.16)



PokerStars Zoom Hand #257439508267:  Hold'em No Limit (€0.01/€0.02) - 2025/08/22 12:29:13 CET [2025/08/22 6:29:13 ET]
Table 'Arneb' 6-max Seat #1 is the button
Seat 1: bega13 (€2.50 in chips) 
Seat 2: Valencinco (€2.38 in chips) 
Seat 3: kombei63 (€0.91 in chips) 
Seat 4: pipinoelbreve9 (€2.45 in chips) 
Seat 5: nicovdle (€1.62 in chips) 
Seat 6: flx5757 (€1.04 in chips) 
Valencinco: posts small blind €0.01
kombei63: posts big blind €0.02
*** HOLE CARDS ***
Dealt to pipinoelbreve9 [3s Qs]
pipinoelbreve9: folds 
nicovdle: folds 
flx5757: raises €0.02 to €0.04
bega13: calls €0.04
Valencinco: calls €0.03
kombei63: calls €0.02
*** FLOP *** [Kd 4c 2d]
Valencinco: checks 
kombei63: checks 
flx5757: checks 
bega13: checks 
*** TURN *** [Kd 4c 2d] [5c]
Valencinco: checks 
kombei63: bets €0.08
flx5757: raises €0.16 to €0.24
bega13: folds 
Valencinco: folds 
kombei63: calls €0.16
*** RIVER *** [Kd 4c 2d 5c] [7s]
kombei63: checks 
flx5757: bets €0.76 and is all-in
kombei63: calls €0.63 and is all-in
Uncalled bet (€0.13) returned to flx5757
*** SHOW DOWN ***
flx5757: shows [Ac 6s] (high card Ace)
kombei63: shows [4h Kh] (two pair, Kings and Fours)
kombei63 collected €1.80 from pot
*** SUMMARY ***
Total pot €1.90 | Rake €0.10 
Board [Kd 4c 2d 5c 7s]
Seat 1: bega13 (button) folded on the Turn
Seat 2: Valencinco (small blind) folded on the Turn
Seat 3: kombei63 (big blind) showed [4h Kh] and won (€1.80) with two pair, Kings and Fours
Seat 4: pipinoelbreve9 folded before Flop (didn't bet)
Seat 5: nicovdle folded before Flop (didn't bet)
Seat 6: flx5757 showed [Ac 6s] and lost with high card Ace



PokerStars Zoom Hand #257439509481:  Hold'em No Limit (€0.01/€0.02) - 2025/08/22 12:29:26 CET [2025/08/22 6:29:26 ET]
Table 'Arneb' 6-max Seat #1 is the button
Seat 1: 77samuel33 (€7.69 in chips) 
Seat 2: allmike78 (€1.12 in chips) 
Seat 3: pipinoelbreve9 (€2.45 in chips) 
Seat 4: crissstal (€0.80 in chips) 
Seat 5: XXILuv (€2.55 in chips) 
Seat 6: aaronroxi (€3.23 in chips) 
allmike78: posts small blind €0.01
pipinoelbreve9: posts big blind €0.02
*** HOLE CARDS ***
Dealt to pipinoelbreve9 [4c Kc]
crissstal: folds 
XXILuv: folds 
aaronroxi: folds 
77samuel33: raises €0.04 to €0.06
allmike78: calls €0.05
pipinoelbreve9: calls €0.04
*** FLOP *** [Qh 4d 4s]
allmike78: bets €0.06
pipinoelbreve9: calls €0.06
77samuel33: calls €0.06
*** TURN *** [Qh 4d 4s] [5d]
allmike78: bets €0.14
pipinoelbreve9: calls €0.14
77samuel33: calls €0.14
*** RIVER *** [Qh 4d 4s 5d] [Jh]
allmike78: bets €0.74
pipinoelbreve9: raises €1.45 to €2.19 and is all-in
77samuel33: folds 
allmike78: calls €0.12 and is all-in
Uncalled bet (€1.33) returned to pipinoelbreve9
*** SHOW DOWN ***
pipinoelbreve9: shows [4c Kc] (three of a kind, Fours)
allmike78: shows [Qs Js] (two pair, Queens and Jacks)
pipinoelbreve9 collected €2.38 from pot
*** SUMMARY ***
Total pot €2.50 | Rake €0.12 
Board [Qh 4d 4s 5d Jh]
Seat 1: 77samuel33 (button) folded on the River
Seat 2: allmike78 (small blind) showed [Qs Js] and lost with two pair, Queens and Jacks
Seat 3: pipinoelbreve9 (big blind) showed [4c Kc] and won (€2.38) with three of a kind, Fours
Seat 4: crissstal folded before Flop (didn't bet)
Seat 5: XXILuv folded before Flop (didn't bet)
Seat 6: aaronroxi folded before Flop (didn't bet)



PokerStars Zoom Hand #257439516184:  Hold'em No Limit (€0.01/€0.02) - 2025/08/22 12:30:36 CET [2025/08/22 6:30:36 ET]
Table 'Arneb' 6-max Seat #1 is the button
Seat 1: NunoSoares18 (€1.83 in chips) 
Seat 2: Carlosalvaro42 (€2.05 in chips) 
Seat 3: pera6521 (€1.99 in chips) 
Seat 4: Lord_Shivaaa (€2 in chips) 
Seat 5: nofuture69 (€2 in chips) 
Seat 6: pipinoelbreve9 (€3.71 in chips) 
Carlosalvaro42: posts small blind €0.01
pera6521: posts big blind €0.02
*** HOLE CARDS ***
Dealt to pipinoelbreve9 [Qs Kh]
Lord_Shivaaa: folds 
nofuture69: folds 
pipinoelbreve9: raises €0.04 to €0.06
NunoSoares18: folds 
Carlosalvaro42: calls €0.05
pera6521: calls €0.04
*** FLOP *** [2h 5h Ad]
Carlosalvaro42: checks 
pera6521: checks 
pipinoelbreve9: checks 
*** TURN *** [2h 5h Ad] [4h]
Carlosalvaro42: checks 
pera6521: checks 
pipinoelbreve9: bets €0.12
Carlosalvaro42: folds 
pera6521: folds 
Uncalled bet (€0.12) returned to pipinoelbreve9
pipinoelbreve9 collected €0.17 from pot
pipinoelbreve9: doesn't show hand 
*** SUMMARY ***
Total pot €0.18 | Rake €0.01 
Board [2h 5h Ad 4h]
Seat 1: NunoSoares18 (button) folded before Flop (didn't bet)
Seat 2: Carlosalvaro42 (small blind) folded on the Turn
Seat 3: pera6521 (big blind) folded on the Turn
Seat 4: Lord_Shivaaa folded before Flop (didn't bet)
Seat 5: nofuture69 folded before Flop (didn't bet)
Seat 6: pipinoelbreve9 collected (€0.17)



PokerStars Zoom Hand #257439521848:  Hold'em No Limit (€0.01/€0.02) - 2025/08/22 12:31:35 CET [2025/08/22 6:31:35 ET]
Table 'Arneb' 6-max Seat #1 is the button
Seat 1: FELIPE439 (€4.03 in chips) 
Seat 2: pipinoelbreve9 (€3.82 in chips) 
Seat 3: Pabl0o0Poker (€0.34 in chips) 
Seat 4: Lord_Shivaaa (€2 in chips) 
Seat 5: XXILuv (€2.57 in chips) 
Seat 6: pera6521 (€2 in chips) 
pipinoelbreve9: posts small blind €0.01
Pabl0o0Poker: posts big blind €0.02
*** HOLE CARDS ***
Dealt to pipinoelbreve9 [3s 4s]
Lord_Shivaaa: folds 
XXILuv: folds 
pera6521: folds 
FELIPE439: folds 
pipinoelbreve9: folds 
Uncalled bet (€0.01) returned to Pabl0o0Poker
Pabl0o0Poker collected €0.02 from pot
Pabl0o0Poker: doesn't show hand 
*** SUMMARY ***
Total pot €0.02 | Rake €0 
Seat 1: FELIPE439 (button) folded before Flop (didn't bet)
Seat 2: pipinoelbreve9 (small blind) folded before Flop
Seat 3: Pabl0o0Poker (big blind) collected (€0.02)
Seat 4: Lord_Shivaaa folded before Flop (didn't bet)
Seat 5: XXILuv folded before Flop (didn't bet)
Seat 6: pera6521 folded before Flop (didn't bet)



PokerStars Zoom Hand #257439525608:  Hold'em No Limit (€0.01/€0.02) - 2025/08/22 12:32:14 CET [2025/08/22 6:32:14 ET]
Table 'Arneb' 6-max Seat #1 is the button
Seat 1: JENOFONTE73 (€2.47 in chips) 
Seat 2: pera6521 (€2.44 in chips) 
Seat 3: Fergonin (€1.90 in chips) 
Seat 4: pipinoelbreve9 (€3.77 in chips) 
Seat 5: lobopardo161 (€1.95 in chips) 
Seat 6: XXILuv (€2.52 in chips) 
pera6521: posts small blind €0.01
Fergonin: posts big blind €0.02
*** HOLE CARDS ***
Dealt to pipinoelbreve9 [3d Jh]
pipinoelbreve9: folds 
lobopardo161: raises €0.02 to €0.04
XXILuv: folds 
JENOFONTE73: folds 
pera6521: folds 
Fergonin: folds 
Uncalled bet (€0.02) returned to lobopardo161
lobopardo161 collected €0.05 from pot
lobopardo161: doesn't show hand 
*** SUMMARY ***
Total pot €0.05 | Rake €0 
Seat 1: JENOFONTE73 (button) folded before Flop (didn't bet)
Seat 2: pera6521 (small blind) folded before Flop
Seat 3: Fergonin (big blind) folded before Flop
Seat 4: pipinoelbreve9 folded before Flop (didn't bet)
Seat 5: lobopardo161 collected (€0.05)
Seat 6: XXILuv folded before Flop (didn't bet)



PokerStars Zoom Hand #257439522436:  Hold'em No Limit (€0.01/€0.02) - 2025/08/22 12:31:41 CET [2025/08/22 6:31:41 ET]
Table 'Arneb' 6-max Seat #1 is the button
Seat 1: Decomou (€2.06 in chips) 
Seat 2: aaronroxi (€3.14 in chips) 
Seat 3: kombei63 (€1.16 in chips) 
Seat 4: bega13 (€2.60 in chips) 
Seat 5: pipinoelbreve9 (€3.81 in chips) 
Seat 6: MRG1488ADOLF (€0.98 in chips) 
aaronroxi: posts small blind €0.01
kombei63: posts big blind €0.02
*** HOLE CARDS ***
Dealt to pipinoelbreve9 [9h Qh]
bega13: folds 
pipinoelbreve9: raises €0.02 to €0.04
MRG1488ADOLF: calls €0.04
Decomou: folds 
aaronroxi: raises €0.16 to €0.20
kombei63: folds 
pipinoelbreve9: folds 
MRG1488ADOLF: calls €0.16
*** FLOP *** [4c 6s 3h]
aaronroxi: bets €0.16
MRG1488ADOLF: calls €0.16
*** TURN *** [4c 6s 3h] [Jh]
aaronroxi: bets €0.37
MRG1488ADOLF: folds 
Uncalled bet (€0.37) returned to aaronroxi
aaronroxi collected €0.74 from pot
aaronroxi: doesn't show hand 
*** SUMMARY ***
Total pot €0.78 | Rake €0.04 
Board [4c 6s 3h Jh]
Seat 1: Decomou (button) folded before Flop (didn't bet)
Seat 2: aaronroxi (small blind) collected (€0.74)
Seat 3: kombei63 (big blind) folded before Flop
Seat 4: bega13 folded before Flop (didn't bet)
Seat 5: pipinoelbreve9 folded before Flop
Seat 6: MRG1488ADOLF folded on the Turn



PokerStars Zoom Hand #257439526142:  Hold'em No Limit (€0.01/€0.02) - 2025/08/22 12:32:20 CET [2025/08/22 6:32:20 ET]
Table 'Arneb' 6-max Seat #1 is the button
Seat 1: XXILuv (€2.06 in chips) 
Seat 2: kombei63 (€0.63 in chips) 
Seat 3: pipinoelbreve9 (€3.77 in chips) 
Seat 4: Lord_Shivaaa (€2.16 in chips) 
Seat 5: Vruj0 (€5 in chips) 
Seat 6: JENOFONTE73 (€2.48 in chips) 
kombei63: posts small blind €0.01
pipinoelbreve9: posts big blind €0.02
*** HOLE CARDS ***
Dealt to pipinoelbreve9 [Jh Jd]
Lord_Shivaaa: raises €0.03 to €0.05
Vruj0: folds 
JENOFONTE73: folds 
XXILuv: folds 
kombei63: folds 
pipinoelbreve9: calls €0.03
*** FLOP *** [As Ac 4h]
pipinoelbreve9: checks 
Lord_Shivaaa: checks 
*** TURN *** [As Ac 4h] [2s]
pipinoelbreve9: bets €0.04
Lord_Shivaaa: folds 
Uncalled bet (€0.04) returned to pipinoelbreve9
pipinoelbreve9 collected €0.10 from pot
pipinoelbreve9: doesn't show hand 
*** SUMMARY ***
Total pot €0.11 | Rake €0.01 
Board [As Ac 4h 2s]
Seat 1: XXILuv (button) folded before Flop (didn't bet)
Seat 2: kombei63 (small blind) folded before Flop
Seat 3: pipinoelbreve9 (big blind) collected (€0.10)
Seat 4: Lord_Shivaaa folded on the Turn
Seat 5: Vruj0 folded before Flop (didn't bet)
Seat 6: JENOFONTE73 folded before Flop (didn't bet)



PokerStars Zoom Hand #257439528418:  Hold'em No Limit (€0.01/€0.02) - 2025/08/22 12:32:44 CET [2025/08/22 6:32:44 ET]
Table 'Arneb' 6-max Seat #1 is the button
Seat 1: gomera30 (€2.15 in chips) 
Seat 2: pipinoelbreve9 (€3.82 in chips) 
Seat 3: XXILuv (€2.47 in chips) 
Seat 4: Alejandro9494 (€1.98 in chips) 
Seat 5: JENOFONTE73 (€2.47 in chips) 
Seat 6: albertos18 (€2.92 in chips) 
pipinoelbreve9: posts small blind €0.01
XXILuv: posts big blind €0.02
*** HOLE CARDS ***
Dealt to pipinoelbreve9 [Qh 4h]
Alejandro9494: raises €0.04 to €0.06
JENOFONTE73: folds 
albertos18: folds 
gomera30: folds 
pipinoelbreve9: folds 
XXILuv: folds 
Uncalled bet (€0.04) returned to Alejandro9494
Alejandro9494 collected €0.05 from pot
Alejandro9494: doesn't show hand 
*** SUMMARY ***
Total pot €0.05 | Rake €0 
Seat 1: gomera30 (button) folded before Flop (didn't bet)
Seat 2: pipinoelbreve9 (small blind) folded before Flop
Seat 3: XXILuv (big blind) folded before Flop
Seat 4: Alejandro9494 collected (€0.05)
Seat 5: JENOFONTE73 folded before Flop (didn't bet)
Seat 6: albertos18 folded before Flop (didn't bet)



PokerStars Zoom Hand #257439525260:  Hold'em No Limit (€0.01/€0.02) - 2025/08/22 12:32:11 CET [2025/08/22 6:32:11 ET]
Table 'Arneb' 6-max Seat #1 is the button
Seat 1: pipinoelbreve9 (€3.77 in chips) 
Seat 2: FELIPE439 (€4.01 in chips) 
Seat 3: patryskajaja (€0.56 in chips) 
Seat 4: ReyGuto (€2.38 in chips) 
Seat 5: Martial333 (€2.54 in chips) 
Seat 6: kombei63 (€1.14 in chips) 
FELIPE439: posts small blind €0.01
patryskajaja: posts big blind €0.02
*** HOLE CARDS ***
Dealt to pipinoelbreve9 [3s 5d]
ReyGuto: folds 
Martial333: calls €0.02
kombei63: raises €0.07 to €0.09
pipinoelbreve9: folds 
FELIPE439: folds 
patryskajaja: calls €0.07
Martial333: raises €0.37 to €0.46
kombei63: raises €0.68 to €1.14 and is all-in
patryskajaja: calls €0.47 and is all-in
Martial333: calls €0.68
*** FLOP *** [Qh 9d 5c]
*** TURN *** [Qh 9d 5c] [6d]
*** RIVER *** [Qh 9d 5c 6d] [Js]
*** SHOW DOWN ***
Martial333: shows [Kh Ks] (a pair of Kings)
kombei63: shows [Qs As] (a pair of Queens)
Martial333 collected €1.10 from side pot
patryskajaja: shows [Ad 8d] (high card Ace)
Martial333 collected €1.61 from main pot
*** SUMMARY ***
Total pot €2.85 Main pot €1.61. Side pot €1.10. | Rake €0.14 
Board [Qh 9d 5c 6d Js]
Seat 1: pipinoelbreve9 (button) folded before Flop (didn't bet)
Seat 2: FELIPE439 (small blind) folded before Flop
Seat 3: patryskajaja (big blind) showed [Ad 8d] and lost with high card Ace
Seat 4: ReyGuto folded before Flop (didn't bet)
Seat 5: Martial333 showed [Kh Ks] and won (€2.71) with a pair of Kings
Seat 6: kombei63 showed [Qs As] and lost with a pair of Queens



PokerStars Zoom Hand #257439529571:  Hold'em No Limit (€0.01/€0.02) - 2025/08/22 12:32:56 CET [2025/08/22 6:32:56 ET]
Table 'Arneb' 6-max Seat #1 is the button
Seat 1: skorpia1988 (€2 in chips) 
Seat 2: FELIPE439 (€2.58 in chips) 
Seat 3: Carlosalvaro42 (€1.82 in chips) 
Seat 4: StrangeNoumena (€2.01 in chips) 
Seat 5: bega13 (€2.57 in chips) 
Seat 6: pipinoelbreve9 (€3.81 in chips) 
FELIPE439: posts small blind €0.01
Carlosalvaro42: posts big blind €0.02
*** HOLE CARDS ***
Dealt to pipinoelbreve9 [9d 9s]
StrangeNoumena: folds 
bega13: folds 
pipinoelbreve9: raises €0.04 to €0.06
skorpia1988: folds 
FELIPE439: folds 
Carlosalvaro42: calls €0.04
*** FLOP *** [6h 2h 4s]
Carlosalvaro42: checks 
pipinoelbreve9: bets €0.06
Carlosalvaro42: calls €0.06
*** TURN *** [6h 2h 4s] [8s]
Carlosalvaro42: checks 
pipinoelbreve9: bets €0.18
Carlosalvaro42: calls €0.18
*** RIVER *** [6h 2h 4s 8s] [Qd]
Carlosalvaro42: checks 
pipinoelbreve9: bets €0.26
Carlosalvaro42: folds 
Uncalled bet (€0.26) returned to pipinoelbreve9
pipinoelbreve9 collected €0.58 from pot
pipinoelbreve9: doesn't show hand 
*** SUMMARY ***
Total pot €0.61 | Rake €0.03 
Board [6h 2h 4s 8s Qd]
Seat 1: skorpia1988 (button) folded before Flop (didn't bet)
Seat 2: FELIPE439 (small blind) folded before Flop
Seat 3: Carlosalvaro42 (big blind) folded on the River
Seat 4: StrangeNoumena folded before Flop (didn't bet)
Seat 5: bega13 folded before Flop (didn't bet)
Seat 6: pipinoelbreve9 collected (€0.58)



PokerStars Zoom Hand #257439534594:  Hold'em No Limit (€0.01/€0.02) - 2025/08/22 12:33:47 CET [2025/08/22 6:33:47 ET]
Table 'Arneb' 6-max Seat #1 is the button
Seat 1: pipinoelbreve9 (€4.09 in chips) 
Seat 2: catboy_cutie (€2.27 in chips) 
Seat 3: burgoa89 (€2 in chips) 
Seat 4: bega13 (€2.55 in chips) 
Seat 5: Lord_Shivaaa (€2 in chips) 
Seat 6: Panditis (€2.05 in chips) 
catboy_cutie: posts small blind €0.01
burgoa89: posts big blind €0.02
*** HOLE CARDS ***
Dealt to pipinoelbreve9 [Th 8c]
bega13: folds 
Lord_Shivaaa: folds 
Panditis: folds 
pipinoelbreve9: folds 
catboy_cutie: folds 
Uncalled bet (€0.01) returned to burgoa89
burgoa89 collected €0.02 from pot
burgoa89: doesn't show hand 
*** SUMMARY ***
Total pot €0.02 | Rake €0 
Seat 1: pipinoelbreve9 (button) folded before Flop (didn't bet)
Seat 2: catboy_cutie (small blind) folded before Flop
Seat 3: burgoa89 (big blind) collected (€0.02)
Seat 4: bega13 folded before Flop (didn't bet)
Seat 5: Lord_Shivaaa folded before Flop (didn't bet)
Seat 6: Panditis folded before Flop (didn't bet)



PokerStars Zoom Hand #257439535018:  Hold'em No Limit (€0.01/€0.02) - 2025/08/22 12:33:51 CET [2025/08/22 6:33:51 ET]
Table 'Arneb' 6-max Seat #1 is the button
Seat 1: Panditis (€2.05 in chips) 
Seat 2: nofuture69 (€2.01 in chips) 
Seat 3: pipinoelbreve9 (€4.09 in chips) 
Seat 4: kombei63 (€0.56 in chips) 
Seat 5: FELIPE439 (€2.57 in chips) 
Seat 6: catboy_cutie (€2.26 in chips) 
nofuture69: posts small blind €0.01
pipinoelbreve9: posts big blind €0.02
*** HOLE CARDS ***
Dealt to pipinoelbreve9 [Qh 4d]
kombei63: raises €0.04 to €0.06
FELIPE439: folds 
catboy_cutie: folds 
Panditis: folds 
nofuture69: folds 
pipinoelbreve9: folds 
Uncalled bet (€0.04) returned to kombei63
kombei63 collected €0.05 from pot
kombei63: doesn't show hand 
*** SUMMARY ***
Total pot €0.05 | Rake €0 
Seat 1: Panditis (button) folded before Flop (didn't bet)
Seat 2: nofuture69 (small blind) folded before Flop
Seat 3: pipinoelbreve9 (big blind) folded before Flop
Seat 4: kombei63 collected (€0.05)
Seat 5: FELIPE439 folded before Flop (didn't bet)
Seat 6: catboy_cutie folded before Flop (didn't bet)



PokerStars Zoom Hand #257439535872:  Hold'em No Limit (€0.01/€0.02) - 2025/08/22 12:34:00 CET [2025/08/22 6:34:00 ET]
Table 'Arneb' 6-max Seat #1 is the button
Seat 1: burgoa89 (€2.01 in chips) 
Seat 2: gomera30 (€2.92 in chips) 
Seat 3: Lord_Shivaaa (€3.85 in chips) 
Seat 4: skorpia1988 (€2.52 in chips) 
Seat 5: patryskajaja (€0.98 in chips) 
Seat 6: pipinoelbreve9 (€4.07 in chips) 
gomera30: posts small blind €0.01
Lord_Shivaaa: posts big blind €0.02
*** HOLE CARDS ***
Dealt to pipinoelbreve9 [3c 2h]
skorpia1988: folds 
patryskajaja: folds 
pipinoelbreve9: folds 
burgoa89: folds 
gomera30: raises €0.03 to €0.05
Lord_Shivaaa: folds 
Uncalled bet (€0.03) returned to gomera30
gomera30 collected €0.04 from pot
gomera30: doesn't show hand 
*** SUMMARY ***
Total pot €0.04 | Rake €0 
Seat 1: burgoa89 (button) folded before Flop (didn't bet)
Seat 2: gomera30 (small blind) collected (€0.04)
Seat 3: Lord_Shivaaa (big blind) folded before Flop
Seat 4: skorpia1988 folded before Flop (didn't bet)
Seat 5: patryskajaja folded before Flop (didn't bet)
Seat 6: pipinoelbreve9 folded before Flop (didn't bet)



PokerStars Zoom Hand #257439533747:  Hold'em No Limit (€0.01/€0.02) - 2025/08/22 12:33:39 CET [2025/08/22 6:33:39 ET]
Table 'Arneb' 6-max Seat #1 is the button
Seat 1: Abrelatas787 (€3.25 in chips) 
Seat 2: FELIPE439 (€2.58 in chips) 
Seat 3: XXILuv (€2.71 in chips) 
Seat 4: Pabl0o0Poker (€4.67 in chips) 
Seat 5: pipinoelbreve9 (€4.09 in chips) 
Seat 6: Lord_Shivaaa (€2 in chips) 
FELIPE439: posts small blind €0.01
XXILuv: posts big blind €0.02
*** HOLE CARDS ***
Dealt to pipinoelbreve9 [4s 6s]
Pabl0o0Poker: folds 
pipinoelbreve9: folds 
Lord_Shivaaa: folds 
Abrelatas787: raises €0.04 to €0.06
FELIPE439: folds 
XXILuv: calls €0.04
*** FLOP *** [6d 3c 3h]
XXILuv: checks 
Abrelatas787: checks 
*** TURN *** [6d 3c 3h] [5c]
XXILuv: checks 
Abrelatas787: bets €0.06
XXILuv: calls €0.06
*** RIVER *** [6d 3c 3h 5c] [As]
XXILuv: checks 
Abrelatas787: checks 
*** SHOW DOWN ***
XXILuv: shows [2h 2d] (two pair, Threes and Deuces)
Abrelatas787: mucks hand 
XXILuv collected €0.24 from pot
*** SUMMARY ***
Total pot €0.25 | Rake €0.01 
Board [6d 3c 3h 5c As]
Seat 1: Abrelatas787 (button) mucked [Qs Jh]
Seat 2: FELIPE439 (small blind) folded before Flop
Seat 3: XXILuv (big blind) showed [2h 2d] and won (€0.24) with two pair, Threes and Deuces
Seat 4: Pabl0o0Poker folded before Flop (didn't bet)
Seat 5: pipinoelbreve9 folded before Flop (didn't bet)
Seat 6: Lord_Shivaaa folded before Flop (didn't bet)



PokerStars Zoom Hand #257439536777:  Hold'em No Limit (€0.01/€0.02) - 2025/08/22 12:34:09 CET [2025/08/22 6:34:09 ET]
Table 'Arneb' 6-max Seat #1 is the button
Seat 1: kombei63 (€0.59 in chips) 
Seat 2: pipinoelbreve9 (€4.07 in chips) 
Seat 3: 33baba33 (€2.80 in chips) 
Seat 4: Martial333 (€4.23 in chips) 
Seat 5: Alejandro9494 (€2.24 in chips) 
Seat 6: burgoa89 (€2 in chips) 
pipinoelbreve9: posts small blind €0.01
33baba33: posts big blind €0.02
*** HOLE CARDS ***
Dealt to pipinoelbreve9 [6s Qd]
Martial333: folds 
Alejandro9494: raises €0.04 to €0.06
burgoa89: folds 
kombei63: calls €0.06
pipinoelbreve9: folds 
33baba33: folds 
*** FLOP *** [Jd 8h Qc]
Alejandro9494: bets €0.09
kombei63: folds 
Uncalled bet (€0.09) returned to Alejandro9494
Alejandro9494 collected €0.14 from pot
Alejandro9494: doesn't show hand 
*** SUMMARY ***
Total pot €0.15 | Rake €0.01 
Board [Jd 8h Qc]
Seat 1: kombei63 (button) folded on the Flop
Seat 2: pipinoelbreve9 (small blind) folded before Flop
Seat 3: 33baba33 (big blind) folded before Flop
Seat 4: Martial333 folded before Flop (didn't bet)
Seat 5: Alejandro9494 collected (€0.14)
Seat 6: burgoa89 folded before Flop (didn't bet)



PokerStars Zoom Hand #257439538179:  Hold'em No Limit (€0.01/€0.02) - 2025/08/22 12:34:23 CET [2025/08/22 6:34:23 ET]
Table 'Arneb' 6-max Seat #1 is the button
Seat 1: linto2800 (€1.75 in chips) 
Seat 2: XXILuv (€2 in chips) 
Seat 3: PolCuenca (€1.52 in chips) 
Seat 4: gomera30 (€2.94 in chips) 
Seat 5: burgoa89 (€2 in chips) 
Seat 6: pipinoelbreve9 (€4.06 in chips) 
XXILuv: posts small blind €0.01
PolCuenca: posts big blind €0.02
*** HOLE CARDS ***
Dealt to pipinoelbreve9 [Jh Th]
gomera30: folds 
burgoa89: folds 
pipinoelbreve9: raises €0.04 to €0.06
linto2800: folds 
XXILuv: folds 
PolCuenca: folds 
Uncalled bet (€0.04) returned to pipinoelbreve9
pipinoelbreve9 collected €0.05 from pot
pipinoelbreve9: doesn't show hand 
*** SUMMARY ***
Total pot €0.05 | Rake €0 
Seat 1: linto2800 (button) folded before Flop (didn't bet)
Seat 2: XXILuv (small blind) folded before Flop
Seat 3: PolCuenca (big blind) folded before Flop
Seat 4: gomera30 folded before Flop (didn't bet)
Seat 5: burgoa89 folded before Flop (didn't bet)
Seat 6: pipinoelbreve9 collected (€0.05)



PokerStars Zoom Hand #257439537823:  Hold'em No Limit (€0.01/€0.02) - 2025/08/22 12:34:19 CET [2025/08/22 6:34:19 ET]
Table 'Arneb' 6-max Seat #1 is the button
Seat 1: pipinoelbreve9 (€4.06 in chips) 
Seat 2: JENOFONTE73 (€2.58 in chips) 
Seat 3: Vruj0 (€4.88 in chips) 
Seat 4: PolCuenca (€1.52 in chips) 
Seat 5: jeannono24 (€2.53 in chips) 
Seat 6: Decomou (€2.20 in chips) 
JENOFONTE73: posts small blind €0.01
Vruj0: posts big blind €0.02
*** HOLE CARDS ***
Dealt to pipinoelbreve9 [9h 5d]
PolCuenca: folds 
jeannono24: folds 
Decomou: raises €0.03 to €0.05
pipinoelbreve9: folds 
JENOFONTE73: calls €0.04
Vruj0: folds 
*** FLOP *** [7s 2h 9s]
JENOFONTE73: checks 
Decomou: checks 
*** TURN *** [7s 2h 9s] [7h]
JENOFONTE73: checks 
Decomou: checks 
*** RIVER *** [7s 2h 9s 7h] [4h]
JENOFONTE73: checks 
Decomou: checks 
*** SHOW DOWN ***
JENOFONTE73: shows [Ts Kh] (a pair of Sevens)
Decomou: shows [Ah Qd] (a pair of Sevens - Ace kicker)
Decomou collected €0.11 from pot
*** SUMMARY ***
Total pot €0.12 | Rake €0.01 
Board [7s 2h 9s 7h 4h]
Seat 1: pipinoelbreve9 (button) folded before Flop (didn't bet)
Seat 2: JENOFONTE73 (small blind) showed [Ts Kh] and lost with a pair of Sevens
Seat 3: Vruj0 (big blind) folded before Flop
Seat 4: PolCuenca folded before Flop (didn't bet)
Seat 5: jeannono24 folded before Flop (didn't bet)
Seat 6: Decomou showed [Ah Qd] and won (€0.11) with a pair of Sevens



PokerStars Zoom Hand #257439537437:  Hold'em No Limit (€0.01/€0.02) - 2025/08/22 12:34:15 CET [2025/08/22 6:34:15 ET]
Table 'Arneb' 6-max Seat #1 is the button
Seat 1: jeannono24 (€2.35 in chips) 
Seat 2: hhgg8 (€2.08 in chips) 
Seat 3: Mixdoll (€1.97 in chips) 
Seat 4: pipinoelbreve9 (€4.06 in chips) 
Seat 5: nofuture69 (€2.18 in chips) 
Seat 6: Martial333 (€4.23 in chips) 
hhgg8: posts small blind €0.01
Mixdoll: posts big blind €0.02
*** HOLE CARDS ***
Dealt to pipinoelbreve9 [9s 2d]
pipinoelbreve9: folds 
nofuture69: folds 
Martial333: calls €0.02
jeannono24: raises €0.04 to €0.06
hhgg8: folds 
Mixdoll: folds 
Martial333: calls €0.04
*** FLOP *** [2c Ad 9c]
Martial333: checks 
jeannono24: bets €0.07
Martial333: folds 
Uncalled bet (€0.07) returned to jeannono24
jeannono24 collected €0.14 from pot
jeannono24: doesn't show hand 
*** SUMMARY ***
Total pot €0.15 | Rake €0.01 
Board [2c Ad 9c]
Seat 1: jeannono24 (button) collected (€0.14)
Seat 2: hhgg8 (small blind) folded before Flop
Seat 3: Mixdoll (big blind) folded before Flop
Seat 4: pipinoelbreve9 folded before Flop (didn't bet)
Seat 5: nofuture69 folded before Flop (didn't bet)
Seat 6: Martial333 folded on the Flop



PokerStars Zoom Hand #257439540111:  Hold'em No Limit (€0.01/€0.02) - 2025/08/22 12:34:42 CET [2025/08/22 6:34:42 ET]
Table 'Arneb' 6-max Seat #1 is the button
Seat 1: Comino79 (€1.97 in chips) 
Seat 2: nofuture69 (€2.16 in chips) 
Seat 3: pipinoelbreve9 (€4.09 in chips) 
Seat 4: Fergonin (€1.79 in chips) 
Seat 5: XXILuv (€2.83 in chips) 
Seat 6: boogychat (€0.81 in chips) 
nofuture69: posts small blind €0.01
pipinoelbreve9: posts big blind €0.02
*** HOLE CARDS ***
Dealt to pipinoelbreve9 [4h 5c]
Fergonin: folds 
XXILuv: folds 
boogychat: folds 
Comino79: folds 
nofuture69: raises €0.04 to €0.06
pipinoelbreve9: folds 
Uncalled bet (€0.04) returned to nofuture69
nofuture69 collected €0.04 from pot
nofuture69: doesn't show hand 
*** SUMMARY ***
Total pot €0.04 | Rake €0 
Seat 1: Comino79 (button) folded before Flop (didn't bet)
Seat 2: nofuture69 (small blind) collected (€0.04)
Seat 3: pipinoelbreve9 (big blind) folded before Flop
Seat 4: Fergonin folded before Flop (didn't bet)
Seat 5: XXILuv folded before Flop (didn't bet)
Seat 6: boogychat folded before Flop (didn't bet)



PokerStars Zoom Hand #257439539733:  Hold'em No Limit (€0.01/€0.02) - 2025/08/22 12:34:38 CET [2025/08/22 6:34:38 ET]
Table 'Arneb' 6-max Seat #1 is the button
Seat 1: Pabl0o0Poker (€0.52 in chips) 
Seat 2: Vruj0 (€4.86 in chips) 
Seat 3: burgoa89 (€2 in chips) 
Seat 4: pipinoelbreve9 (€4.09 in chips) 
Seat 5: Lord_Shivaaa (€2 in chips) 
Seat 6: albertos18 (€3.05 in chips) 
Vruj0: posts small blind €0.01
burgoa89: posts big blind €0.02
*** HOLE CARDS ***
Dealt to pipinoelbreve9 [9d 4d]
pipinoelbreve9: folds 
Lord_Shivaaa: folds 
albertos18: folds 
Pabl0o0Poker: raises €0.03 to €0.05
Vruj0: folds 
burgoa89: folds 
Uncalled bet (€0.03) returned to Pabl0o0Poker
Pabl0o0Poker collected €0.05 from pot
Pabl0o0Poker: doesn't show hand 
*** SUMMARY ***
Total pot €0.05 | Rake €0 
Seat 1: Pabl0o0Poker (button) collected (€0.05)
Seat 2: Vruj0 (small blind) folded before Flop
Seat 3: burgoa89 (big blind) folded before Flop
Seat 4: pipinoelbreve9 folded before Flop (didn't bet)
Seat 5: Lord_Shivaaa folded before Flop (didn't bet)
Seat 6: albertos18 folded before Flop (didn't bet)



PokerStars Zoom Hand #257439536520:  Hold'em No Limit (€0.01/€0.02) - 2025/08/22 12:34:06 CET [2025/08/22 6:34:06 ET]
Table 'Arneb' 6-max Seat #1 is the button
Seat 1: nofuture69 (€2 in chips) 
Seat 2: linto2800 (€1.76 in chips) 
Seat 3: XXILuv (€2.02 in chips) 
Seat 4: hhgg8 (€2.01 in chips) 
Seat 5: pipinoelbreve9 (€4.07 in chips) 
Seat 6: FELIPE439 (€3.94 in chips) 
linto2800: posts small blind €0.01
XXILuv: posts big blind €0.02
*** HOLE CARDS ***
Dealt to pipinoelbreve9 [2d 5h]
hhgg8: raises €0.03 to €0.05
pipinoelbreve9: folds 
FELIPE439: calls €0.05
nofuture69: calls €0.05
linto2800: folds 
XXILuv: folds 
*** FLOP *** [4s 9s 5s]
hhgg8: checks 
FELIPE439: checks 
nofuture69: checks 
*** TURN *** [4s 9s 5s] [5d]
hhgg8: checks 
FELIPE439: checks 
nofuture69: bets €0.13
hhgg8: folds 
FELIPE439: folds 
Uncalled bet (€0.13) returned to nofuture69
nofuture69 collected €0.17 from pot
nofuture69: doesn't show hand 
*** SUMMARY ***
Total pot €0.18 | Rake €0.01 
Board [4s 9s 5s 5d]
Seat 1: nofuture69 (button) collected (€0.17)
Seat 2: linto2800 (small blind) folded before Flop
Seat 3: XXILuv (big blind) folded before Flop
Seat 4: hhgg8 folded on the Turn
Seat 5: pipinoelbreve9 folded before Flop (didn't bet)
Seat 6: FELIPE439 folded on the Turn



PokerStars Zoom Hand #257439541770:  Hold'em No Limit (€0.01/€0.02) - 2025/08/22 12:34:58 CET [2025/08/22 6:34:58 ET]
Table 'Arneb' 6-max Seat #1 is the button
Seat 1: Vruj0 (€4.85 in chips) 
Seat 2: pipinoelbreve9 (€4.07 in chips) 
Seat 3: gomera30 (€3.36 in chips) 
Seat 4: JENOFONTE73 (€2.53 in chips) 
Seat 5: Panditis (€1.99 in chips) 
Seat 6: Lord_Shivaaa (€3.81 in chips) 
pipinoelbreve9: posts small blind €0.01
gomera30: posts big blind €0.02
*** HOLE CARDS ***
Dealt to pipinoelbreve9 [5c 9c]
JENOFONTE73: folds 
Panditis: folds 
Lord_Shivaaa: folds 
Vruj0: raises €0.04 to €0.06
pipinoelbreve9: folds 
gomera30: folds 
Uncalled bet (€0.04) returned to Vruj0
Vruj0 collected €0.05 from pot
Vruj0: doesn't show hand 
*** SUMMARY ***
Total pot €0.05 | Rake €0 
Seat 1: Vruj0 (button) collected (€0.05)
Seat 2: pipinoelbreve9 (small blind) folded before Flop
Seat 3: gomera30 (big blind) folded before Flop
Seat 4: JENOFONTE73 folded before Flop (didn't bet)
Seat 5: Panditis folded before Flop (didn't bet)
Seat 6: Lord_Shivaaa folded before Flop (didn't bet)



PokerStars Zoom Hand #257439542237:  Hold'em No Limit (€0.01/€0.02) - 2025/08/22 12:35:03 CET [2025/08/22 6:35:03 ET]
Table 'Arneb' 6-max Seat #1 is the button
Seat 1: kombei63 (€0.53 in chips) 
Seat 2: burgoa89 (€1.95 in chips) 
Seat 3: jeannono24 (€2.47 in chips) 
Seat 4: XXILuv (€2.59 in chips) 
Seat 5: pipinoelbreve9 (€4.06 in chips) 
Seat 6: Pabl0o0Poker (€0.55 in chips) 
burgoa89: posts small blind €0.01
jeannono24: posts big blind €0.02
*** HOLE CARDS ***
Dealt to pipinoelbreve9 [4c 7h]
XXILuv: folds 
pipinoelbreve9: folds 
Pabl0o0Poker: raises €0.03 to €0.05
kombei63: folds 
burgoa89: folds 
jeannono24: folds 
Uncalled bet (€0.03) returned to Pabl0o0Poker
Pabl0o0Poker collected €0.05 from pot
Pabl0o0Poker: doesn't show hand 
*** SUMMARY ***
Total pot €0.05 | Rake €0 
Seat 1: kombei63 (button) folded before Flop (didn't bet)
Seat 2: burgoa89 (small blind) folded before Flop
Seat 3: jeannono24 (big blind) folded before Flop
Seat 4: XXILuv folded before Flop (didn't bet)
Seat 5: pipinoelbreve9 folded before Flop (didn't bet)
Seat 6: Pabl0o0Poker collected (€0.05)



PokerStars Zoom Hand #257439544401:  Hold'em No Limit (€0.01/€0.02) - 2025/08/22 12:35:24 CET [2025/08/22 6:35:24 ET]
Table 'Arneb' 6-max Seat #1 is the button
Seat 1: Fergonin (€1.76 in chips) 
Seat 2: XXILuv (€2 in chips) 
Seat 3: pipinoelbreve9 (€4.06 in chips) 
Seat 4: nukilla888 (€0.62 in chips) 
Seat 5: jeannono24 (€2.30 in chips) 
Seat 6: pera6521 (€1.98 in chips) 
XXILuv: posts small blind €0.01
pipinoelbreve9: posts big blind €0.02
*** HOLE CARDS ***
Dealt to pipinoelbreve9 [3d 6s]
nukilla888: folds 
jeannono24: folds 
pera6521: folds 
Fergonin: folds 
XXILuv: folds 
Uncalled bet (€0.01) returned to pipinoelbreve9
pipinoelbreve9 collected €0.02 from pot
pipinoelbreve9: doesn't show hand 
*** SUMMARY ***
Total pot €0.02 | Rake €0 
Seat 1: Fergonin (button) folded before Flop (didn't bet)
Seat 2: XXILuv (small blind) folded before Flop
Seat 3: pipinoelbreve9 (big blind) collected (€0.02)
Seat 4: nukilla888 folded before Flop (didn't bet)
Seat 5: jeannono24 folded before Flop (didn't bet)
Seat 6: pera6521 folded before Flop (didn't bet)



PokerStars Zoom Hand #257439544038:  Hold'em No Limit (€0.01/€0.02) - 2025/08/22 12:35:21 CET [2025/08/22 6:35:21 ET]
Table 'Arneb' 6-max Seat #1 is the button
Seat 1: nofuture69 (€2 in chips) 
Seat 2: Panditis (€2 in chips) 
Seat 3: Noobunaga (€2 in chips) 
Seat 4: pipinoelbreve9 (€4.06 in chips) 
Seat 5: Encina 99 (€2.96 in chips) 
Seat 6: gomera30 (€2.99 in chips) 
Panditis: posts small blind €0.01
Noobunaga: posts big blind €0.02
*** HOLE CARDS ***
Dealt to pipinoelbreve9 [Qd 9c]
pipinoelbreve9: folds 
Encina 99: folds 
gomera30: folds 
nofuture69: folds 
Panditis: folds 
Uncalled bet (€0.01) returned to Noobunaga
Noobunaga collected €0.02 from pot
Noobunaga: doesn't show hand 
*** SUMMARY ***
Total pot €0.02 | Rake €0 
Seat 1: nofuture69 (button) folded before Flop (didn't bet)
Seat 2: Panditis (small blind) folded before Flop
Seat 3: Noobunaga (big blind) collected (€0.02)
Seat 4: pipinoelbreve9 folded before Flop (didn't bet)
Seat 5: Encina 99 folded before Flop (didn't bet)
Seat 6: gomera30 folded before Flop (didn't bet)



PokerStars Zoom Hand #257439543242:  Hold'em No Limit (€0.01/€0.02) - 2025/08/22 12:35:13 CET [2025/08/22 6:35:13 ET]
Table 'Arneb' 6-max Seat #1 is the button
Seat 1: pipinoelbreve9 (€4.06 in chips) 
Seat 2: nofuture69 (€2 in chips) 
Seat 3: FELIPE439 (€2.78 in chips) 
Seat 4: gomera30 (€2.99 in chips) 
Seat 5: Vruj0 (€4.18 in chips) 
Seat 6: burgoa89 (€1.97 in chips) 
nofuture69: posts small blind €0.01
FELIPE439: posts big blind €0.02
*** HOLE CARDS ***
Dealt to pipinoelbreve9 [6c 9d]
gomera30: folds 
Vruj0: raises €0.04 to €0.06
burgoa89: folds 
pipinoelbreve9: folds 
nofuture69: folds 
FELIPE439: folds 
Uncalled bet (€0.04) returned to Vruj0
Vruj0 collected €0.05 from pot
Vruj0: doesn't show hand 
*** SUMMARY ***
Total pot €0.05 | Rake €0 
Seat 1: pipinoelbreve9 (button) folded before Flop (didn't bet)
Seat 2: nofuture69 (small blind) folded before Flop
Seat 3: FELIPE439 (big blind) folded before Flop
Seat 4: gomera30 folded before Flop (didn't bet)
Seat 5: Vruj0 collected (€0.05)
Seat 6: burgoa89 folded before Flop (didn't bet)



PokerStars Zoom Hand #257439545537:  Hold'em No Limit (€0.01/€0.02) - 2025/08/22 12:35:36 CET [2025/08/22 6:35:36 ET]
Table 'Arneb' 6-max Seat #1 is the button
Seat 1: Comino79 (€1.94 in chips) 
Seat 2: pipinoelbreve9 (€4.07 in chips) 
Seat 3: nukilla888 (€0.61 in chips) 
Seat 4: catboy_cutie (€2.02 in chips) 
Seat 5: hhgg8 (€2 in chips) 
Seat 6: NunoSoares18 (€2.15 in chips) 
pipinoelbreve9: posts small blind €0.01
nukilla888: posts big blind €0.02
*** HOLE CARDS ***
Dealt to pipinoelbreve9 [5s 8d]
catboy_cutie: folds 
hhgg8: folds 
NunoSoares18: raises €0.04 to €0.06
Comino79: folds 
pipinoelbreve9: folds 
nukilla888: folds 
Uncalled bet (€0.04) returned to NunoSoares18
NunoSoares18 collected €0.05 from pot
NunoSoares18: doesn't show hand 
*** SUMMARY ***
Total pot €0.05 | Rake €0 
Seat 1: Comino79 (button) folded before Flop (didn't bet)
Seat 2: pipinoelbreve9 (small blind) folded before Flop
Seat 3: nukilla888 (big blind) folded before Flop
Seat 4: catboy_cutie folded before Flop (didn't bet)
Seat 5: hhgg8 folded before Flop (didn't bet)
Seat 6: NunoSoares18 collected (€0.05)



PokerStars Zoom Hand #257439542578:  Hold'em No Limit (€0.01/€0.02) - 2025/08/22 12:35:06 CET [2025/08/22 6:35:06 ET]
Table 'Arneb' 6-max Seat #1 is the button
Seat 1: nofuture69 (€2.18 in chips) 
Seat 2: cabsudo77 (€2.04 in chips) 
Seat 3: hhgg8 (€2 in chips) 
Seat 4: JENOFONTE73 (€2.13 in chips) 
Seat 5: Noobunaga (€2.30 in chips) 
Seat 6: pipinoelbreve9 (€4.06 in chips) 
cabsudo77: posts small blind €0.01
hhgg8: posts big blind €0.02
*** HOLE CARDS ***
Dealt to pipinoelbreve9 [6c 8c]
JENOFONTE73: raises €0.03 to €0.05
Noobunaga: folds 
pipinoelbreve9: folds 
nofuture69: folds 
cabsudo77: folds 
hhgg8: calls €0.03
*** FLOP *** [7h 5s Jd]
hhgg8: checks 
JENOFONTE73: bets €0.05
hhgg8: calls €0.05
*** TURN *** [7h 5s Jd] [Qs]
hhgg8: checks 
JENOFONTE73: checks 
*** RIVER *** [7h 5s Jd Qs] [4c]
hhgg8: bets €0.09
JENOFONTE73: folds 
Uncalled bet (€0.09) returned to hhgg8
hhgg8 collected €0.20 from pot
hhgg8: doesn't show hand 
*** SUMMARY ***
Total pot €0.21 | Rake €0.01 
Board [7h 5s Jd Qs 4c]
Seat 1: nofuture69 (button) folded before Flop (didn't bet)
Seat 2: cabsudo77 (small blind) folded before Flop
Seat 3: hhgg8 (big blind) collected (€0.20)
Seat 4: JENOFONTE73 folded on the River
Seat 5: Noobunaga folded before Flop (didn't bet)
Seat 6: pipinoelbreve9 folded before Flop (didn't bet)



PokerStars Zoom Hand #257439546032:  Hold'em No Limit (€0.01/€0.02) - 2025/08/22 12:35:41 CET [2025/08/22 6:35:41 ET]
Table 'Arneb' 6-max Seat #1 is the button
Seat 1: PolCuenca (€3.05 in chips) 
Seat 2: kombei63 (€0.54 in chips) 
Seat 3: catboy_cutie (€2.02 in chips) 
Seat 4: pipinoelbreve9 (€4.06 in chips) 
Seat 5: burgoa89 (€2 in chips) 
Seat 6: XXILuv (€2.53 in chips) 
kombei63: posts small blind €0.01
catboy_cutie: posts big blind €0.02
*** HOLE CARDS ***
Dealt to pipinoelbreve9 [7s 7d]
pipinoelbreve9: raises €0.04 to €0.06
burgoa89: folds 
XXILuv: folds 
PolCuenca: folds 
kombei63: folds 
catboy_cutie: raises €0.18 to €0.24
pipinoelbreve9: calls €0.18
*** FLOP *** [3h 5s 3c]
catboy_cutie: bets €0.28
pipinoelbreve9: calls €0.28
*** TURN *** [3h 5s 3c] [As]
catboy_cutie: checks 
pipinoelbreve9: checks 
*** RIVER *** [3h 5s 3c As] [Ks]
catboy_cutie: checks 
pipinoelbreve9: bets €0.02
catboy_cutie: calls €0.02
*** SHOW DOWN ***
pipinoelbreve9: shows [7s 7d] (two pair, Sevens and Threes)
catboy_cutie: shows [2h Ah] (two pair, Aces and Threes)
catboy_cutie collected €1.04 from pot
*** SUMMARY ***
Total pot €1.09 | Rake €0.05 
Board [3h 5s 3c As Ks]
Seat 1: PolCuenca (button) folded before Flop (didn't bet)
Seat 2: kombei63 (small blind) folded before Flop
Seat 3: catboy_cutie (big blind) showed [2h Ah] and won (€1.04) with two pair, Aces and Threes
Seat 4: pipinoelbreve9 showed [7s 7d] and lost with two pair, Sevens and Threes
Seat 5: burgoa89 folded before Flop (didn't bet)
Seat 6: XXILuv folded before Flop (didn't bet)



PokerStars Zoom Hand #257439549412:  Hold'em No Limit (€0.01/€0.02) - 2025/08/22 12:36:14 CET [2025/08/22 6:36:14 ET]
Table 'Arneb' 6-max Seat #1 is the button
Seat 1: Valencinco (€2.11 in chips) 
Seat 2: JENOFONTE73 (€2.33 in chips) 
Seat 3: XXILuv (€2.03 in chips) 
Seat 4: NunoSoares18 (€1.27 in chips) 
Seat 5: hhgg8 (€2 in chips) 
Seat 6: pipinoelbreve9 (€3.52 in chips) 
JENOFONTE73: posts small blind €0.01
XXILuv: posts big blind €0.02
*** HOLE CARDS ***
Dealt to pipinoelbreve9 [8h 6d]
NunoSoares18: folds 
hhgg8: folds 
pipinoelbreve9: folds 
Valencinco: folds 
JENOFONTE73: raises €0.03 to €0.05
XXILuv: folds 
Uncalled bet (€0.03) returned to JENOFONTE73
JENOFONTE73 collected €0.04 from pot
JENOFONTE73: doesn't show hand 
*** SUMMARY ***
Total pot €0.04 | Rake €0 
Seat 1: Valencinco (button) folded before Flop (didn't bet)
Seat 2: JENOFONTE73 (small blind) collected (€0.04)
Seat 3: XXILuv (big blind) folded before Flop
Seat 4: NunoSoares18 folded before Flop (didn't bet)
Seat 5: hhgg8 folded before Flop (didn't bet)
Seat 6: pipinoelbreve9 folded before Flop (didn't bet)



PokerStars Zoom Hand #257439549980:  Hold'em No Limit (€0.01/€0.02) - 2025/08/22 12:36:19 CET [2025/08/22 6:36:19 ET]
Table 'Arneb' 6-max Seat #1 is the button
Seat 1: pipinoelbreve9 (€3.52 in chips) 
Seat 2: Vruj0 (€4.22 in chips) 
Seat 3: Lord_Shivaaa (€3.81 in chips) 
Seat 4: Panditis (€1.22 in chips) 
Seat 5: gomera30 (€2.41 in chips) 
Seat 6: bega13 (€2.08 in chips) 
Vruj0: posts small blind €0.01
Lord_Shivaaa: posts big blind €0.02
*** HOLE CARDS ***
Dealt to pipinoelbreve9 [8s 3c]
Panditis: folds 
gomera30: folds 
bega13: folds 
pipinoelbreve9: folds 
Vruj0: raises €0.04 to €0.06
Lord_Shivaaa: calls €0.04
*** FLOP *** [4d 3s Ac]
Vruj0: bets €0.04
Lord_Shivaaa: calls €0.04
*** TURN *** [4d 3s Ac] [8c]
Vruj0: bets €0.10
Lord_Shivaaa: calls €0.10
*** RIVER *** [4d 3s Ac 8c] [2d]
Vruj0: checks 
Lord_Shivaaa: bets €0.42
Vruj0: calls €0.42
*** SHOW DOWN ***
Lord_Shivaaa: shows [5d 7h] (a straight, Ace to Five)
Vruj0: mucks hand 
Lord_Shivaaa collected €1.18 from pot
*** SUMMARY ***
Total pot €1.24 | Rake €0.06 
Board [4d 3s Ac 8c 2d]
Seat 1: pipinoelbreve9 (button) folded before Flop (didn't bet)
Seat 2: Vruj0 (small blind) mucked [4h 6h]
Seat 3: Lord_Shivaaa (big blind) showed [5d 7h] and won (€1.18) with a straight, Ace to Five
Seat 4: Panditis folded before Flop (didn't bet)
Seat 5: gomera30 folded before Flop (didn't bet)
Seat 6: bega13 folded before Flop (didn't bet)



PokerStars Zoom Hand #257439550335:  Hold'em No Limit (€0.01/€0.02) - 2025/08/22 12:36:23 CET [2025/08/22 6:36:23 ET]
Table 'Arneb' 6-max Seat #1 is the button
Seat 1: nofuture69 (€2.16 in chips) 
Seat 2: Noobunaga (€2.07 in chips) 
Seat 3: skorpia1988 (€2.43 in chips) 
Seat 4: Fergonin (€1.76 in chips) 
Seat 5: pipinoelbreve9 (€3.52 in chips) 
Seat 6: Panditis (€1.22 in chips) 
Noobunaga: posts small blind €0.01
skorpia1988: posts big blind €0.02
*** HOLE CARDS ***
Dealt to pipinoelbreve9 [3s 3c]
Fergonin: folds 
pipinoelbreve9: raises €0.02 to €0.04
Panditis: folds 
nofuture69: folds 
Noobunaga: calls €0.03
skorpia1988: folds 
*** FLOP *** [7s Tc Qh]
Noobunaga: checks 
pipinoelbreve9: checks 
*** TURN *** [7s Tc Qh] [Jc]
Noobunaga: checks 
pipinoelbreve9: checks 
*** RIVER *** [7s Tc Qh Jc] [7d]
Noobunaga: bets €0.08
pipinoelbreve9: folds 
Uncalled bet (€0.08) returned to Noobunaga
Noobunaga collected €0.10 from pot
Noobunaga: doesn't show hand 
*** SUMMARY ***
Total pot €0.10 | Rake €0 
Board [7s Tc Qh Jc 7d]
Seat 1: nofuture69 (button) folded before Flop (didn't bet)
Seat 2: Noobunaga (small blind) collected (€0.10)
Seat 3: skorpia1988 (big blind) folded before Flop
Seat 4: Fergonin folded before Flop (didn't bet)
Seat 5: pipinoelbreve9 folded on the River
Seat 6: Panditis folded before Flop (didn't bet)



PokerStars Zoom Hand #257439555085:  Hold'em No Limit (€0.01/€0.02) - 2025/08/22 12:37:10 CET [2025/08/22 6:37:10 ET]
Table 'Arneb' 6-max Seat #1 is the button
Seat 1: linto2800 (€2.14 in chips) 
Seat 2: hhgg8 (€2.03 in chips) 
Seat 3: pipinoelbreve9 (€3.48 in chips) 
Seat 4: bega13 (€3.63 in chips) 
Seat 5: nofuture69 (€2.12 in chips) 
Seat 6: jeannono24 (€3.07 in chips) 
hhgg8: posts small blind €0.01
pipinoelbreve9: posts big blind €0.02
*** HOLE CARDS ***
Dealt to pipinoelbreve9 [5s 7h]
bega13: folds 
nofuture69: folds 
jeannono24: folds 
linto2800: raises €0.04 to €0.06
hhgg8: folds 
pipinoelbreve9: folds 
Uncalled bet (€0.04) returned to linto2800
linto2800 collected €0.05 from pot
linto2800: doesn't show hand 
*** SUMMARY ***
Total pot €0.05 | Rake €0 
Seat 1: linto2800 (button) collected (€0.05)
Seat 2: hhgg8 (small blind) folded before Flop
Seat 3: pipinoelbreve9 (big blind) folded before Flop
Seat 4: bega13 folded before Flop (didn't bet)
Seat 5: nofuture69 folded before Flop (didn't bet)
Seat 6: jeannono24 folded before Flop (didn't bet)



PokerStars Zoom Hand #257439556020:  Hold'em No Limit (€0.01/€0.02) - 2025/08/22 12:37:20 CET [2025/08/22 6:37:20 ET]
Table 'Arneb' 6-max Seat #1 is the button
Seat 1: FELIPE439 (€2.52 in chips) 
Seat 2: pipinoelbreve9 (€3.46 in chips) 
Seat 3: skorpia1988 (€3.60 in chips) 
Seat 4: linto2800 (€2.17 in chips) 
Seat 5: XXILuv (€2.43 in chips) 
Seat 6: JENOFONTE73 (€1.91 in chips) 
pipinoelbreve9: posts small blind €0.01
skorpia1988: posts big blind €0.02
*** HOLE CARDS ***
Dealt to pipinoelbreve9 [3h Qc]
linto2800: folds 
XXILuv: folds 
JENOFONTE73: folds 
FELIPE439: raises €0.04 to €0.06
pipinoelbreve9: folds 
skorpia1988: folds 
Uncalled bet (€0.04) returned to FELIPE439
FELIPE439 collected €0.05 from pot
FELIPE439: doesn't show hand 
*** SUMMARY ***
Total pot €0.05 | Rake €0 
Seat 1: FELIPE439 (button) collected (€0.05)
Seat 2: pipinoelbreve9 (small blind) folded before Flop
Seat 3: skorpia1988 (big blind) folded before Flop
Seat 4: linto2800 folded before Flop (didn't bet)
Seat 5: XXILuv folded before Flop (didn't bet)
Seat 6: JENOFONTE73 folded before Flop (didn't bet)



PokerStars Zoom Hand #257439556885:  Hold'em No Limit (€0.01/€0.02) - 2025/08/22 12:37:28 CET [2025/08/22 6:37:28 ET]
Table 'Arneb' 6-max Seat #1 is the button
Seat 1: pipinoelbreve9 (€3.45 in chips) 
Seat 2: XXILuv (€2.43 in chips) 
Seat 3: JENOFONTE73 (€1.91 in chips) 
Seat 4: StrangeNoumena (€2.08 in chips) 
Seat 5: jeannono24 (€3.07 in chips) 
Seat 6: linto2800 (€2.17 in chips) 
XXILuv: posts small blind €0.01
JENOFONTE73: posts big blind €0.02
*** HOLE CARDS ***
Dealt to pipinoelbreve9 [3c Tc]
StrangeNoumena: folds 
jeannono24: folds 
linto2800: folds 
pipinoelbreve9: folds 
XXILuv: folds 
Uncalled bet (€0.01) returned to JENOFONTE73
JENOFONTE73 collected €0.02 from pot
JENOFONTE73: doesn't show hand 
*** SUMMARY ***
Total pot €0.02 | Rake €0 
Seat 1: pipinoelbreve9 (button) folded before Flop (didn't bet)
Seat 2: XXILuv (small blind) folded before Flop
Seat 3: JENOFONTE73 (big blind) collected (€0.02)
Seat 4: StrangeNoumena folded before Flop (didn't bet)
Seat 5: jeannono24 folded before Flop (didn't bet)
Seat 6: linto2800 folded before Flop (didn't bet)



PokerStars Zoom Hand #257439556364:  Hold'em No Limit (€0.01/€0.02) - 2025/08/22 12:37:23 CET [2025/08/22 6:37:23 ET]
Table 'Arneb' 6-max Seat #1 is the button
Seat 1: kombei63 (€2.15 in chips) 
Seat 2: nofuture69 (€2 in chips) 
Seat 3: burgoa89 (€1.99 in chips) 
Seat 4: pipinoelbreve9 (€3.45 in chips) 
Seat 5: StrangeNoumena (€2.08 in chips) 
Seat 6: Pabl0o0Poker (€5.01 in chips) 
nofuture69: posts small blind €0.01
burgoa89: posts big blind €0.02
*** HOLE CARDS ***
Dealt to pipinoelbreve9 [3c 9h]
pipinoelbreve9: folds 
StrangeNoumena: folds 
Pabl0o0Poker: folds 
kombei63: folds 
nofuture69: raises €0.04 to €0.06
burgoa89: folds 
Uncalled bet (€0.04) returned to nofuture69
nofuture69 collected €0.04 from pot
nofuture69: doesn't show hand 
*** SUMMARY ***
Total pot €0.04 | Rake €0 
Seat 1: kombei63 (button) folded before Flop (didn't bet)
Seat 2: nofuture69 (small blind) collected (€0.04)
Seat 3: burgoa89 (big blind) folded before Flop
Seat 4: pipinoelbreve9 folded before Flop (didn't bet)
Seat 5: StrangeNoumena folded before Flop (didn't bet)
Seat 6: Pabl0o0Poker folded before Flop (didn't bet)



PokerStars Zoom Hand #257439557789:  Hold'em No Limit (€0.01/€0.02) - 2025/08/22 12:37:37 CET [2025/08/22 6:37:37 ET]
Table 'Arneb' 6-max Seat #1 is the button
Seat 1: PolCuenca (€2.98 in chips) 
Seat 2: allmike78 (€1.93 in chips) 
Seat 3: skorpia1988 (€2.43 in chips) 
Seat 4: hhgg8 (€2.33 in chips) 
Seat 5: kombei63 (€2.15 in chips) 
Seat 6: pipinoelbreve9 (€3.45 in chips) 
allmike78: posts small blind €0.01
skorpia1988: posts big blind €0.02
*** HOLE CARDS ***
Dealt to pipinoelbreve9 [5d 2d]
hhgg8: folds 
kombei63: folds 
pipinoelbreve9: folds 
PolCuenca: raises €0.02 to €0.04
allmike78: raises €0.10 to €0.14
skorpia1988: folds 
PolCuenca: folds 
Uncalled bet (€0.10) returned to allmike78
allmike78 collected €0.10 from pot
allmike78: doesn't show hand 
*** SUMMARY ***
Total pot €0.10 | Rake €0 
Seat 1: PolCuenca (button) folded before Flop
Seat 2: allmike78 (small blind) collected (€0.10)
Seat 3: skorpia1988 (big blind) folded before Flop
Seat 4: hhgg8 folded before Flop (didn't bet)
Seat 5: kombei63 folded before Flop (didn't bet)
Seat 6: pipinoelbreve9 folded before Flop (didn't bet)



PokerStars Zoom Hand #257439558676:  Hold'em No Limit (€0.01/€0.02) - 2025/08/22 12:37:46 CET [2025/08/22 6:37:46 ET]
Table 'Arneb' 6-max Seat #1 is the button
Seat 1: hhgg8 (€2 in chips) 
Seat 2: kombei63 (€2.46 in chips) 
Seat 3: pipinoelbreve9 (€3.45 in chips) 
Seat 4: NunoSoares18 (€1.35 in chips) 
Seat 5: FELIPE439 (€2.68 in chips) 
Seat 6: XXILuv (€2 in chips) 
kombei63: posts small blind €0.01
pipinoelbreve9: posts big blind €0.02
*** HOLE CARDS ***
Dealt to pipinoelbreve9 [8h 6d]
NunoSoares18: folds 
FELIPE439: folds 
XXILuv: folds 
hhgg8: raises €0.03 to €0.05
kombei63: calls €0.04
pipinoelbreve9: folds 
*** FLOP *** [Td Qh Tc]
kombei63: checks 
hhgg8: bets €0.04
kombei63: folds 
Uncalled bet (€0.04) returned to hhgg8
hhgg8 collected €0.11 from pot
hhgg8: doesn't show hand 
*** SUMMARY ***
Total pot €0.12 | Rake €0.01 
Board [Td Qh Tc]
Seat 1: hhgg8 (button) collected (€0.11)
Seat 2: kombei63 (small blind) folded on the Flop
Seat 3: pipinoelbreve9 (big blind) folded before Flop
Seat 4: NunoSoares18 folded before Flop (didn't bet)
Seat 5: FELIPE439 folded before Flop (didn't bet)
Seat 6: XXILuv folded before Flop (didn't bet)



PokerStars Zoom Hand #257439559768:  Hold'em No Limit (€0.01/€0.02) - 2025/08/22 12:37:57 CET [2025/08/22 6:37:57 ET]
Table 'Arneb' 6-max Seat #1 is the button
Seat 1: XXILuv (€2.37 in chips) 
Seat 2: bega13 (€2.44 in chips) 
Seat 3: nofuture69 (€2.02 in chips) 
Seat 4: Lord_Shivaaa (€2 in chips) 
Seat 5: pipinoelbreve9 (€3.43 in chips) 
Seat 6: jeannono24 (€2.22 in chips) 
bega13: posts small blind €0.01
nofuture69: posts big blind €0.02
*** HOLE CARDS ***
Dealt to pipinoelbreve9 [9h 5c]
Lord_Shivaaa: folds 
pipinoelbreve9: folds 
jeannono24: folds 
XXILuv: raises €0.03 to €0.05
bega13: folds 
nofuture69: folds 
Uncalled bet (€0.03) returned to XXILuv
XXILuv collected €0.05 from pot
XXILuv: doesn't show hand 
*** SUMMARY ***
Total pot €0.05 | Rake €0 
Seat 1: XXILuv (button) collected (€0.05)
Seat 2: bega13 (small blind) folded before Flop
Seat 3: nofuture69 (big blind) folded before Flop
Seat 4: Lord_Shivaaa folded before Flop (didn't bet)
Seat 5: pipinoelbreve9 folded before Flop (didn't bet)
Seat 6: jeannono24 folded before Flop (didn't bet)



PokerStars Zoom Hand #257439561058:  Hold'em No Limit (€0.01/€0.02) - 2025/08/22 12:38:09 CET [2025/08/22 6:38:09 ET]
Table 'Arneb' 6-max Seat #1 is the button
Seat 1: catboy_cutie (€2.57 in chips) 
Seat 2: pipinoelbreve9 (€3.43 in chips) 
Seat 3: patryskajaja (€1.21 in chips) 
Seat 4: bega13 (€2.43 in chips) 
Seat 5: Fergonin (€1.64 in chips) 
Seat 6: ReyGuto (€2.12 in chips) 
pipinoelbreve9: posts small blind €0.01
patryskajaja: posts big blind €0.02
*** HOLE CARDS ***
Dealt to pipinoelbreve9 [7s 3h]
bega13: folds 
Fergonin: raises €0.04 to €0.06
ReyGuto: folds 
catboy_cutie: folds 
pipinoelbreve9: folds 
patryskajaja: folds 
Uncalled bet (€0.04) returned to Fergonin
Fergonin collected €0.05 from pot
Fergonin: doesn't show hand 
*** SUMMARY ***
Total pot €0.05 | Rake €0 
Seat 1: catboy_cutie (button) folded before Flop (didn't bet)
Seat 2: pipinoelbreve9 (small blind) folded before Flop
Seat 3: patryskajaja (big blind) folded before Flop
Seat 4: bega13 folded before Flop (didn't bet)
Seat 5: Fergonin collected (€0.05)
Seat 6: ReyGuto folded before Flop (didn't bet)



PokerStars Zoom Hand #257439561398:  Hold'em No Limit (€0.01/€0.02) - 2025/08/22 12:38:13 CET [2025/08/22 6:38:13 ET]
Table 'Arneb' 6-max Seat #1 is the button
Seat 1: pera6521 (€2.05 in chips) 
Seat 2: skorpia1988 (€2.02 in chips) 
Seat 3: burgoa89 (€1.96 in chips) 
Seat 4: Ab5tract10n (€2.54 in chips) 
Seat 5: pipinoelbreve9 (€3.42 in chips) 
Seat 6: cabsudo77 (€2.62 in chips) 
skorpia1988: posts small blind €0.01
burgoa89: posts big blind €0.02
*** HOLE CARDS ***
Dealt to pipinoelbreve9 [Kh Td]
Ab5tract10n: folds 
pipinoelbreve9: raises €0.02 to €0.04
cabsudo77: folds 
pera6521: folds 
skorpia1988: folds 
burgoa89: folds 
Uncalled bet (€0.02) returned to pipinoelbreve9
pipinoelbreve9 collected €0.05 from pot
pipinoelbreve9: doesn't show hand 
*** SUMMARY ***
Total pot €0.05 | Rake €0 
Seat 1: pera6521 (button) folded before Flop (didn't bet)
Seat 2: skorpia1988 (small blind) folded before Flop
Seat 3: burgoa89 (big blind) folded before Flop
Seat 4: Ab5tract10n folded before Flop (didn't bet)
Seat 5: pipinoelbreve9 collected (€0.05)
Seat 6: cabsudo77 folded before Flop (didn't bet)



PokerStars Zoom Hand #257439564468:  Hold'em No Limit (€0.01/€0.02) - 2025/08/22 12:38:43 CET [2025/08/22 6:38:43 ET]
Table 'Arneb' 6-max Seat #1 is the button
Seat 1: gomera30 (€2.90 in chips) 
Seat 2: XXILuv (€2.41 in chips) 
Seat 3: pipinoelbreve9 (€3.44 in chips) 
Seat 4: hhgg8 (€2.08 in chips) 
Seat 5: Panditis (€2.11 in chips) 
Seat 6: Fergonin (€1.67 in chips) 
XXILuv: posts small blind €0.01
pipinoelbreve9: posts big blind €0.02
*** HOLE CARDS ***
Dealt to pipinoelbreve9 [6h 8h]
hhgg8: folds 
Panditis: raises €0.04 to €0.06
Fergonin: folds 
gomera30: folds 
XXILuv: folds 
pipinoelbreve9: folds 
Uncalled bet (€0.04) returned to Panditis
Panditis collected €0.05 from pot
Panditis: doesn't show hand 
*** SUMMARY ***
Total pot €0.05 | Rake €0 
Seat 1: gomera30 (button) folded before Flop (didn't bet)
Seat 2: XXILuv (small blind) folded before Flop
Seat 3: pipinoelbreve9 (big blind) folded before Flop
Seat 4: hhgg8 folded before Flop (didn't bet)
Seat 5: Panditis collected (€0.05)
Seat 6: Fergonin folded before Flop (didn't bet)



PokerStars Zoom Hand #257439563446:  Hold'em No Limit (€0.01/€0.02) - 2025/08/22 12:38:33 CET [2025/08/22 6:38:33 ET]
Table 'Arneb' 6-max Seat #1 is the button
Seat 1: gelotes (€2.23 in chips) 
Seat 2: PolCuenca (€1.30 in chips) 
Seat 3: Hulkesmag215 (€1 in chips) 
Seat 4: pipinoelbreve9 (€3.45 in chips) 
Seat 5: jeannono24 (€2 in chips) 
Seat 6: gomera30 (€2.38 in chips) 
PolCuenca: posts small blind €0.01
Hulkesmag215: posts big blind €0.02
*** HOLE CARDS ***
Dealt to pipinoelbreve9 [8s Jd]
pipinoelbreve9: folds 
jeannono24: folds 
gomera30: folds 
gelotes: calls €0.02
PolCuenca: folds 
Hulkesmag215: checks 
*** FLOP *** [3h Kh 2d]
Hulkesmag215: checks 
gelotes: checks 
*** TURN *** [3h Kh 2d] [9c]
Hulkesmag215: checks 
gelotes: checks 
*** RIVER *** [3h Kh 2d 9c] [2h]
Hulkesmag215: bets €0.02
gelotes: raises €0.09 to €0.11
Hulkesmag215: calls €0.09
*** SHOW DOWN ***
gelotes: shows [Jh Qh] (a flush, King high)
Hulkesmag215: mucks hand 
gelotes collected €0.26 from pot
*** SUMMARY ***
Total pot €0.27 | Rake €0.01 
Board [3h Kh 2d 9c 2h]
Seat 1: gelotes (button) showed [Jh Qh] and won (€0.26) with a flush, King high
Seat 2: PolCuenca (small blind) folded before Flop
Seat 3: Hulkesmag215 (big blind) mucked [8h 6h]
Seat 4: pipinoelbreve9 folded before Flop (didn't bet)
Seat 5: jeannono24 folded before Flop (didn't bet)
Seat 6: gomera30 folded before Flop (didn't bet)



PokerStars Zoom Hand #257439565102:  Hold'em No Limit (€0.01/€0.02) - 2025/08/22 12:38:49 CET [2025/08/22 6:38:49 ET]
Table 'Arneb' 6-max Seat #1 is the button
Seat 1: pipinoelbreve9 (€3.42 in chips) 
Seat 2: Fergonin (€1.67 in chips) 
Seat 3: nofuture69 (€2.23 in chips) 
Seat 4: Lord_Shivaaa (€4.34 in chips) 
Seat 5: jeannono24 (€2.24 in chips) 
Seat 6: Vruj0 (€3.59 in chips) 
Fergonin: posts small blind €0.01
nofuture69: posts big blind €0.02
*** HOLE CARDS ***
Dealt to pipinoelbreve9 [3d Ac]
Lord_Shivaaa: raises €0.03 to €0.05
jeannono24: folds 
Vruj0: folds 
pipinoelbreve9: folds 
Fergonin: folds 
nofuture69: folds 
Uncalled bet (€0.03) returned to Lord_Shivaaa
Lord_Shivaaa collected €0.05 from pot
Lord_Shivaaa: doesn't show hand 
*** SUMMARY ***
Total pot €0.05 | Rake €0 
Seat 1: pipinoelbreve9 (button) folded before Flop (didn't bet)
Seat 2: Fergonin (small blind) folded before Flop
Seat 3: nofuture69 (big blind) folded before Flop
Seat 4: Lord_Shivaaa collected (€0.05)
Seat 5: jeannono24 folded before Flop (didn't bet)
Seat 6: Vruj0 folded before Flop (didn't bet)



PokerStars Zoom Hand #257439562732:  Hold'em No Limit (€0.01/€0.02) - 2025/08/22 12:38:26 CET [2025/08/22 6:38:26 ET]
Table 'Arneb' 6-max Seat #1 is the button
Seat 1: pipinoelbreve9 (€3.45 in chips) 
Seat 2: Panditis (€2.12 in chips) 
Seat 3: sablaca (€1.60 in chips) 
Seat 4: kombei63 (€1.90 in chips) 
Seat 5: bega13 (€2.43 in chips) 
Seat 6: Noobunaga (€2 in chips) 
Panditis: posts small blind €0.01
sablaca: posts big blind €0.02
*** HOLE CARDS ***
Dealt to pipinoelbreve9 [4d Qd]
kombei63: folds 
bega13: folds 
Noobunaga: raises €0.03 to €0.05
pipinoelbreve9: folds 
Panditis: folds 
sablaca: calls €0.03
*** FLOP *** [Kh 6h 5s]
sablaca: checks 
Noobunaga: bets €0.03
sablaca: calls €0.03
*** TURN *** [Kh 6h 5s] [7h]
sablaca: checks 
Noobunaga: bets €0.05
sablaca: raises €0.13 to €0.18
Noobunaga: raises €1.74 to €1.92 and is all-in
sablaca: folds 
Uncalled bet (€1.74) returned to Noobunaga
Noobunaga collected €0.50 from pot
Noobunaga: doesn't show hand 
*** SUMMARY ***
Total pot €0.53 | Rake €0.03 
Board [Kh 6h 5s 7h]
Seat 1: pipinoelbreve9 (button) folded before Flop (didn't bet)
Seat 2: Panditis (small blind) folded before Flop
Seat 3: sablaca (big blind) folded on the Turn
Seat 4: kombei63 folded before Flop (didn't bet)
Seat 5: bega13 folded before Flop (didn't bet)
Seat 6: Noobunaga collected (€0.50)



PokerStars Zoom Hand #257439560240:  Hold'em No Limit (€0.01/€0.02) - 2025/08/22 12:38:01 CET [2025/08/22 6:38:01 ET]
Table 'Arneb' 6-max Seat #1 is the button
Seat 1: 33baba33 (€2.72 in chips) 
Seat 2: Noobunaga (€2 in chips) 
Seat 3: Lord_Shivaaa (€2 in chips) 
Seat 4: Mixdoll (€1.44 in chips) 
Seat 5: 34Sirina (€0.65 in chips) 
Seat 6: pipinoelbreve9 (€3.43 in chips) 
Noobunaga: posts small blind €0.01
Lord_Shivaaa: posts big blind €0.02
*** HOLE CARDS ***
Dealt to pipinoelbreve9 [5s 2s]
Mixdoll: raises €0.05 to €0.07
34Sirina: folds 
pipinoelbreve9: folds 
33baba33: raises €0.17 to €0.24
Noobunaga: folds 
Lord_Shivaaa: folds 
Mixdoll: calls €0.17
*** FLOP *** [6h 7h 8d]
Mixdoll: checks 
33baba33: checks 
*** TURN *** [6h 7h 8d] [6c]
Mixdoll: bets €1.20 and is all-in
33baba33: folds 
Uncalled bet (€1.20) returned to Mixdoll
Mixdoll collected €0.48 from pot
Mixdoll: doesn't show hand 
*** SUMMARY ***
Total pot €0.51 | Rake €0.03 
Board [6h 7h 8d 6c]
Seat 1: 33baba33 (button) folded on the Turn
Seat 2: Noobunaga (small blind) folded before Flop
Seat 3: Lord_Shivaaa (big blind) folded before Flop
Seat 4: Mixdoll collected (€0.48)
Seat 5: 34Sirina folded before Flop (didn't bet)
Seat 6: pipinoelbreve9 folded before Flop (didn't bet)



PokerStars Zoom Hand #257439564074:  Hold'em No Limit (€0.01/€0.02) - 2025/08/22 12:38:39 CET [2025/08/22 6:38:39 ET]
Table 'Arneb' 6-max Seat #1 is the button
Seat 1: Trajine AK (€2 in chips) 
Seat 2: pipinoelbreve9 (€3.45 in chips) 
Seat 3: Grokuyu (€2 in chips) 
Seat 4: hhgg8 (€2.08 in chips) 
Seat 5: lobopardo161 (€2.05 in chips) 
Seat 6: jeannono24 (€2 in chips) 
pipinoelbreve9: posts small blind €0.01
Grokuyu: posts big blind €0.02
*** HOLE CARDS ***
Dealt to pipinoelbreve9 [2s 9s]
hhgg8: folds 
lobopardo161: calls €0.02
jeannono24: folds 
Trajine AK: folds 
pipinoelbreve9: folds 
Grokuyu: checks 
*** FLOP *** [2h 8s 7s]
Grokuyu: checks 
lobopardo161: bets €0.02
Grokuyu: folds 
Uncalled bet (€0.02) returned to lobopardo161
lobopardo161 collected €0.05 from pot
lobopardo161: doesn't show hand 
*** SUMMARY ***
Total pot €0.05 | Rake €0 
Board [2h 8s 7s]
Seat 1: Trajine AK (button) folded before Flop (didn't bet)
Seat 2: pipinoelbreve9 (small blind) folded before Flop
Seat 3: Grokuyu (big blind) folded on the Flop
Seat 4: hhgg8 folded before Flop (didn't bet)
Seat 5: lobopardo161 collected (€0.05)
Seat 6: jeannono24 folded before Flop (didn't bet)



PokerStars Zoom Hand #257439565922:  Hold'em No Limit (€0.01/€0.02) - 2025/08/22 12:38:57 CET [2025/08/22 6:38:57 ET]
Table 'Arneb' 6-max Seat #1 is the button
Seat 1: hhgg8 (€2.06 in chips) 
Seat 2: Panditis (€1.54 in chips) 
Seat 3: Vruj0 (€3.59 in chips) 
Seat 4: bega13 (€2.38 in chips) 
Seat 5: Abrelatas787 (€3.46 in chips) 
Seat 6: pipinoelbreve9 (€3.42 in chips) 
Panditis: posts small blind €0.01
Vruj0: posts big blind €0.02
*** HOLE CARDS ***
Dealt to pipinoelbreve9 [Qh 6d]
bega13: folds 
Abrelatas787: folds 
pipinoelbreve9: folds 
hhgg8: folds 
Panditis: raises €0.04 to €0.06
Vruj0: folds 
Uncalled bet (€0.04) returned to Panditis
Panditis collected €0.04 from pot
Panditis: doesn't show hand 
*** SUMMARY ***
Total pot €0.04 | Rake €0 
Seat 1: hhgg8 (button) folded before Flop (didn't bet)
Seat 2: Panditis (small blind) collected (€0.04)
Seat 3: Vruj0 (big blind) folded before Flop
Seat 4: bega13 folded before Flop (didn't bet)
Seat 5: Abrelatas787 folded before Flop (didn't bet)
Seat 6: pipinoelbreve9 folded before Flop (didn't bet)



PokerStars Zoom Hand #257439567465:  Hold'em No Limit (€0.01/€0.02) - 2025/08/22 12:39:12 CET [2025/08/22 6:39:12 ET]
Table 'Arneb' 6-max Seat #1 is the button
Seat 1: Decomou (€1.77 in chips) 
Seat 2: bega13 (€2.46 in chips) 
Seat 3: XXILuv (€2.40 in chips) 
Seat 4: kombei63 (€2.69 in chips) 
Seat 5: pipinoelbreve9 (€3.40 in chips) 
Seat 6: PolCuenca (€1.50 in chips) 
bega13: posts small blind €0.01
XXILuv: posts big blind €0.02
*** HOLE CARDS ***
Dealt to pipinoelbreve9 [Jc 8d]
kombei63: folds 
pipinoelbreve9: folds 
PolCuenca: folds 
Decomou: folds 
bega13: raises €0.04 to €0.06
XXILuv: folds 
Uncalled bet (€0.04) returned to bega13
bega13 collected €0.04 from pot
bega13: doesn't show hand 
*** SUMMARY ***
Total pot €0.04 | Rake €0 
Seat 1: Decomou (button) folded before Flop (didn't bet)
Seat 2: bega13 (small blind) collected (€0.04)
Seat 3: XXILuv (big blind) folded before Flop
Seat 4: kombei63 folded before Flop (didn't bet)
Seat 5: pipinoelbreve9 folded before Flop (didn't bet)
Seat 6: PolCuenca folded before Flop (didn't bet)



PokerStars Zoom Hand #257439567889:  Hold'em No Limit (€0.01/€0.02) - 2025/08/22 12:39:17 CET [2025/08/22 6:39:17 ET]
Table 'Arneb' 6-max Seat #1 is the button
Seat 1: Noobunaga (€2 in chips) 
Seat 2: pipinoelbreve9 (€3.40 in chips) 
Seat 3: Decomou (€1.77 in chips) 
Seat 4: JENOFONTE73 (€2.19 in chips) 
Seat 5: nofuture69 (€2 in chips) 
Seat 6: Trajine AK (€2 in chips) 
pipinoelbreve9: posts small blind €0.01
Decomou: posts big blind €0.02
*** HOLE CARDS ***
Dealt to pipinoelbreve9 [8d 7c]
JENOFONTE73: raises €0.03 to €0.05
nofuture69: folds 
Trajine AK: folds 
Noobunaga: folds 
pipinoelbreve9: folds 
Decomou: calls €0.03
*** FLOP *** [4h Kh 3c]
Decomou: checks 
JENOFONTE73: bets €0.05
Decomou: folds 
Uncalled bet (€0.05) returned to JENOFONTE73
JENOFONTE73 collected €0.10 from pot
JENOFONTE73: doesn't show hand 
*** SUMMARY ***
Total pot €0.11 | Rake €0.01 
Board [4h Kh 3c]
Seat 1: Noobunaga (button) folded before Flop (didn't bet)
Seat 2: pipinoelbreve9 (small blind) folded before Flop
Seat 3: Decomou (big blind) folded on the Flop
Seat 4: JENOFONTE73 collected (€0.10)
Seat 5: nofuture69 folded before Flop (didn't bet)
Seat 6: Trajine AK folded before Flop (didn't bet)



PokerStars Zoom Hand #257439568215:  Hold'em No Limit (€0.01/€0.02) - 2025/08/22 12:39:20 CET [2025/08/22 6:39:20 ET]
Table 'Arneb' 6-max Seat #1 is the button
Seat 1: kombei63 (€2.05 in chips) 
Seat 2: patryskajaja (€1.20 in chips) 
Seat 3: 34Sirina (€0.48 in chips) 
Seat 4: Fergonin (€1.67 in chips) 
Seat 5: pipinoelbreve9 (€3.39 in chips) 
Seat 6: gomera30 (€3.42 in chips) 
patryskajaja: posts small blind €0.01
34Sirina: posts big blind €0.02
*** HOLE CARDS ***
Dealt to pipinoelbreve9 [Jd Ah]
Fergonin: folds 
pipinoelbreve9: raises €0.04 to €0.06
gomera30: folds 
kombei63: folds 
patryskajaja: calls €0.05
34Sirina: folds 
*** FLOP *** [6d Jh Ac]
patryskajaja: checks 
pipinoelbreve9: bets €0.04
patryskajaja: calls €0.04
*** TURN *** [6d Jh Ac] [8c]
patryskajaja: checks 
pipinoelbreve9: bets €0.15
patryskajaja: calls €0.15
*** RIVER *** [6d Jh Ac 8c] [Jc]
patryskajaja: checks 
pipinoelbreve9: bets €0.55
patryskajaja: folds 
Uncalled bet (€0.55) returned to pipinoelbreve9
pipinoelbreve9 collected €0.49 from pot
pipinoelbreve9: doesn't show hand 
*** SUMMARY ***
Total pot €0.52 | Rake €0.03 
Board [6d Jh Ac 8c Jc]
Seat 1: kombei63 (button) folded before Flop (didn't bet)
Seat 2: patryskajaja (small blind) folded on the River
Seat 3: 34Sirina (big blind) folded before Flop
Seat 4: Fergonin folded before Flop (didn't bet)
Seat 5: pipinoelbreve9 collected (€0.49)
Seat 6: gomera30 folded before Flop (didn't bet)



PokerStars Zoom Hand #257439566829:  Hold'em No Limit (€0.01/€0.02) - 2025/08/22 12:39:06 CET [2025/08/22 6:39:06 ET]
Table 'Arneb' 6-max Seat #1 is the button
Seat 1: hai_itzelika (€1.08 in chips) 
Seat 2: 33baba33 (€2.48 in chips) 
Seat 3: pipinoelbreve9 (€3.42 in chips) 
Seat 4: Valencinco (€2.58 in chips) 
Seat 5: JENOFONTE73 (€2.19 in chips) 
Seat 6: sablaca (€1.34 in chips) 
33baba33: posts small blind €0.01
pipinoelbreve9: posts big blind €0.02
*** HOLE CARDS ***
Dealt to pipinoelbreve9 [2s Jd]
Valencinco: raises €0.03 to €0.05
JENOFONTE73: folds 
sablaca: calls €0.05
hai_itzelika: raises €0.18 to €0.23
33baba33: folds 
pipinoelbreve9: folds 
Valencinco: calls €0.18
sablaca: calls €0.18
*** FLOP *** [8d Tc 2c]
Valencinco: bets €0.22
sablaca: calls €0.22
hai_itzelika: calls €0.22
*** TURN *** [8d Tc 2c] [6h]
Valencinco: bets €0.98
sablaca: folds 
hai_itzelika: calls €0.63 and is all-in
Uncalled bet (€0.35) returned to Valencinco
*** RIVER *** [8d Tc 2c 6h] [6c]
*** SHOW DOWN ***
Valencinco: shows [Ac Jc] (a flush, Ace high)
hai_itzelika: shows [Th Ad] (two pair, Tens and Sixes)
Valencinco collected €2.51 from pot
*** SUMMARY ***
Total pot €2.64 | Rake €0.13 
Board [8d Tc 2c 6h 6c]
Seat 1: hai_itzelika (button) showed [Th Ad] and lost with two pair, Tens and Sixes
Seat 2: 33baba33 (small blind) folded before Flop
Seat 3: pipinoelbreve9 (big blind) folded before Flop
Seat 4: Valencinco showed [Ac Jc] and won (€2.51) with a flush, Ace high
Seat 5: JENOFONTE73 folded before Flop (didn't bet)
Seat 6: sablaca folded on the Turn



PokerStars Zoom Hand #257439573662:  Hold'em No Limit (€0.01/€0.02) - 2025/08/22 12:40:13 CET [2025/08/22 6:40:13 ET]
Table 'Arneb' 6-max Seat #1 is the button
Seat 1: Valencinco (€2.26 in chips) 
Seat 2: Hulkesmag215 (€0.90 in chips) 
Seat 3: Lord_Shivaaa (€2.15 in chips) 
Seat 4: bega13 (€3.69 in chips) 
Seat 5: lorocontento (€1.21 in chips) 
Seat 6: pipinoelbreve9 (€3.63 in chips) 
Hulkesmag215: posts small blind €0.01
Lord_Shivaaa: posts big blind €0.02
*** HOLE CARDS ***
Dealt to pipinoelbreve9 [2c 9d]
bega13: folds 
lorocontento: folds 
pipinoelbreve9: folds 
Valencinco: folds 
Hulkesmag215: folds 
Uncalled bet (€0.01) returned to Lord_Shivaaa
Lord_Shivaaa collected €0.02 from pot
Lord_Shivaaa: doesn't show hand 
*** SUMMARY ***
Total pot €0.02 | Rake €0 
Seat 1: Valencinco (button) folded before Flop (didn't bet)
Seat 2: Hulkesmag215 (small blind) folded before Flop
Seat 3: Lord_Shivaaa (big blind) collected (€0.02)
Seat 4: bega13 folded before Flop (didn't bet)
Seat 5: lorocontento folded before Flop (didn't bet)
Seat 6: pipinoelbreve9 folded before Flop (didn't bet)



PokerStars Zoom Hand #257439574016:  Hold'em No Limit (€0.01/€0.02) - 2025/08/22 12:40:16 CET [2025/08/22 6:40:16 ET]
Table 'Arneb' 6-max Seat #1 is the button
Seat 1: Pabl0o0Poker (€1.07 in chips) 
Seat 2: gomera30 (€2.36 in chips) 
Seat 3: bega13 (€3.69 in chips) 
Seat 4: pipinoelbreve9 (€3.63 in chips) 
Seat 5: nofuture69 (€2.37 in chips) 
Seat 6: Noobunaga (€2.04 in chips) 
gomera30: posts small blind €0.01
bega13: posts big blind €0.02
*** HOLE CARDS ***
Dealt to pipinoelbreve9 [Ks 3h]
pipinoelbreve9: folds 
nofuture69: folds 
Noobunaga: folds 
Pabl0o0Poker: raises €0.03 to €0.05
gomera30: folds 
bega13: folds 
Uncalled bet (€0.03) returned to Pabl0o0Poker
Pabl0o0Poker collected €0.05 from pot
Pabl0o0Poker: doesn't show hand 
*** SUMMARY ***
Total pot €0.05 | Rake €0 
Seat 1: Pabl0o0Poker (button) collected (€0.05)
Seat 2: gomera30 (small blind) folded before Flop
Seat 3: bega13 (big blind) folded before Flop
Seat 4: pipinoelbreve9 folded before Flop (didn't bet)
Seat 5: nofuture69 folded before Flop (didn't bet)
Seat 6: Noobunaga folded before Flop (didn't bet)



PokerStars Zoom Hand #257439573230:  Hold'em No Limit (€0.01/€0.02) - 2025/08/22 12:40:09 CET [2025/08/22 6:40:09 ET]
Table 'Arneb' 6-max Seat #1 is the button
Seat 1: pipinoelbreve9 (€3.63 in chips) 
Seat 2: burgoa89 (€2.02 in chips) 
Seat 3: .nt.189 (€1 in chips) 
Seat 4: StrangeNoumena (€2.13 in chips) 
Seat 5: Noobunaga (€2.30 in chips) 
Seat 6: patryskajaja (€0.95 in chips) 
burgoa89: posts small blind €0.01
.nt.189: posts big blind €0.02
*** HOLE CARDS ***
Dealt to pipinoelbreve9 [3h Ac]
StrangeNoumena: folds 
Noobunaga: folds 
patryskajaja: calls €0.02
pipinoelbreve9: folds 
burgoa89: raises €0.06 to €0.08
.nt.189: calls €0.06
patryskajaja: calls €0.06
*** FLOP *** [8h 5h As]
burgoa89: checks 
.nt.189: checks 
patryskajaja: checks 
*** TURN *** [8h 5h As] [Ad]
burgoa89: checks 
.nt.189: bets €0.23
patryskajaja: calls €0.23
burgoa89: folds 
*** RIVER *** [8h 5h As Ad] [5c]
.nt.189: bets €0.69 and is all-in
patryskajaja: calls €0.64 and is all-in
Uncalled bet (€0.05) returned to .nt.189
*** SHOW DOWN ***
.nt.189: shows [6d Th] (two pair, Aces and Fives)
patryskajaja: shows [8d 7s] (two pair, Aces and Eights)
patryskajaja collected €1.88 from pot
*** SUMMARY ***
Total pot €1.98 | Rake €0.10 
Board [8h 5h As Ad 5c]
Seat 1: pipinoelbreve9 (button) folded before Flop (didn't bet)
Seat 2: burgoa89 (small blind) folded on the Turn
Seat 3: .nt.189 (big blind) showed [6d Th] and lost with two pair, Aces and Fives
Seat 4: StrangeNoumena folded before Flop (didn't bet)
Seat 5: Noobunaga folded before Flop (didn't bet)
Seat 6: patryskajaja showed [8d 7s] and won (€1.88) with two pair, Aces and Eights



PokerStars Zoom Hand #257439574820:  Hold'em No Limit (€0.01/€0.02) - 2025/08/22 12:40:24 CET [2025/08/22 6:40:24 ET]
Table 'Arneb' 6-max Seat #1 is the button
Seat 1: Noobunaga (€2.04 in chips) 
Seat 2: skorpia1988 (€2.36 in chips) 
Seat 3: safodaestilo (€2 in chips) 
Seat 4: XXILuv (€2.53 in chips) 
Seat 5: pipinoelbreve9 (€3.63 in chips) 
Seat 6: nofuture69 (€2.37 in chips) 
skorpia1988: posts small blind €0.01
safodaestilo: posts big blind €0.02
*** HOLE CARDS ***
Dealt to pipinoelbreve9 [As 4s]
XXILuv: folds 
pipinoelbreve9: raises €0.04 to €0.06
nofuture69: folds 
Noobunaga: folds 
skorpia1988: folds 
safodaestilo: calls €0.04
*** FLOP *** [Td Qs Th]
safodaestilo: bets €0.04
pipinoelbreve9: calls €0.04
*** TURN *** [Td Qs Th] [3c]
safodaestilo: checks 
pipinoelbreve9: checks 
*** RIVER *** [Td Qs Th 3c] [Tc]
safodaestilo: bets €0.12
pipinoelbreve9: calls €0.12
*** SHOW DOWN ***
safodaestilo: shows [Jh Jd] (a full house, Tens full of Jacks)
pipinoelbreve9: mucks hand 
safodaestilo collected €0.43 from pot
*** SUMMARY ***
Total pot €0.45 | Rake €0.02 
Board [Td Qs Th 3c Tc]
Seat 1: Noobunaga (button) folded before Flop (didn't bet)
Seat 2: skorpia1988 (small blind) folded before Flop
Seat 3: safodaestilo (big blind) showed [Jh Jd] and won (€0.43) with a full house, Tens full of Jacks
Seat 4: XXILuv folded before Flop (didn't bet)
Seat 5: pipinoelbreve9 mucked [As 4s]
Seat 6: nofuture69 folded before Flop (didn't bet)



PokerStars Zoom Hand #257439574452:  Hold'em No Limit (€0.01/€0.02) - 2025/08/22 12:40:20 CET [2025/08/22 6:40:20 ET]
Table 'Arneb' 6-max Seat #1 is the button
Seat 1: nofuture69 (€2 in chips) 
Seat 2: cabsudo77 (€2.45 in chips) 
Seat 3: felidor88 (€2 in chips) 
Seat 4: pipinoelbreve9 (€3.63 in chips) 
Seat 5: JENOFONTE73 (€1.71 in chips) 
Seat 6: FELIPE439 (€2.23 in chips) 
cabsudo77: posts small blind €0.01
felidor88: posts big blind €0.02
*** HOLE CARDS ***
Dealt to pipinoelbreve9 [4h 9c]
pipinoelbreve9: folds 
JENOFONTE73 has timed out
JENOFONTE73: folds 
FELIPE439: folds 
nofuture69: raises €0.03 to €0.05
cabsudo77: folds 
felidor88: calls €0.03
*** FLOP *** [Ks Td Jh]
felidor88: checks 
nofuture69: bets €0.03
felidor88: folds 
Uncalled bet (€0.03) returned to nofuture69
nofuture69 collected €0.10 from pot
nofuture69: doesn't show hand 
*** SUMMARY ***
Total pot €0.11 | Rake €0.01 
Board [Ks Td Jh]
Seat 1: nofuture69 (button) collected (€0.10)
Seat 2: cabsudo77 (small blind) folded before Flop
Seat 3: felidor88 (big blind) folded on the Flop
Seat 4: pipinoelbreve9 folded before Flop (didn't bet)
Seat 5: JENOFONTE73 folded before Flop (didn't bet)
Seat 6: FELIPE439 folded before Flop (didn't bet)



PokerStars Zoom Hand #257439578940:  Hold'em No Limit (€0.01/€0.02) - 2025/08/22 12:41:03 CET [2025/08/22 6:41:03 ET]
Table 'Arneb' 6-max Seat #1 is the button
Seat 1: grenha1972 (€1.77 in chips) 
Seat 2: pipinoelbreve9 (€3.41 in chips) 
Seat 3: basurdia (€2 in chips) 
Seat 4: burgoa89 (€2.04 in chips) 
Seat 5: gomera30 (€2.35 in chips) 
Seat 6: bega13 (€3.66 in chips) 
pipinoelbreve9: posts small blind €0.01
basurdia: posts big blind €0.02
*** HOLE CARDS ***
Dealt to pipinoelbreve9 [5d 6c]
burgoa89: folds 
gomera30: folds 
bega13: folds 
grenha1972: raises €0.02 to €0.04
pipinoelbreve9: folds 
basurdia: raises €0.08 to €0.12
grenha1972: calls €0.08
*** FLOP *** [Kc 5c Td]
basurdia: checks 
grenha1972: bets €0.17
basurdia: calls €0.17
*** TURN *** [Kc 5c Td] [9h]
basurdia: checks 
grenha1972: checks 
*** RIVER *** [Kc 5c Td 9h] [3h]
basurdia: bets €0.20
grenha1972: calls €0.20
*** SHOW DOWN ***
basurdia: shows [Qd Ks] (a pair of Kings)
grenha1972: mucks hand 
basurdia collected €0.94 from pot
*** SUMMARY ***
Total pot €0.99 | Rake €0.05 
Board [Kc 5c Td 9h 3h]
Seat 1: grenha1972 (button) mucked [Js Kd]
Seat 2: pipinoelbreve9 (small blind) folded before Flop
Seat 3: basurdia (big blind) showed [Qd Ks] and won (€0.94) with a pair of Kings
Seat 4: burgoa89 folded before Flop (didn't bet)
Seat 5: gomera30 folded before Flop (didn't bet)
Seat 6: bega13 folded before Flop (didn't bet)



PokerStars Zoom Hand #257440277813:  Hold'em No Limit (€0.01/€0.02) - 2025/08/22 14:25:48 CET [2025/08/22 8:25:48 ET]
Table 'Arneb' 6-max Seat #1 is the button
Seat 1: Topuluz33 (€4.66 in chips) 
Seat 2: bega13 (€2.01 in chips) 
Seat 3: pipinoelbreve9 (€2 in chips) 
Seat 4: BestiaESP12 (€2.72 in chips) 
Seat 5: pokeraxyn (€2.50 in chips) 
Seat 6: bdcscstars (€3.77 in chips) 
bega13: posts small blind €0.01
pipinoelbreve9: posts big blind €0.02
*** HOLE CARDS ***
Dealt to pipinoelbreve9 [9h 2c]
BestiaESP12: folds 
pokeraxyn: folds 
bdcscstars: folds 
Topuluz33: folds 
bega13: raises €0.04 to €0.06
pipinoelbreve9: folds 
Uncalled bet (€0.04) returned to bega13
bega13 collected €0.04 from pot
bega13: doesn't show hand 
*** SUMMARY ***
Total pot €0.04 | Rake €0 
Seat 1: Topuluz33 (button) folded before Flop (didn't bet)
Seat 2: bega13 (small blind) collected (€0.04)
Seat 3: pipinoelbreve9 (big blind) folded before Flop
Seat 4: BestiaESP12 folded before Flop (didn't bet)
Seat 5: pokeraxyn folded before Flop (didn't bet)
Seat 6: bdcscstars folded before Flop (didn't bet)



