PokerStars Zoom Hand #257607198494:  Hold'em No Limit (€0.01/€0.02) - 2025/09/04 12:28:18 CET [2025/09/04 6:28:18 ET]
Table 'Arneb' 6-max Seat #1 is the button
Seat 1: sorceline (€2.21 in chips) 
Seat 2: grenha1972 (€2.79 in chips) 
Seat 3: pipinoelbreve9 (€2 in chips) 
Seat 4: DavSnook (€3.80 in chips) 
Seat 5: EiramSenpai (€5.11 in chips) 
Seat 6: Zoueleux (€1.91 in chips) 
grenha1972: posts small blind €0.01
pipinoelbreve9: posts big blind €0.02
*** HOLE CARDS ***
Dealt to pipinoelbreve9 [Ac Qd]
DavSnook: raises €0.05 to €0.07
EiramSenpai: folds 
Zoueleux: folds 
sorceline: calls €0.07
grenha1972: folds 
pipinoelbreve9: calls €0.05
*** FLOP *** [9s 5h Qc]
pipinoelbreve9: checks 
DavSnook: bets €0.10
sorceline: calls €0.10
pipinoelbreve9: raises €0.20 to €0.30
DavSnook: folds 
sorceline: calls €0.20
*** TURN *** [9s 5h Qc] [Th]
pipinoelbreve9: bets €0.44
sorceline: calls €0.44
*** RIVER *** [9s 5h Qc Th] [Qs]
pipinoelbreve9: bets €1.19 and is all-in
sorceline: folds 
Uncalled bet (€1.19) returned to pipinoelbreve9
pipinoelbreve9 collected €1.71 from pot
pipinoelbreve9: doesn't show hand 
*** SUMMARY ***
Total pot €1.80 | Rake €0.09 
Board [9s 5h Qc Th Qs]
Seat 1: sorceline (button) folded on the River
Seat 2: grenha1972 (small blind) folded before Flop
Seat 3: pipinoelbreve9 (big blind) collected (€1.71)
Seat 4: DavSnook folded on the Flop
Seat 5: EiramSenpai folded before Flop (didn't bet)
Seat 6: Zoueleux folded before Flop (didn't bet)



PokerStars Zoom Hand #257607206702:  Hold'em No Limit (€0.01/€0.02) - 2025/09/04 12:29:44 CET [2025/09/04 6:29:44 ET]
Table 'Arneb' 6-max Seat #1 is the button
Seat 1: Danipro178 (€2.53 in chips) 
Seat 2: burgoa89 (€2.84 in chips) 
Seat 3: lorocontento (€1 in chips) 
Seat 4: FELIPE439 (€3.75 in chips) 
Seat 5: @RobarTevoy99 (€3.27 in chips) 
Seat 6: pipinoelbreve9 (€2.89 in chips) 
burgoa89: posts small blind €0.01
lorocontento: posts big blind €0.02
*** HOLE CARDS ***
Dealt to pipinoelbreve9 [3h Js]
FELIPE439: folds 
@RobarTevoy99: folds 
pipinoelbreve9: folds 
Danipro178: folds 
burgoa89: folds 
Uncalled bet (€0.01) returned to lorocontento
lorocontento collected €0.02 from pot
lorocontento: doesn't show hand 
*** SUMMARY ***
Total pot €0.02 | Rake €0 
Seat 1: Danipro178 (button) folded before Flop (didn't bet)
Seat 2: burgoa89 (small blind) folded before Flop
Seat 3: lorocontento (big blind) collected (€0.02)
Seat 4: FELIPE439 folded before Flop (didn't bet)
Seat 5: @RobarTevoy99 folded before Flop (didn't bet)
Seat 6: pipinoelbreve9 folded before Flop (didn't bet)



PokerStars Zoom Hand #257607204136:  Hold'em No Limit (€0.01/€0.02) - 2025/09/04 12:29:17 CET [2025/09/04 6:29:17 ET]
Table 'Arneb' 6-max Seat #1 is the button
Seat 1: burgoa89 (€2.31 in chips) 
Seat 2: pipinoelbreve9 (€2.90 in chips) 
Seat 3: swiitx (€0.46 in chips) 
Seat 4: EiramSenpai (€5.08 in chips) 
Seat 5: Angelo697 (€1.42 in chips) 
Seat 6: marcel13013 (€1.57 in chips) 
pipinoelbreve9: posts small blind €0.01
swiitx: posts big blind €0.02
*** HOLE CARDS ***
Dealt to pipinoelbreve9 [2h 9c]
EiramSenpai: folds 
Angelo697: calls €0.02
marcel13013: folds 
burgoa89: folds 
pipinoelbreve9: folds 
swiitx: raises €0.04 to €0.06
Angelo697: calls €0.04
*** FLOP *** [2s Jc As]
swiitx: bets €0.06
Angelo697: folds 
Uncalled bet (€0.06) returned to swiitx
swiitx collected €0.12 from pot
swiitx: doesn't show hand 
*** SUMMARY ***
Total pot €0.13 | Rake €0.01 
Board [2s Jc As]
Seat 1: burgoa89 (button) folded before Flop (didn't bet)
Seat 2: pipinoelbreve9 (small blind) folded before Flop
Seat 3: swiitx (big blind) collected (€0.12)
Seat 4: EiramSenpai folded before Flop (didn't bet)
Seat 5: Angelo697 folded on the Flop
Seat 6: marcel13013 folded before Flop (didn't bet)



PokerStars Zoom Hand #257607207812:  Hold'em No Limit (€0.01/€0.02) - 2025/09/04 12:29:55 CET [2025/09/04 6:29:55 ET]
Table 'Arneb' 6-max Seat #1 is the button
Seat 1: seriomarkos (€2.22 in chips) 
Seat 2: joanmi_sanchez (€2.23 in chips) 
Seat 3: pipinoelbreve9 (€2.89 in chips) 
Seat 4: MDKristian (€2.13 in chips) 
Seat 5: José A. A. (€2.43 in chips) 
Seat 6: morganlee66 (€2.86 in chips) 
joanmi_sanchez: posts small blind €0.01
pipinoelbreve9: posts big blind €0.02
*** HOLE CARDS ***
Dealt to pipinoelbreve9 [2c Ah]
MDKristian: folds 
José A. A.: folds 
morganlee66: folds 
seriomarkos: folds 
joanmi_sanchez: folds 
Uncalled bet (€0.01) returned to pipinoelbreve9
pipinoelbreve9 collected €0.02 from pot
pipinoelbreve9: doesn't show hand 
*** SUMMARY ***
Total pot €0.02 | Rake €0 
Seat 1: seriomarkos (button) folded before Flop (didn't bet)
Seat 2: joanmi_sanchez (small blind) folded before Flop
Seat 3: pipinoelbreve9 (big blind) collected (€0.02)
Seat 4: MDKristian folded before Flop (didn't bet)
Seat 5: José A. A. folded before Flop (didn't bet)
Seat 6: morganlee66 folded before Flop (didn't bet)



PokerStars Zoom Hand #257607209043:  Hold'em No Limit (€0.01/€0.02) - 2025/09/04 12:30:08 CET [2025/09/04 6:30:08 ET]
Table 'Arneb' 6-max Seat #1 is the button
Seat 1: lorocontento (€1 in chips) 
Seat 2: pipinoelbreve9 (€2.90 in chips) 
Seat 3: @RobarTevoy99 (€1.79 in chips) 
Seat 4: mari197721 (€1.59 in chips) 
Seat 5: seriomarkos (€8.03 in chips) 
Seat 6: swiitx (€0.51 in chips) 
pipinoelbreve9: posts small blind €0.01
@RobarTevoy99: posts big blind €0.02
*** HOLE CARDS ***
Dealt to pipinoelbreve9 [Kc 8d]
mari197721: folds 
seriomarkos: folds 
swiitx: folds 
lorocontento: folds 
pipinoelbreve9: raises €0.04 to €0.06
@RobarTevoy99: folds 
Uncalled bet (€0.04) returned to pipinoelbreve9
pipinoelbreve9 collected €0.04 from pot
pipinoelbreve9: doesn't show hand 
*** SUMMARY ***
Total pot €0.04 | Rake €0 
Seat 1: lorocontento (button) folded before Flop (didn't bet)
Seat 2: pipinoelbreve9 (small blind) collected (€0.04)
Seat 3: @RobarTevoy99 (big blind) folded before Flop
Seat 4: mari197721 folded before Flop (didn't bet)
Seat 5: seriomarkos folded before Flop (didn't bet)
Seat 6: swiitx folded before Flop (didn't bet)



PokerStars Zoom Hand #257607207328:  Hold'em No Limit (€0.01/€0.02) - 2025/09/04 12:29:50 CET [2025/09/04 6:29:50 ET]
Table 'Arneb' 6-max Seat #1 is the button
Seat 1: FELIPE439 (€3.75 in chips) 
Seat 2: 34Sirina (€0.85 in chips) 
Seat 3: lorocontento (€1 in chips) 
Seat 4: burgoa89 (€3.50 in chips) 
Seat 5: pipinoelbreve9 (€2.89 in chips) 
Seat 6: D Tasmania (€1.44 in chips) 
34Sirina: posts small blind €0.01
lorocontento: posts big blind €0.02
*** HOLE CARDS ***
Dealt to pipinoelbreve9 [8c 6h]
burgoa89: folds 
pipinoelbreve9: folds 
D Tasmania: folds 
FELIPE439: folds 
34Sirina: calls €0.01
lorocontento: checks 
*** FLOP *** [Qs Jd 9d]
34Sirina: checks 
lorocontento: checks 
*** TURN *** [Qs Jd 9d] [4d]
34Sirina: checks 
lorocontento: bets €0.03
34Sirina: folds 
Uncalled bet (€0.03) returned to lorocontento
lorocontento collected €0.04 from pot
lorocontento: doesn't show hand 
*** SUMMARY ***
Total pot €0.04 | Rake €0 
Board [Qs Jd 9d 4d]
Seat 1: FELIPE439 (button) folded before Flop (didn't bet)
Seat 2: 34Sirina (small blind) folded on the Turn
Seat 3: lorocontento (big blind) collected (€0.04)
Seat 4: burgoa89 folded before Flop (didn't bet)
Seat 5: pipinoelbreve9 folded before Flop (didn't bet)
Seat 6: D Tasmania folded before Flop (didn't bet)



PokerStars Zoom Hand #257607205898:  Hold'em No Limit (€0.01/€0.02) - 2025/09/04 12:29:35 CET [2025/09/04 6:29:35 ET]
Table 'Arneb' 6-max Seat #1 is the button
Seat 1: pipinoelbreve9 (€2.89 in chips) 
Seat 2: MDKristian (€2.48 in chips) 
Seat 3: burgoa89 (€3.15 in chips) 
Seat 4: damastodas (€1.38 in chips) 
Seat 5: Xplotas (€1.63 in chips) 
Seat 6: @RobarTevoy99 (€2.30 in chips) 
MDKristian: posts small blind €0.01
burgoa89: posts big blind €0.02
*** HOLE CARDS ***
Dealt to pipinoelbreve9 [7d 4s]
damastodas: calls €0.02
Xplotas: calls €0.02
@RobarTevoy99: folds 
pipinoelbreve9: folds 
MDKristian: raises €0.02 to €0.04
burgoa89: folds 
damastodas: calls €0.02
Xplotas: calls €0.02
*** FLOP *** [3s 2c Th]
MDKristian: checks 
damastodas: checks 
Xplotas: checks 
*** TURN *** [3s 2c Th] [2s]
MDKristian: checks 
damastodas: checks 
Xplotas: bets €0.04
MDKristian: calls €0.04
damastodas: calls €0.04
*** RIVER *** [3s 2c Th 2s] [9c]
MDKristian: checks 
damastodas: checks 
Xplotas: checks 
*** SHOW DOWN ***
MDKristian: shows [7h 7s] (two pair, Sevens and Deuces)
damastodas: mucks hand 
Xplotas: mucks hand 
MDKristian collected €0.25 from pot
*** SUMMARY ***
Total pot €0.26 | Rake €0.01 
Board [3s 2c Th 2s 9c]
Seat 1: pipinoelbreve9 (button) folded before Flop (didn't bet)
Seat 2: MDKristian (small blind) showed [7h 7s] and won (€0.25) with two pair, Sevens and Deuces
Seat 3: burgoa89 (big blind) folded before Flop
Seat 4: damastodas mucked [4h Ad]
Seat 5: Xplotas mucked [Kd 5s]
Seat 6: @RobarTevoy99 folded before Flop (didn't bet)



PokerStars Zoom Hand #257607210574:  Hold'em No Limit (€0.01/€0.02) - 2025/09/04 12:30:24 CET [2025/09/04 6:30:24 ET]
Table 'Arneb' 6-max Seat #1 is the button
Seat 1: pipinoelbreve9 (€2.92 in chips) 
Seat 2: FELIPE439 (€2.26 in chips) 
Seat 3: 34Sirina (€0.83 in chips) 
Seat 4: lorocontento (€1 in chips) 
Seat 5: burgoa89 (€3.10 in chips) 
Seat 6: Danipro178 (€2.07 in chips) 
FELIPE439: posts small blind €0.01
34Sirina: posts big blind €0.02
*** HOLE CARDS ***
Dealt to pipinoelbreve9 [As 6h]
lorocontento: folds 
burgoa89: folds 
Danipro178: folds 
pipinoelbreve9: raises €0.04 to €0.06
FELIPE439: folds 
34Sirina: calls €0.04
*** FLOP *** [2d 9d 4c]
34Sirina: checks 
pipinoelbreve9: bets €0.04
34Sirina: folds 
Uncalled bet (€0.04) returned to pipinoelbreve9
pipinoelbreve9 collected €0.12 from pot
pipinoelbreve9: doesn't show hand 
*** SUMMARY ***
Total pot €0.13 | Rake €0.01 
Board [2d 9d 4c]
Seat 1: pipinoelbreve9 (button) collected (€0.12)
Seat 2: FELIPE439 (small blind) folded before Flop
Seat 3: 34Sirina (big blind) folded on the Flop
Seat 4: lorocontento folded before Flop (didn't bet)
Seat 5: burgoa89 folded before Flop (didn't bet)
Seat 6: Danipro178 folded before Flop (didn't bet)



PokerStars Zoom Hand #257607212747:  Hold'em No Limit (€0.01/€0.02) - 2025/09/04 12:30:46 CET [2025/09/04 6:30:46 ET]
Table 'Arneb' 6-max Seat #1 is the button
Seat 1: more457 (€1.60 in chips) 
Seat 2: sorceline (€1.55 in chips) 
Seat 3: MDKristian (€2.65 in chips) 
Seat 4: pipinoelbreve9 (€2.98 in chips) 
Seat 5: burgoa89 (€3.42 in chips) 
Seat 6: aaronroxi (€2.07 in chips) 
sorceline: posts small blind €0.01
MDKristian: posts big blind €0.02
*** HOLE CARDS ***
Dealt to pipinoelbreve9 [Jd 5c]
pipinoelbreve9: folds 
burgoa89: folds 
aaronroxi: folds 
more457: folds 
sorceline: calls €0.01
MDKristian: checks 
*** FLOP *** [4s 7h 4d]
sorceline: bets €0.04
MDKristian: folds 
Uncalled bet (€0.04) returned to sorceline
sorceline collected €0.04 from pot
sorceline: doesn't show hand 
*** SUMMARY ***
Total pot €0.04 | Rake €0 
Board [4s 7h 4d]
Seat 1: more457 (button) folded before Flop (didn't bet)
Seat 2: sorceline (small blind) collected (€0.04)
Seat 3: MDKristian (big blind) folded on the Flop
Seat 4: pipinoelbreve9 folded before Flop (didn't bet)
Seat 5: burgoa89 folded before Flop (didn't bet)
Seat 6: aaronroxi folded before Flop (didn't bet)



PokerStars Zoom Hand #257607213897:  Hold'em No Limit (€0.01/€0.02) - 2025/09/04 12:30:59 CET [2025/09/04 6:30:59 ET]
Table 'Arneb' 6-max Seat #1 is the button
Seat 1: more457 (€1.60 in chips) 
Seat 2: seriomarkos (€2.92 in chips) 
Seat 3: Angelo697 (€0.99 in chips) 
Seat 4: D Tasmania (€1.42 in chips) 
Seat 5: Zoueleux (€2.32 in chips) 
Seat 6: pipinoelbreve9 (€2.98 in chips) 
seriomarkos: posts small blind €0.01
Angelo697: posts big blind €0.02
*** HOLE CARDS ***
Dealt to pipinoelbreve9 [Ts 5h]
D Tasmania: raises €0.03 to €0.05
Zoueleux: folds 
pipinoelbreve9: folds 
more457: folds 
seriomarkos: folds 
Angelo697: calls €0.03
*** FLOP *** [Qs 3h 4c]
Angelo697: checks 
D Tasmania: bets €0.03
Angelo697: calls €0.03
*** TURN *** [Qs 3h 4c] [Js]
Angelo697: checks 
D Tasmania: bets €0.18
Angelo697: folds 
Uncalled bet (€0.18) returned to D Tasmania
D Tasmania collected €0.16 from pot
D Tasmania: doesn't show hand 
*** SUMMARY ***
Total pot €0.17 | Rake €0.01 
Board [Qs 3h 4c Js]
Seat 1: more457 (button) folded before Flop (didn't bet)
Seat 2: seriomarkos (small blind) folded before Flop
Seat 3: Angelo697 (big blind) folded on the Turn
Seat 4: D Tasmania collected (€0.16)
Seat 5: Zoueleux folded before Flop (didn't bet)
Seat 6: pipinoelbreve9 folded before Flop (didn't bet)



PokerStars Zoom Hand #257607214414:  Hold'em No Limit (€0.01/€0.02) - 2025/09/04 12:31:04 CET [2025/09/04 6:31:04 ET]
Table 'Arneb' 6-max Seat #1 is the button
Seat 1: seriomarkos (€2.57 in chips) 
Seat 2: MDKristian (€2.21 in chips) 
Seat 3: more457 (€1.60 in chips) 
Seat 4: poteaarte (€5.07 in chips) 
Seat 5: pipinoelbreve9 (€2.98 in chips) 
Seat 6: EiramSenpai (€4.03 in chips) 
MDKristian: posts small blind €0.01
more457: posts big blind €0.02
*** HOLE CARDS ***
Dealt to pipinoelbreve9 [Ad 8d]
poteaarte: folds 
pipinoelbreve9: raises €0.04 to €0.06
EiramSenpai: folds 
seriomarkos: calls €0.06
MDKristian: folds 
more457: folds 
*** FLOP *** [Kh Th 6h]
pipinoelbreve9: checks 
seriomarkos: checks 
*** TURN *** [Kh Th 6h] [8s]
pipinoelbreve9: bets €0.07
seriomarkos: calls €0.07
*** RIVER *** [Kh Th 6h 8s] [6d]
pipinoelbreve9: checks 
seriomarkos: checks 
*** SHOW DOWN ***
pipinoelbreve9: shows [Ad 8d] (two pair, Eights and Sixes)
seriomarkos: shows [Qd Ts] (two pair, Tens and Sixes)
seriomarkos collected €0.28 from pot
*** SUMMARY ***
Total pot €0.29 | Rake €0.01 
Board [Kh Th 6h 8s 6d]
Seat 1: seriomarkos (button) showed [Qd Ts] and won (€0.28) with two pair, Tens and Sixes
Seat 2: MDKristian (small blind) folded before Flop
Seat 3: more457 (big blind) folded before Flop
Seat 4: poteaarte folded before Flop (didn't bet)
Seat 5: pipinoelbreve9 showed [Ad 8d] and lost with two pair, Eights and Sixes
Seat 6: EiramSenpai folded before Flop (didn't bet)



PokerStars Zoom Hand #257607218833:  Hold'em No Limit (€0.01/€0.02) - 2025/09/04 12:31:49 CET [2025/09/04 6:31:49 ET]
Table 'Arneb' 6-max Seat #1 is the button
Seat 1: burgoa89 (€3.01 in chips) 
Seat 2: ehbraga (€1.62 in chips) 
Seat 3: pipinoelbreve9 (€2.85 in chips) 
Seat 4: Asensiaco (€1.48 in chips) 
Seat 5: MDKristian (€2.22 in chips) 
Seat 6: DavSnook (€5.46 in chips) 
ehbraga: posts small blind €0.01
pipinoelbreve9: posts big blind €0.02
*** HOLE CARDS ***
Dealt to pipinoelbreve9 [2h 5c]
Asensiaco: raises €0.04 to €0.06
MDKristian: folds 
DavSnook: folds 
burgoa89: folds 
ehbraga: folds 
pipinoelbreve9: folds 
Uncalled bet (€0.04) returned to Asensiaco
Asensiaco collected €0.05 from pot
Asensiaco: doesn't show hand 
*** SUMMARY ***
Total pot €0.05 | Rake €0 
Seat 1: burgoa89 (button) folded before Flop (didn't bet)
Seat 2: ehbraga (small blind) folded before Flop
Seat 3: pipinoelbreve9 (big blind) folded before Flop
Seat 4: Asensiaco collected (€0.05)
Seat 5: MDKristian folded before Flop (didn't bet)
Seat 6: DavSnook folded before Flop (didn't bet)



PokerStars Zoom Hand #257607219912:  Hold'em No Limit (€0.01/€0.02) - 2025/09/04 12:32:00 CET [2025/09/04 6:32:00 ET]
Table 'Arneb' 6-max Seat #1 is the button
Seat 1: @RobarTevoy99 (€1.59 in chips) 
Seat 2: José A. A. (€2 in chips) 
Seat 3: MDKristian (€2.22 in chips) 
Seat 4: Danipro178 (€2 in chips) 
Seat 5: pipinoelbreve9 (€2.83 in chips) 
Seat 6: Isbut (€1.55 in chips) 
José A. A.: posts small blind €0.01
MDKristian: posts big blind €0.02
*** HOLE CARDS ***
Dealt to pipinoelbreve9 [7c 3c]
Danipro178: folds 
pipinoelbreve9: folds 
Isbut: folds 
@RobarTevoy99: raises €0.05 to €0.07
José A. A.: folds 
MDKristian: folds 
Uncalled bet (€0.05) returned to @RobarTevoy99
@RobarTevoy99 collected €0.05 from pot
@RobarTevoy99: doesn't show hand 
*** SUMMARY ***
Total pot €0.05 | Rake €0 
Seat 1: @RobarTevoy99 (button) collected (€0.05)
Seat 2: José A. A. (small blind) folded before Flop
Seat 3: MDKristian (big blind) folded before Flop
Seat 4: Danipro178 folded before Flop (didn't bet)
Seat 5: pipinoelbreve9 folded before Flop (didn't bet)
Seat 6: Isbut folded before Flop (didn't bet)



PokerStars Zoom Hand #257607220893:  Hold'em No Limit (€0.01/€0.02) - 2025/09/04 12:32:11 CET [2025/09/04 6:32:11 ET]
Table 'Arneb' 6-max Seat #1 is the button
Seat 1: D Tasmania (€1.47 in chips) 
Seat 2: pipinoelbreve9 (€2.83 in chips) 
Seat 3: poteaarte (€1.76 in chips) 
Seat 4: Zoueleux (€2.17 in chips) 
Seat 5: FELIPE439 (€2.23 in chips) 
Seat 6: damastodas (€1.66 in chips) 
pipinoelbreve9: posts small blind €0.01
poteaarte: posts big blind €0.02
*** HOLE CARDS ***
Dealt to pipinoelbreve9 [6d 8h]
Zoueleux: folds 
FELIPE439: folds 
damastodas: folds 
D Tasmania: folds 
pipinoelbreve9: folds 
Uncalled bet (€0.01) returned to poteaarte
poteaarte collected €0.02 from pot
poteaarte: doesn't show hand 
*** SUMMARY ***
Total pot €0.02 | Rake €0 
Seat 1: D Tasmania (button) folded before Flop (didn't bet)
Seat 2: pipinoelbreve9 (small blind) folded before Flop
Seat 3: poteaarte (big blind) collected (€0.02)
Seat 4: Zoueleux folded before Flop (didn't bet)
Seat 5: FELIPE439 folded before Flop (didn't bet)
Seat 6: damastodas folded before Flop (didn't bet)



PokerStars Zoom Hand #257607222039:  Hold'em No Limit (€0.01/€0.02) - 2025/09/04 12:32:23 CET [2025/09/04 6:32:23 ET]
Table 'Arneb' 6-max Seat #1 is the button
Seat 1: pipinoelbreve9 (€2.82 in chips) 
Seat 2: seriomarkos (€8 in chips) 
Seat 3: poteaarte (€2 in chips) 
Seat 4: burgoa89 (€3.34 in chips) 
Seat 5: ehbraga (€0.47 in chips) 
Seat 6: FELIPE439 (€1.53 in chips) 
seriomarkos: posts small blind €0.01
poteaarte: posts big blind €0.02
*** HOLE CARDS ***
Dealt to pipinoelbreve9 [4d 3s]
burgoa89: folds 
ehbraga: folds 
FELIPE439: folds 
pipinoelbreve9: folds 
seriomarkos: raises €0.04 to €0.06
poteaarte: folds 
Uncalled bet (€0.04) returned to seriomarkos
seriomarkos collected €0.04 from pot
seriomarkos: doesn't show hand 
*** SUMMARY ***
Total pot €0.04 | Rake €0 
Seat 1: pipinoelbreve9 (button) folded before Flop (didn't bet)
Seat 2: seriomarkos (small blind) collected (€0.04)
Seat 3: poteaarte (big blind) folded before Flop
Seat 4: burgoa89 folded before Flop (didn't bet)
Seat 5: ehbraga folded before Flop (didn't bet)
Seat 6: FELIPE439 folded before Flop (didn't bet)



PokerStars Zoom Hand #257607222682:  Hold'em No Limit (€0.01/€0.02) - 2025/09/04 12:32:30 CET [2025/09/04 6:32:30 ET]
Table 'Arneb' 6-max Seat #1 is the button
Seat 1: José A. A. (€2 in chips) 
Seat 2: @RobarTevoy99 (€1.60 in chips) 
Seat 3: QUIQUE JONES (€0.88 in chips) 
Seat 4: DavSnook (€1.23 in chips) 
Seat 5: burgoa89 (€3.34 in chips) 
Seat 6: pipinoelbreve9 (€2.82 in chips) 
@RobarTevoy99: posts small blind €0.01
QUIQUE JONES: posts big blind €0.02
*** HOLE CARDS ***
Dealt to pipinoelbreve9 [3s 7h]
DavSnook: folds 
burgoa89: folds 
pipinoelbreve9: folds 
José A. A.: folds 
@RobarTevoy99: folds 
Uncalled bet (€0.01) returned to QUIQUE JONES
QUIQUE JONES collected €0.02 from pot
QUIQUE JONES: doesn't show hand 
*** SUMMARY ***
Total pot €0.02 | Rake €0 
Seat 1: José A. A. (button) folded before Flop (didn't bet)
Seat 2: @RobarTevoy99 (small blind) folded before Flop
Seat 3: QUIQUE JONES (big blind) collected (€0.02)
Seat 4: DavSnook folded before Flop (didn't bet)
Seat 5: burgoa89 folded before Flop (didn't bet)
Seat 6: pipinoelbreve9 folded before Flop (didn't bet)



PokerStars Zoom Hand #257607223423:  Hold'em No Limit (€0.01/€0.02) - 2025/09/04 12:32:37 CET [2025/09/04 6:32:37 ET]
Table 'Arneb' 6-max Seat #1 is the button
Seat 1: Xenon-FR (€3.47 in chips) 
Seat 2: burgoa89 (€2.19 in chips) 
Seat 3: José A. A. (€2 in chips) 
Seat 4: pipinoelbreve9 (€2.82 in chips) 
Seat 5: MDKristian (€2 in chips) 
Seat 6: more457 (€1.55 in chips) 
burgoa89: posts small blind €0.01
José A. A.: posts big blind €0.02
*** HOLE CARDS ***
Dealt to pipinoelbreve9 [5d 3h]
pipinoelbreve9: folds 
MDKristian: folds 
more457: folds 
Xenon-FR: calls €0.02
burgoa89: folds 
José A. A.: checks 
*** FLOP *** [Qs Jh 9c]
José A. A.: checks 
Xenon-FR: checks 
*** TURN *** [Qs Jh 9c] [Qd]
José A. A.: checks 
Xenon-FR: checks 
*** RIVER *** [Qs Jh 9c Qd] [2c]
José A. A.: checks 
Xenon-FR: checks 
*** SHOW DOWN ***
José A. A.: shows [8h 7h] (a pair of Queens)
Xenon-FR: shows [5c 5s] (two pair, Queens and Fives)
Xenon-FR collected €0.05 from pot
*** SUMMARY ***
Total pot €0.05 | Rake €0 
Board [Qs Jh 9c Qd 2c]
Seat 1: Xenon-FR (button) showed [5c 5s] and won (€0.05) with two pair, Queens and Fives
Seat 2: burgoa89 (small blind) folded before Flop
Seat 3: José A. A. (big blind) showed [8h 7h] and lost with a pair of Queens
Seat 4: pipinoelbreve9 folded before Flop (didn't bet)
Seat 5: MDKristian folded before Flop (didn't bet)
Seat 6: more457 folded before Flop (didn't bet)



PokerStars Zoom Hand #257607224010:  Hold'em No Limit (€0.01/€0.02) - 2025/09/04 12:32:43 CET [2025/09/04 6:32:43 ET]
Table 'Arneb' 6-max Seat #1 is the button
Seat 1: DavSnook (€2.75 in chips) 
Seat 2: Asensiaco (€1.71 in chips) 
Seat 3: @RobarTevoy99 (€2.09 in chips) 
Seat 4: pipinoelbreve9 (€2.82 in chips) 
Seat 5: more457 (€1.55 in chips) 
Seat 6: QUIQUE JONES (€0.89 in chips) 
Asensiaco: posts small blind €0.01
@RobarTevoy99: posts big blind €0.02
*** HOLE CARDS ***
Dealt to pipinoelbreve9 [6h 2h]
pipinoelbreve9: folds 
more457: folds 
QUIQUE JONES: folds 
DavSnook: raises €0.05 to €0.07
Asensiaco: calls €0.06
@RobarTevoy99: folds 
*** FLOP *** [Ks 2s Jd]
Asensiaco: checks 
DavSnook: bets €0.08
Asensiaco: folds 
Uncalled bet (€0.08) returned to DavSnook
DavSnook collected €0.15 from pot
DavSnook: doesn't show hand 
*** SUMMARY ***
Total pot €0.16 | Rake €0.01 
Board [Ks 2s Jd]
Seat 1: DavSnook (button) collected (€0.15)
Seat 2: Asensiaco (small blind) folded on the Flop
Seat 3: @RobarTevoy99 (big blind) folded before Flop
Seat 4: pipinoelbreve9 folded before Flop (didn't bet)
Seat 5: more457 folded before Flop (didn't bet)
Seat 6: QUIQUE JONES folded before Flop (didn't bet)



PokerStars Zoom Hand #257607224601:  Hold'em No Limit (€0.01/€0.02) - 2025/09/04 12:32:50 CET [2025/09/04 6:32:50 ET]
Table 'Arneb' 6-max Seat #1 is the button
Seat 1: FELIPE439 (€1.53 in chips) 
Seat 2: @RobarTevoy99 (€1.49 in chips) 
Seat 3: pipinoelbreve9 (€2.82 in chips) 
Seat 4: DavSnook (€3.02 in chips) 
Seat 5: seriomarkos (€2.78 in chips) 
Seat 6: tidji67 (€2.21 in chips) 
@RobarTevoy99: posts small blind €0.01
pipinoelbreve9: posts big blind €0.02
*** HOLE CARDS ***
Dealt to pipinoelbreve9 [6d 8h]
DavSnook: folds 
seriomarkos: folds 
tidji67: raises €0.05 to €0.07
FELIPE439: folds 
@RobarTevoy99: folds 
pipinoelbreve9: folds 
Uncalled bet (€0.05) returned to tidji67
tidji67 collected €0.05 from pot
tidji67: doesn't show hand 
*** SUMMARY ***
Total pot €0.05 | Rake €0 
Seat 1: FELIPE439 (button) folded before Flop (didn't bet)
Seat 2: @RobarTevoy99 (small blind) folded before Flop
Seat 3: pipinoelbreve9 (big blind) folded before Flop
Seat 4: DavSnook folded before Flop (didn't bet)
Seat 5: seriomarkos folded before Flop (didn't bet)
Seat 6: tidji67 collected (€0.05)



PokerStars Zoom Hand #257607226437:  Hold'em No Limit (€0.01/€0.02) - 2025/09/04 12:33:08 CET [2025/09/04 6:33:08 ET]
Table 'Arneb' 6-max Seat #1 is the button
Seat 1: Danipro178 (€2.65 in chips) 
Seat 2: ThePunisher73 (€1.83 in chips) 
Seat 3: D Tasmania (€1.56 in chips) 
Seat 4: MDKristian (€2.01 in chips) 
Seat 5: pipinoelbreve9 (€2.80 in chips) 
Seat 6: @RobarTevoy99 (€1.58 in chips) 
ThePunisher73: posts small blind €0.01
D Tasmania: posts big blind €0.02
*** HOLE CARDS ***
Dealt to pipinoelbreve9 [2c Qc]
MDKristian: folds 
pipinoelbreve9: folds 
@RobarTevoy99: folds 
Danipro178: folds 
ThePunisher73: folds 
Uncalled bet (€0.01) returned to D Tasmania
D Tasmania collected €0.02 from pot
D Tasmania: doesn't show hand 
*** SUMMARY ***
Total pot €0.02 | Rake €0 
Seat 1: Danipro178 (button) folded before Flop (didn't bet)
Seat 2: ThePunisher73 (small blind) folded before Flop
Seat 3: D Tasmania (big blind) collected (€0.02)
Seat 4: MDKristian folded before Flop (didn't bet)
Seat 5: pipinoelbreve9 folded before Flop (didn't bet)
Seat 6: @RobarTevoy99 folded before Flop (didn't bet)



PokerStars Zoom Hand #257607227249:  Hold'em No Limit (€0.01/€0.02) - 2025/09/04 12:33:16 CET [2025/09/04 6:33:16 ET]
Table 'Arneb' 6-max Seat #1 is the button
Seat 1: Zoueleux (€2.46 in chips) 
Seat 2: pipinoelbreve9 (€2.80 in chips) 
Seat 3: mari197721 (€2 in chips) 
Seat 4: burgoa89 (€2.91 in chips) 
Seat 5: sorceline (€1.71 in chips) 
Seat 6: ehbraga (€1.64 in chips) 
pipinoelbreve9: posts small blind €0.01
mari197721: posts big blind €0.02
*** HOLE CARDS ***
Dealt to pipinoelbreve9 [4d Qh]
burgoa89: folds 
sorceline: folds 
ehbraga: folds 
Zoueleux: folds 
pipinoelbreve9: folds 
Uncalled bet (€0.01) returned to mari197721
mari197721 collected €0.02 from pot
mari197721: doesn't show hand 
*** SUMMARY ***
Total pot €0.02 | Rake €0 
Seat 1: Zoueleux (button) folded before Flop (didn't bet)
Seat 2: pipinoelbreve9 (small blind) folded before Flop
Seat 3: mari197721 (big blind) collected (€0.02)
Seat 4: burgoa89 folded before Flop (didn't bet)
Seat 5: sorceline folded before Flop (didn't bet)
Seat 6: ehbraga folded before Flop (didn't bet)



PokerStars Zoom Hand #257607229253:  Hold'em No Limit (€0.01/€0.02) - 2025/09/04 12:33:36 CET [2025/09/04 6:33:36 ET]
Table 'Arneb' 6-max Seat #1 is the button
Seat 1: joanmi_sanchez (€3.47 in chips) 
Seat 2: elseneka-1 (€1.47 in chips) 
Seat 3: DavSnook (€1.25 in chips) 
Seat 4: pipinoelbreve9 (€2.79 in chips) 
Seat 5: FELIPE439 (€3.15 in chips) 
Seat 6: more457 (€0.88 in chips) 
elseneka-1: posts small blind €0.01
DavSnook: posts big blind €0.02
*** HOLE CARDS ***
Dealt to pipinoelbreve9 [Td Kd]
pipinoelbreve9: raises €0.04 to €0.06
FELIPE439: calls €0.06
more457: folds 
joanmi_sanchez: folds 
elseneka-1: folds 
DavSnook: calls €0.04
*** FLOP *** [Qc Jh Ts]
DavSnook: checks 
pipinoelbreve9: bets €0.07
FELIPE439: folds 
DavSnook: calls €0.07
*** TURN *** [Qc Jh Ts] [7h]
DavSnook: checks 
pipinoelbreve9: bets €0.16
DavSnook: folds 
Uncalled bet (€0.16) returned to pipinoelbreve9
pipinoelbreve9 collected €0.31 from pot
pipinoelbreve9: doesn't show hand 
*** SUMMARY ***
Total pot €0.33 | Rake €0.02 
Board [Qc Jh Ts 7h]
Seat 1: joanmi_sanchez (button) folded before Flop (didn't bet)
Seat 2: elseneka-1 (small blind) folded before Flop
Seat 3: DavSnook (big blind) folded on the Turn
Seat 4: pipinoelbreve9 collected (€0.31)
Seat 5: FELIPE439 folded on the Flop
Seat 6: more457 folded before Flop (didn't bet)



PokerStars Zoom Hand #257607234083:  Hold'em No Limit (€0.01/€0.02) - 2025/09/04 12:34:24 CET [2025/09/04 6:34:24 ET]
Table 'Arneb' 6-max Seat #1 is the button
Seat 1: pipinoelbreve9 (€2.97 in chips) 
Seat 2: RMOT100A (€2.47 in chips) 
Seat 3: FELIPE439 (€3.09 in chips) 
Seat 4: grenha1972 (€2.65 in chips) 
Seat 5: Angelo697 (€0.90 in chips) 
Seat 6: DavSnook (€1.12 in chips) 
RMOT100A: posts small blind €0.01
FELIPE439: posts big blind €0.02
*** HOLE CARDS ***
Dealt to pipinoelbreve9 [7d 4c]
grenha1972: folds 
Angelo697: calls €0.02
DavSnook: folds 
pipinoelbreve9: folds 
RMOT100A: calls €0.01
FELIPE439: checks 
*** FLOP *** [Tc 2d 6h]
RMOT100A: bets €0.10
FELIPE439: folds 
Angelo697: folds 
Uncalled bet (€0.10) returned to RMOT100A
RMOT100A collected €0.06 from pot
RMOT100A: doesn't show hand 
*** SUMMARY ***
Total pot €0.06 | Rake €0 
Board [Tc 2d 6h]
Seat 1: pipinoelbreve9 (button) folded before Flop (didn't bet)
Seat 2: RMOT100A (small blind) collected (€0.06)
Seat 3: FELIPE439 (big blind) folded on the Flop
Seat 4: grenha1972 folded before Flop (didn't bet)
Seat 5: Angelo697 folded on the Flop
Seat 6: DavSnook folded before Flop (didn't bet)



PokerStars Zoom Hand #257607234826:  Hold'em No Limit (€0.01/€0.02) - 2025/09/04 12:34:31 CET [2025/09/04 6:34:31 ET]
Table 'Arneb' 6-max Seat #1 is the button
Seat 1: poteaarte (€5.14 in chips) 
Seat 2: aaronroxi (€2.06 in chips) 
Seat 3: Zoueleux (€2.39 in chips) 
Seat 4: Grenaund_ (€2.45 in chips) 
Seat 5: José A. A. (€2.05 in chips) 
Seat 6: pipinoelbreve9 (€2.97 in chips) 
aaronroxi: posts small blind €0.01
Zoueleux: posts big blind €0.02
*** HOLE CARDS ***
Dealt to pipinoelbreve9 [Th 3c]
Grenaund_: folds 
José A. A.: folds 
pipinoelbreve9: folds 
poteaarte: raises €0.04 to €0.06
aaronroxi: folds 
Zoueleux: folds 
Uncalled bet (€0.04) returned to poteaarte
poteaarte collected €0.05 from pot
poteaarte: doesn't show hand 
*** SUMMARY ***
Total pot €0.05 | Rake €0 
Seat 1: poteaarte (button) collected (€0.05)
Seat 2: aaronroxi (small blind) folded before Flop
Seat 3: Zoueleux (big blind) folded before Flop
Seat 4: Grenaund_ folded before Flop (didn't bet)
Seat 5: José A. A. folded before Flop (didn't bet)
Seat 6: pipinoelbreve9 folded before Flop (didn't bet)



PokerStars Zoom Hand #257607236547:  Hold'em No Limit (€0.01/€0.02) - 2025/09/04 12:34:48 CET [2025/09/04 6:34:48 ET]
Table 'Arneb' 6-max Seat #1 is the button
Seat 1: SrLyrox (€6.54 in chips) 
Seat 2: pipinoelbreve9 (€2.95 in chips) 
Seat 3: marcel13013 (€3.19 in chips) 
Seat 4: seriomarkos (€2.28 in chips) 
Seat 5: poteaarte (€2.04 in chips) 
Seat 6: MDKristian (€2.07 in chips) 
pipinoelbreve9: posts small blind €0.01
marcel13013: posts big blind €0.02
*** HOLE CARDS ***
Dealt to pipinoelbreve9 [Ad 7h]
seriomarkos: raises €0.03 to €0.05
poteaarte: folds 
MDKristian: folds 
SrLyrox: folds 
pipinoelbreve9: folds 
marcel13013: folds 
Uncalled bet (€0.03) returned to seriomarkos
seriomarkos collected €0.05 from pot
seriomarkos: doesn't show hand 
*** SUMMARY ***
Total pot €0.05 | Rake €0 
Seat 1: SrLyrox (button) folded before Flop (didn't bet)
Seat 2: pipinoelbreve9 (small blind) folded before Flop
Seat 3: marcel13013 (big blind) folded before Flop
Seat 4: seriomarkos collected (€0.05)
Seat 5: poteaarte folded before Flop (didn't bet)
Seat 6: MDKristian folded before Flop (didn't bet)



PokerStars Zoom Hand #257607235370:  Hold'em No Limit (€0.01/€0.02) - 2025/09/04 12:34:37 CET [2025/09/04 6:34:37 ET]
Table 'Arneb' 6-max Seat #1 is the button
Seat 1: QUIQUE JONES (€0.75 in chips) 
Seat 2: elseneka-1 (€1.47 in chips) 
Seat 3: pipinoelbreve9 (€2.97 in chips) 
Seat 4: seriomarkos (€8.09 in chips) 
Seat 5: DavSnook (€1.12 in chips) 
Seat 6: D Tasmania (€2.11 in chips) 
elseneka-1: posts small blind €0.01
pipinoelbreve9: posts big blind €0.02
*** HOLE CARDS ***
Dealt to pipinoelbreve9 [5d 8h]
seriomarkos: folds 
DavSnook: folds 
D Tasmania: raises €0.03 to €0.05
QUIQUE JONES: folds 
elseneka-1: calls €0.04
pipinoelbreve9: folds 
*** FLOP *** [7s 6h 7h]
elseneka-1: checks 
D Tasmania: checks 
*** TURN *** [7s 6h 7h] [Th]
elseneka-1: bets €0.02
D Tasmania: folds 
Uncalled bet (€0.02) returned to elseneka-1
elseneka-1 collected €0.11 from pot
elseneka-1: doesn't show hand 
*** SUMMARY ***
Total pot €0.12 | Rake €0.01 
Board [7s 6h 7h Th]
Seat 1: QUIQUE JONES (button) folded before Flop (didn't bet)
Seat 2: elseneka-1 (small blind) collected (€0.11)
Seat 3: pipinoelbreve9 (big blind) folded before Flop
Seat 4: seriomarkos folded before Flop (didn't bet)
Seat 5: DavSnook folded before Flop (didn't bet)
Seat 6: D Tasmania folded on the Turn



PokerStars Zoom Hand #257607237722:  Hold'em No Limit (€0.01/€0.02) - 2025/09/04 12:35:00 CET [2025/09/04 6:35:00 ET]
Table 'Arneb' 6-max Seat #1 is the button
Seat 1: FELIPE439 (€2.19 in chips) 
Seat 2: more457 (€1.58 in chips) 
Seat 3: José A. A. (€2.26 in chips) 
Seat 4: burgoa89 (€3.56 in chips) 
Seat 5: pipinoelbreve9 (€2.94 in chips) 
Seat 6: joanmi_sanchez (€3.68 in chips) 
more457: posts small blind €0.01
José A. A.: posts big blind €0.02
*** HOLE CARDS ***
Dealt to pipinoelbreve9 [Ts 5c]
burgoa89: raises €0.04 to €0.06
pipinoelbreve9: folds 
joanmi_sanchez: folds 
FELIPE439: folds 
more457: folds 
José A. A.: folds 
Uncalled bet (€0.04) returned to burgoa89
burgoa89 collected €0.05 from pot
burgoa89: doesn't show hand 
*** SUMMARY ***
Total pot €0.05 | Rake €0 
Seat 1: FELIPE439 (button) folded before Flop (didn't bet)
Seat 2: more457 (small blind) folded before Flop
Seat 3: José A. A. (big blind) folded before Flop
Seat 4: burgoa89 collected (€0.05)
Seat 5: pipinoelbreve9 folded before Flop (didn't bet)
Seat 6: joanmi_sanchez folded before Flop (didn't bet)



PokerStars Zoom Hand #257607238584:  Hold'em No Limit (€0.01/€0.02) - 2025/09/04 12:35:08 CET [2025/09/04 6:35:08 ET]
Table 'Arneb' 6-max Seat #1 is the button
Seat 1: pipinoelbreve9 (€2.94 in chips) 
Seat 2: seriomarkos (€2.74 in chips) 
Seat 3: D Tasmania (€2.06 in chips) 
Seat 4: poteaarte (€5.17 in chips) 
Seat 5: QUIQUE JONES (€0.71 in chips) 
Seat 6: DavSnook (€1.11 in chips) 
seriomarkos: posts small blind €0.01
D Tasmania: posts big blind €0.02
*** HOLE CARDS ***
Dealt to pipinoelbreve9 [Qh Ts]
poteaarte: folds 
QUIQUE JONES: folds 
DavSnook: folds 
pipinoelbreve9: raises €0.04 to €0.06
seriomarkos: folds 
D Tasmania: raises €0.14 to €0.20
pipinoelbreve9: folds 
Uncalled bet (€0.14) returned to D Tasmania
D Tasmania collected €0.13 from pot
D Tasmania: doesn't show hand 
*** SUMMARY ***
Total pot €0.13 | Rake €0 
Seat 1: pipinoelbreve9 (button) folded before Flop
Seat 2: seriomarkos (small blind) folded before Flop
Seat 3: D Tasmania (big blind) collected (€0.13)
Seat 4: poteaarte folded before Flop (didn't bet)
Seat 5: QUIQUE JONES folded before Flop (didn't bet)
Seat 6: DavSnook folded before Flop (didn't bet)



PokerStars Zoom Hand #257607240480:  Hold'em No Limit (€0.01/€0.02) - 2025/09/04 12:35:27 CET [2025/09/04 6:35:27 ET]
Table 'Arneb' 6-max Seat #1 is the button
Seat 1: D Tasmania (€2.13 in chips) 
Seat 2: seriomarkos (€8.10 in chips) 
Seat 3: FELIPE439 (€1.41 in chips) 
Seat 4: QUIQUE JONES (€0.69 in chips) 
Seat 5: burgoa89 (€2.91 in chips) 
Seat 6: pipinoelbreve9 (€2.88 in chips) 
seriomarkos: posts small blind €0.01
FELIPE439: posts big blind €0.02
*** HOLE CARDS ***
Dealt to pipinoelbreve9 [Kc 6h]
QUIQUE JONES: folds 
burgoa89: raises €0.04 to €0.06
pipinoelbreve9: folds 
D Tasmania: folds 
seriomarkos: calls €0.05
FELIPE439: folds 
*** FLOP *** [Qc 7d Kd]
seriomarkos: checks 
burgoa89: checks 
*** TURN *** [Qc 7d Kd] [Ks]
seriomarkos: bets €0.07
burgoa89: folds 
Uncalled bet (€0.07) returned to seriomarkos
seriomarkos collected €0.13 from pot
seriomarkos: doesn't show hand 
*** SUMMARY ***
Total pot €0.14 | Rake €0.01 
Board [Qc 7d Kd Ks]
Seat 1: D Tasmania (button) folded before Flop (didn't bet)
Seat 2: seriomarkos (small blind) collected (€0.13)
Seat 3: FELIPE439 (big blind) folded before Flop
Seat 4: QUIQUE JONES folded before Flop (didn't bet)
Seat 5: burgoa89 folded on the Turn
Seat 6: pipinoelbreve9 folded before Flop (didn't bet)



PokerStars Zoom Hand #257607242347:  Hold'em No Limit (€0.01/€0.02) - 2025/09/04 12:35:45 CET [2025/09/04 6:35:45 ET]
Table 'Arneb' 6-max Seat #1 is the button
Seat 1: D Tasmania (€1.55 in chips) 
Seat 2: poteaarte (€2.38 in chips) 
Seat 3: MDKristian (€2 in chips) 
Seat 4: Isbut (€2.30 in chips) 
Seat 5: pipinoelbreve9 (€2.86 in chips) 
Seat 6: marcel13013 (€3.16 in chips) 
poteaarte: posts small blind €0.01
MDKristian: posts big blind €0.02
*** HOLE CARDS ***
Dealt to pipinoelbreve9 [Jd Tc]
Isbut: folds 
pipinoelbreve9: folds 
marcel13013: folds 
D Tasmania: raises €0.03 to €0.05
poteaarte: folds 
MDKristian: folds 
Uncalled bet (€0.03) returned to D Tasmania
D Tasmania collected €0.05 from pot
D Tasmania: doesn't show hand 
*** SUMMARY ***
Total pot €0.05 | Rake €0 
Seat 1: D Tasmania (button) collected (€0.05)
Seat 2: poteaarte (small blind) folded before Flop
Seat 3: MDKristian (big blind) folded before Flop
Seat 4: Isbut folded before Flop (didn't bet)
Seat 5: pipinoelbreve9 folded before Flop (didn't bet)
Seat 6: marcel13013 folded before Flop (didn't bet)



PokerStars Zoom Hand #257607242950:  Hold'em No Limit (€0.01/€0.02) - 2025/09/04 12:35:51 CET [2025/09/04 6:35:51 ET]
Table 'Arneb' 6-max Seat #1 is the button
Seat 1: poteaarte (€4.46 in chips) 
Seat 2: seriomarkos (€2.18 in chips) 
Seat 3: burgoa89 (€2.85 in chips) 
Seat 4: pipinoelbreve9 (€2.86 in chips) 
Seat 5: MDKristian (€2.06 in chips) 
Seat 6: spoke_6969 (€1.97 in chips) 
seriomarkos: posts small blind €0.01
burgoa89: posts big blind €0.02
*** HOLE CARDS ***
Dealt to pipinoelbreve9 [8d 8h]
pipinoelbreve9: raises €0.04 to €0.06
MDKristian: folds 
spoke_6969: folds 
poteaarte: folds 
seriomarkos: folds 
burgoa89: folds 
Uncalled bet (€0.04) returned to pipinoelbreve9
pipinoelbreve9 collected €0.05 from pot
pipinoelbreve9: doesn't show hand 
*** SUMMARY ***
Total pot €0.05 | Rake €0 
Seat 1: poteaarte (button) folded before Flop (didn't bet)
Seat 2: seriomarkos (small blind) folded before Flop
Seat 3: burgoa89 (big blind) folded before Flop
Seat 4: pipinoelbreve9 collected (€0.05)
Seat 5: MDKristian folded before Flop (didn't bet)
Seat 6: spoke_6969 folded before Flop (didn't bet)



PokerStars Zoom Hand #257607241110:  Hold'em No Limit (€0.01/€0.02) - 2025/09/04 12:35:33 CET [2025/09/04 6:35:33 ET]
Table 'Arneb' 6-max Seat #1 is the button
Seat 1: José A. A. (€2.02 in chips) 
Seat 2: burgoa89 (€2.82 in chips) 
Seat 3: pipinoelbreve9 (€2.88 in chips) 
Seat 4: FELIPE439 (€3.44 in chips) 
Seat 5: D Tasmania (€2.13 in chips) 
Seat 6: @RobarTevoy99 (€1.73 in chips) 
burgoa89: posts small blind €0.01
pipinoelbreve9: posts big blind €0.02
*** HOLE CARDS ***
Dealt to pipinoelbreve9 [Js 4d]
FELIPE439: folds 
D Tasmania: folds 
@RobarTevoy99: raises €0.05 to €0.07
José A. A.: raises €0.13 to €0.20
burgoa89: folds 
pipinoelbreve9: folds 
@RobarTevoy99: raises €1.53 to €1.73 and is all-in
José A. A.: calls €1.53
*** FLOP *** [3h As 2c]
*** TURN *** [3h As 2c] [Qd]
*** RIVER *** [3h As 2c Qd] [6d]
*** SHOW DOWN ***
@RobarTevoy99: shows [7c 7s] (a pair of Sevens)
José A. A.: shows [Ks Ad] (a pair of Aces)
José A. A. collected €3.32 from pot
*** SUMMARY ***
Total pot €3.49 | Rake €0.17 
Board [3h As 2c Qd 6d]
Seat 1: José A. A. (button) showed [Ks Ad] and won (€3.32) with a pair of Aces
Seat 2: burgoa89 (small blind) folded before Flop
Seat 3: pipinoelbreve9 (big blind) folded before Flop
Seat 4: FELIPE439 folded before Flop (didn't bet)
Seat 5: D Tasmania folded before Flop (didn't bet)
Seat 6: @RobarTevoy99 showed [7c 7s] and lost with a pair of Sevens



PokerStars Zoom Hand #257607244605:  Hold'em No Limit (€0.01/€0.02) - 2025/09/04 12:36:07 CET [2025/09/04 6:36:07 ET]
Table 'Arneb' 6-max Seat #1 is the button
Seat 1: poteaarte (€2.02 in chips) 
Seat 2: pipinoelbreve9 (€2.89 in chips) 
Seat 3: DavSnook (€3.04 in chips) 
Seat 4: José A. A. (€3.61 in chips) 
Seat 5: tidji67 (€1.37 in chips) 
Seat 6: MDKristian (€2 in chips) 
pipinoelbreve9: posts small blind €0.01
DavSnook: posts big blind €0.02
*** HOLE CARDS ***
Dealt to pipinoelbreve9 [Kh 7h]
José A. A.: folds 
tidji67: folds 
MDKristian: raises €0.04 to €0.06
poteaarte: folds 
pipinoelbreve9: calls €0.05
DavSnook: folds 
*** FLOP *** [4s Jc Qh]
pipinoelbreve9: bets €0.05
MDKristian: raises €0.12 to €0.17
pipinoelbreve9: folds 
Uncalled bet (€0.12) returned to MDKristian
MDKristian collected €0.23 from pot
MDKristian: doesn't show hand 
*** SUMMARY ***
Total pot €0.24 | Rake €0.01 
Board [4s Jc Qh]
Seat 1: poteaarte (button) folded before Flop (didn't bet)
Seat 2: pipinoelbreve9 (small blind) folded on the Flop
Seat 3: DavSnook (big blind) folded before Flop
Seat 4: José A. A. folded before Flop (didn't bet)
Seat 5: tidji67 folded before Flop (didn't bet)
Seat 6: MDKristian collected (€0.23)



PokerStars Zoom Hand #257607248497:  Hold'em No Limit (€0.01/€0.02) - 2025/09/04 12:36:45 CET [2025/09/04 6:36:45 ET]
Table 'Arneb' 6-max Seat #1 is the button
Seat 1: pipinoelbreve9 (€2.78 in chips) 
Seat 2: patridifusa18 (€1.58 in chips) 
Seat 3: @RobarTevoy99 (€1.09 in chips) 
Seat 4: burgoa89 (€2.90 in chips) 
Seat 5: MDKristian (€2.12 in chips) 
Seat 6: aaronroxi (€2.92 in chips) 
patridifusa18: posts small blind €0.01
@RobarTevoy99: posts big blind €0.02
*** HOLE CARDS ***
Dealt to pipinoelbreve9 [Ts Ac]
burgoa89: folds 
MDKristian: folds 
aaronroxi: raises €0.04 to €0.06
pipinoelbreve9: raises €0.12 to €0.18
patridifusa18: folds 
@RobarTevoy99: folds 
aaronroxi: folds 
Uncalled bet (€0.12) returned to pipinoelbreve9
pipinoelbreve9 collected €0.15 from pot
pipinoelbreve9: doesn't show hand 
*** SUMMARY ***
Total pot €0.15 | Rake €0 
Seat 1: pipinoelbreve9 (button) collected (€0.15)
Seat 2: patridifusa18 (small blind) folded before Flop
Seat 3: @RobarTevoy99 (big blind) folded before Flop
Seat 4: burgoa89 folded before Flop (didn't bet)
Seat 5: MDKristian folded before Flop (didn't bet)
Seat 6: aaronroxi folded before Flop



PokerStars Zoom Hand #257607252695:  Hold'em No Limit (€0.01/€0.02) - 2025/09/04 12:37:27 CET [2025/09/04 6:37:27 ET]
Table 'Arneb' 6-max Seat #1 is the button
Seat 1: burgoa89 (€2 in chips) 
Seat 2: grenha1972 (€2.18 in chips) 
Seat 3: joanmi_sanchez (€3.59 in chips) 
Seat 4: pipinoelbreve9 (€2.87 in chips) 
Seat 5: MDKristian (€2.12 in chips) 
Seat 6: Xenon-FR (€5.50 in chips) 
grenha1972: posts small blind €0.01
joanmi_sanchez: posts big blind €0.02
*** HOLE CARDS ***
Dealt to pipinoelbreve9 [8h 8c]
pipinoelbreve9: raises €0.04 to €0.06
MDKristian: folds 
Xenon-FR: folds 
burgoa89: raises €0.04 to €0.10
grenha1972: folds 
joanmi_sanchez: folds 
pipinoelbreve9: calls €0.04
*** FLOP *** [2h 9s 4s]
pipinoelbreve9: checks 
burgoa89: checks 
*** TURN *** [2h 9s 4s] [7h]
pipinoelbreve9: bets €0.11
burgoa89: folds 
Uncalled bet (€0.11) returned to pipinoelbreve9
pipinoelbreve9 collected €0.22 from pot
pipinoelbreve9: doesn't show hand 
*** SUMMARY ***
Total pot €0.23 | Rake €0.01 
Board [2h 9s 4s 7h]
Seat 1: burgoa89 (button) folded on the Turn
Seat 2: grenha1972 (small blind) folded before Flop
Seat 3: joanmi_sanchez (big blind) folded before Flop
Seat 4: pipinoelbreve9 collected (€0.22)
Seat 5: MDKristian folded before Flop (didn't bet)
Seat 6: Xenon-FR folded before Flop (didn't bet)



PokerStars Zoom Hand #257607256076:  Hold'em No Limit (€0.01/€0.02) - 2025/09/04 12:38:00 CET [2025/09/04 6:38:00 ET]
Table 'Arneb' 6-max Seat #1 is the button
Seat 1: D Tasmania (€2.06 in chips) 
Seat 2: pipinoelbreve9 (€2.99 in chips) 
Seat 3: DavSnook (€1.29 in chips) 
Seat 4: McMack626 (€1.97 in chips) 
Seat 5: Danipro178 (€2 in chips) 
Seat 6: burgoa89 (€1.90 in chips) 
pipinoelbreve9: posts small blind €0.01
DavSnook: posts big blind €0.02
*** HOLE CARDS ***
Dealt to pipinoelbreve9 [9h As]
McMack626: folds 
Danipro178: folds 
burgoa89: folds 
D Tasmania: folds 
pipinoelbreve9: raises €0.04 to €0.06
DavSnook: raises €0.12 to €0.18
pipinoelbreve9: calls €0.12
*** FLOP *** [2d Qh 5h]
pipinoelbreve9: checks 
DavSnook: bets €0.17
pipinoelbreve9: folds 
Uncalled bet (€0.17) returned to DavSnook
DavSnook collected €0.34 from pot
DavSnook: doesn't show hand 
*** SUMMARY ***
Total pot €0.36 | Rake €0.02 
Board [2d Qh 5h]
Seat 1: D Tasmania (button) folded before Flop (didn't bet)
Seat 2: pipinoelbreve9 (small blind) folded on the Flop
Seat 3: DavSnook (big blind) collected (€0.34)
Seat 4: McMack626 folded before Flop (didn't bet)
Seat 5: Danipro178 folded before Flop (didn't bet)
Seat 6: burgoa89 folded before Flop (didn't bet)



PokerStars Zoom Hand #257607260981:  Hold'em No Limit (€0.01/€0.02) - 2025/09/04 12:38:48 CET [2025/09/04 6:38:48 ET]
Table 'Arneb' 6-max Seat #1 is the button
Seat 1: SrLyrox (€6.12 in chips) 
Seat 2: D Tasmania (€2.04 in chips) 
Seat 3: pipinoelbreve9 (€2.81 in chips) 
Seat 4: DavSnook (€1.45 in chips) 
Seat 5: @RobarTevoy99 (€2.21 in chips) 
Seat 6: poteaarte (€4.44 in chips) 
D Tasmania: posts small blind €0.01
pipinoelbreve9: posts big blind €0.02
*** HOLE CARDS ***
Dealt to pipinoelbreve9 [8s 2h]
DavSnook: folds 
@RobarTevoy99: folds 
poteaarte: folds 
SrLyrox: raises €0.04 to €0.06
D Tasmania: folds 
pipinoelbreve9: folds 
Uncalled bet (€0.04) returned to SrLyrox
SrLyrox collected €0.05 from pot
SrLyrox: doesn't show hand 
*** SUMMARY ***
Total pot €0.05 | Rake €0 
Seat 1: SrLyrox (button) collected (€0.05)
Seat 2: D Tasmania (small blind) folded before Flop
Seat 3: pipinoelbreve9 (big blind) folded before Flop
Seat 4: DavSnook folded before Flop (didn't bet)
Seat 5: @RobarTevoy99 folded before Flop (didn't bet)
Seat 6: poteaarte folded before Flop (didn't bet)



PokerStars Zoom Hand #257607262392:  Hold'em No Limit (€0.01/€0.02) - 2025/09/04 12:39:02 CET [2025/09/04 6:39:02 ET]
Table 'Arneb' 6-max Seat #1 is the button
Seat 1: pipinoelbreve9 (€2.79 in chips) 
Seat 2: Penha17213 (€2.04 in chips) 
Seat 3: Danipro178 (€2.02 in chips) 
Seat 4: burgoa89 (€2.66 in chips) 
Seat 5: LaDecimaRAFA (€2 in chips) 
Seat 6: @RobarTevoy99 (€3.69 in chips) 
Penha17213: posts small blind €0.01
Danipro178: posts big blind €0.02
*** HOLE CARDS ***
Dealt to pipinoelbreve9 [4s 8h]
burgoa89: folds 
LaDecimaRAFA: folds 
@RobarTevoy99: folds 
pipinoelbreve9: folds 
Penha17213: raises €0.03 to €0.05
Danipro178: folds 
Uncalled bet (€0.03) returned to Penha17213
Penha17213 collected €0.04 from pot
Penha17213: doesn't show hand 
*** SUMMARY ***
Total pot €0.04 | Rake €0 
Seat 1: pipinoelbreve9 (button) folded before Flop (didn't bet)
Seat 2: Penha17213 (small blind) collected (€0.04)
Seat 3: Danipro178 (big blind) folded before Flop
Seat 4: burgoa89 folded before Flop (didn't bet)
Seat 5: LaDecimaRAFA folded before Flop (didn't bet)
Seat 6: @RobarTevoy99 folded before Flop (didn't bet)



PokerStars Zoom Hand #257607263660:  Hold'em No Limit (€0.01/€0.02) - 2025/09/04 12:39:15 CET [2025/09/04 6:39:15 ET]
Table 'Arneb' 6-max Seat #1 is the button
Seat 1: MDKristian (€2.41 in chips) 
Seat 2: Asensiaco (€3.92 in chips) 
Seat 3: more457 (€0.63 in chips) 
Seat 4: poteaarte (€2.05 in chips) 
Seat 5: pipinoelbreve9 (€2.79 in chips) 
Seat 6: burgoa89 (€2.84 in chips) 
Asensiaco: posts small blind €0.01
more457: posts big blind €0.02
*** HOLE CARDS ***
Dealt to pipinoelbreve9 [7h 9h]
poteaarte: folds 
pipinoelbreve9: folds 
burgoa89: folds 
MDKristian: folds 
Asensiaco: raises €0.04 to €0.06
more457: folds 
Uncalled bet (€0.04) returned to Asensiaco
Asensiaco collected €0.04 from pot
Asensiaco: doesn't show hand 
*** SUMMARY ***
Total pot €0.04 | Rake €0 
Seat 1: MDKristian (button) folded before Flop (didn't bet)
Seat 2: Asensiaco (small blind) collected (€0.04)
Seat 3: more457 (big blind) folded before Flop
Seat 4: poteaarte folded before Flop (didn't bet)
Seat 5: pipinoelbreve9 folded before Flop (didn't bet)
Seat 6: burgoa89 folded before Flop (didn't bet)



PokerStars Zoom Hand #257607264743:  Hold'em No Limit (€0.01/€0.02) - 2025/09/04 12:39:25 CET [2025/09/04 6:39:25 ET]
Table 'Arneb' 6-max Seat #1 is the button
Seat 1: poteaarte (€4.43 in chips) 
Seat 2: pipinoelbreve9 (€2.79 in chips) 
Seat 3: burgoa89 (€2.83 in chips) 
Seat 4: QUIQUE JONES (€0.76 in chips) 
Seat 5: D Tasmania (€2.04 in chips) 
Seat 6: marcel13013 (€4.01 in chips) 
pipinoelbreve9: posts small blind €0.01
burgoa89: posts big blind €0.02
*** HOLE CARDS ***
Dealt to pipinoelbreve9 [2d Jd]
QUIQUE JONES: raises €0.02 to €0.04
D Tasmania: folds 
marcel13013: folds 
poteaarte: folds 
pipinoelbreve9: folds 
burgoa89: folds 
Uncalled bet (€0.02) returned to QUIQUE JONES
QUIQUE JONES collected €0.05 from pot
QUIQUE JONES: doesn't show hand 
*** SUMMARY ***
Total pot €0.05 | Rake €0 
Seat 1: poteaarte (button) folded before Flop (didn't bet)
Seat 2: pipinoelbreve9 (small blind) folded before Flop
Seat 3: burgoa89 (big blind) folded before Flop
Seat 4: QUIQUE JONES collected (€0.05)
Seat 5: D Tasmania folded before Flop (didn't bet)
Seat 6: marcel13013 folded before Flop (didn't bet)



PokerStars Zoom Hand #257607266028:  Hold'em No Limit (€0.01/€0.02) - 2025/09/04 12:39:38 CET [2025/09/04 6:39:38 ET]
Table 'Arneb' 6-max Seat #1 is the button
Seat 1: MDKristian (€2.81 in chips) 
Seat 2: D Tasmania (€2.04 in chips) 
Seat 3: seriomarkos (€7.72 in chips) 
Seat 4: @RobarTevoy99 (€1.86 in chips) 
Seat 5: Danipro178 (€2 in chips) 
Seat 6: pipinoelbreve9 (€2.78 in chips) 
D Tasmania: posts small blind €0.01
seriomarkos: posts big blind €0.02
*** HOLE CARDS ***
Dealt to pipinoelbreve9 [7d 4s]
@RobarTevoy99: folds 
Danipro178: folds 
pipinoelbreve9: folds 
MDKristian: folds 
D Tasmania: folds 
Uncalled bet (€0.01) returned to seriomarkos
seriomarkos collected €0.02 from pot
seriomarkos: doesn't show hand 
*** SUMMARY ***
Total pot €0.02 | Rake €0 
Seat 1: MDKristian (button) folded before Flop (didn't bet)
Seat 2: D Tasmania (small blind) folded before Flop
Seat 3: seriomarkos (big blind) collected (€0.02)
Seat 4: @RobarTevoy99 folded before Flop (didn't bet)
Seat 5: Danipro178 folded before Flop (didn't bet)
Seat 6: pipinoelbreve9 folded before Flop (didn't bet)



PokerStars Zoom Hand #257607260278:  Hold'em No Limit (€0.01/€0.02) - 2025/09/04 12:38:41 CET [2025/09/04 6:38:41 ET]
Table 'Arneb' 6-max Seat #1 is the button
Seat 1: MDKristian (€2.42 in chips) 
Seat 2: LaDecimaRAFA (€2.01 in chips) 
Seat 3: ehbraga (€1 in chips) 
Seat 4: DavSnook (€2.35 in chips) 
Seat 5: mari197721 (€1.56 in chips) 
Seat 6: pipinoelbreve9 (€2.81 in chips) 
LaDecimaRAFA: posts small blind €0.01
ehbraga: posts big blind €0.02
*** HOLE CARDS ***
Dealt to pipinoelbreve9 [Tc 2c]
DavSnook: raises €0.05 to €0.07
mari197721: folds 
pipinoelbreve9: folds 
MDKristian: folds 
LaDecimaRAFA: raises €0.13 to €0.20
ehbraga: calls €0.18
DavSnook: folds 
*** FLOP *** [7s Qs Ac]
LaDecimaRAFA: checks 
ehbraga: checks 
*** TURN *** [7s Qs Ac] [6d]
LaDecimaRAFA: checks 
ehbraga: checks 
*** RIVER *** [7s Qs Ac 6d] [4h]
LaDecimaRAFA: checks 
ehbraga: checks 
*** SHOW DOWN ***
LaDecimaRAFA: shows [Td Ts] (a pair of Tens)
ehbraga: mucks hand 
LaDecimaRAFA collected €0.45 from pot
*** SUMMARY ***
Total pot €0.47 | Rake €0.02 
Board [7s Qs Ac 6d 4h]
Seat 1: MDKristian (button) folded before Flop (didn't bet)
Seat 2: LaDecimaRAFA (small blind) showed [Td Ts] and won (€0.45) with a pair of Tens
Seat 3: ehbraga (big blind) mucked [Kd 9h]
Seat 4: DavSnook folded before Flop
Seat 5: mari197721 folded before Flop (didn't bet)
Seat 6: pipinoelbreve9 folded before Flop (didn't bet)



PokerStars Zoom Hand #257607264152:  Hold'em No Limit (€0.01/€0.02) - 2025/09/04 12:39:20 CET [2025/09/04 6:39:20 ET]
Table 'Arneb' 6-max Seat #1 is the button
Seat 1: DavSnook (€2.26 in chips) 
Seat 2: marcel13013 (€3 in chips) 
Seat 3: elseneka-1 (€1.68 in chips) 
Seat 4: pipinoelbreve9 (€2.79 in chips) 
Seat 5: burgoa89 (€2.66 in chips) 
Seat 6: Penha17213 (€2.06 in chips) 
marcel13013: posts small blind €0.01
elseneka-1: posts big blind €0.02
*** HOLE CARDS ***
Dealt to pipinoelbreve9 [Ad 3c]
pipinoelbreve9: folds 
burgoa89: raises €0.04 to €0.06
Penha17213: folds 
DavSnook: calls €0.06
marcel13013: calls €0.05
elseneka-1: calls €0.04
*** FLOP *** [2s 6c Qs]
marcel13013: checks 
elseneka-1: checks 
burgoa89: checks 
DavSnook: checks 
*** TURN *** [2s 6c Qs] [6s]
marcel13013: checks 
elseneka-1: bets €0.02
burgoa89: folds 
DavSnook: folds 
marcel13013: folds 
Uncalled bet (€0.02) returned to elseneka-1
elseneka-1 collected €0.23 from pot
elseneka-1: doesn't show hand 
*** SUMMARY ***
Total pot €0.24 | Rake €0.01 
Board [2s 6c Qs 6s]
Seat 1: DavSnook (button) folded on the Turn
Seat 2: marcel13013 (small blind) folded on the Turn
Seat 3: elseneka-1 (big blind) collected (€0.23)
Seat 4: pipinoelbreve9 folded before Flop (didn't bet)
Seat 5: burgoa89 folded on the Turn
Seat 6: Penha17213 folded before Flop (didn't bet)



PokerStars Zoom Hand #257607266748:  Hold'em No Limit (€0.01/€0.02) - 2025/09/04 12:39:45 CET [2025/09/04 6:39:45 ET]
Table 'Arneb' 6-max Seat #1 is the button
Seat 1: @RobarTevoy99 (€1.69 in chips) 
Seat 2: poteaarte (€2.08 in chips) 
Seat 3: pipinoelbreve9 (€2.78 in chips) 
Seat 4: joanmi_sanchez (€2.49 in chips) 
Seat 5: QUIQUE JONES (€0.79 in chips) 
Seat 6: marcel13013 (€4.01 in chips) 
poteaarte: posts small blind €0.01
pipinoelbreve9: posts big blind €0.02
*** HOLE CARDS ***
Dealt to pipinoelbreve9 [Kh Qc]
joanmi_sanchez: folds 
QUIQUE JONES: folds 
marcel13013: calls €0.02
@RobarTevoy99: folds 
poteaarte: folds 
pipinoelbreve9: raises €0.08 to €0.10
marcel13013: calls €0.08
*** FLOP *** [9s 6c Ks]
pipinoelbreve9: bets €0.10
marcel13013: folds 
Uncalled bet (€0.10) returned to pipinoelbreve9
pipinoelbreve9 collected €0.20 from pot
pipinoelbreve9: doesn't show hand 
*** SUMMARY ***
Total pot €0.21 | Rake €0.01 
Board [9s 6c Ks]
Seat 1: @RobarTevoy99 (button) folded before Flop (didn't bet)
Seat 2: poteaarte (small blind) folded before Flop
Seat 3: pipinoelbreve9 (big blind) collected (€0.20)
Seat 4: joanmi_sanchez folded before Flop (didn't bet)
Seat 5: QUIQUE JONES folded before Flop (didn't bet)
Seat 6: marcel13013 folded on the Flop



PokerStars Zoom Hand #257607270108:  Hold'em No Limit (€0.01/€0.02) - 2025/09/04 12:40:18 CET [2025/09/04 6:40:18 ET]
Table 'Arneb' 6-max Seat #1 is the button
Seat 1: Danipro178 (€2.68 in chips) 
Seat 2: seriomarkos (€2.16 in chips) 
Seat 3: poteaarte (€2.05 in chips) 
Seat 4: D Tasmania (€2.01 in chips) 
Seat 5: burgoa89 (€2.76 in chips) 
Seat 6: pipinoelbreve9 (€2.88 in chips) 
seriomarkos: posts small blind €0.01
poteaarte: posts big blind €0.02
*** HOLE CARDS ***
Dealt to pipinoelbreve9 [Ah Jd]
D Tasmania: folds 
burgoa89: folds 
pipinoelbreve9: raises €0.04 to €0.06
Danipro178: folds 
seriomarkos: folds 
poteaarte: folds 
Uncalled bet (€0.04) returned to pipinoelbreve9
pipinoelbreve9 collected €0.05 from pot
pipinoelbreve9: doesn't show hand 
*** SUMMARY ***
Total pot €0.05 | Rake €0 
Seat 1: Danipro178 (button) folded before Flop (didn't bet)
Seat 2: seriomarkos (small blind) folded before Flop
Seat 3: poteaarte (big blind) folded before Flop
Seat 4: D Tasmania folded before Flop (didn't bet)
Seat 5: burgoa89 folded before Flop (didn't bet)
Seat 6: pipinoelbreve9 collected (€0.05)



PokerStars Zoom Hand #257607271334:  Hold'em No Limit (€0.01/€0.02) - 2025/09/04 12:40:30 CET [2025/09/04 6:40:30 ET]
Table 'Arneb' 6-max Seat #1 is the button
Seat 1: MDKristian (€2.23 in chips) 
Seat 2: marcel13013 (€2.92 in chips) 
Seat 3: D Tasmania (€1.53 in chips) 
Seat 4: burgoa89 (€2.59 in chips) 
Seat 5: pipinoelbreve9 (€2.91 in chips) 
Seat 6: SrLyrox (€6.41 in chips) 
marcel13013: posts small blind €0.01
D Tasmania: posts big blind €0.02
*** HOLE CARDS ***
Dealt to pipinoelbreve9 [4c 3s]
burgoa89: folds 
pipinoelbreve9: folds 
SrLyrox: folds 
MDKristian: folds 
marcel13013: folds 
Uncalled bet (€0.01) returned to D Tasmania
D Tasmania collected €0.02 from pot
D Tasmania: doesn't show hand 
*** SUMMARY ***
Total pot €0.02 | Rake €0 
Seat 1: MDKristian (button) folded before Flop (didn't bet)
Seat 2: marcel13013 (small blind) folded before Flop
Seat 3: D Tasmania (big blind) collected (€0.02)
Seat 4: burgoa89 folded before Flop (didn't bet)
Seat 5: pipinoelbreve9 folded before Flop (didn't bet)
Seat 6: SrLyrox folded before Flop (didn't bet)



PokerStars Zoom Hand #257607271746:  Hold'em No Limit (€0.01/€0.02) - 2025/09/04 12:40:35 CET [2025/09/04 6:40:35 ET]
Table 'Arneb' 6-max Seat #1 is the button
Seat 1: pipinoelbreve9 (€2.91 in chips) 
Seat 2: poteaarte (€4.28 in chips) 
Seat 3: more457 (€1.60 in chips) 
Seat 4: marcel13013 (€2.91 in chips) 
Seat 5: joanmi_sanchez (€2.49 in chips) 
Seat 6: seriomarkos (€2.65 in chips) 
poteaarte: posts small blind €0.01
more457: posts big blind €0.02
*** HOLE CARDS ***
Dealt to pipinoelbreve9 [Ah Ad]
marcel13013: folds 
joanmi_sanchez: folds 
seriomarkos: folds 
pipinoelbreve9: raises €0.04 to €0.06
poteaarte: folds 
more457: folds 
Uncalled bet (€0.04) returned to pipinoelbreve9
pipinoelbreve9 collected €0.05 from pot
pipinoelbreve9: doesn't show hand 
*** SUMMARY ***
Total pot €0.05 | Rake €0 
Seat 1: pipinoelbreve9 (button) collected (€0.05)
Seat 2: poteaarte (small blind) folded before Flop
Seat 3: more457 (big blind) folded before Flop
Seat 4: marcel13013 folded before Flop (didn't bet)
Seat 5: joanmi_sanchez folded before Flop (didn't bet)
Seat 6: seriomarkos folded before Flop (didn't bet)



PokerStars Zoom Hand #257607274984:  Hold'em No Limit (€0.01/€0.02) - 2025/09/04 12:41:07 CET [2025/09/04 6:41:07 ET]
Table 'Arneb' 6-max Seat #1 is the button
Seat 1: more457 (€1.54 in chips) 
Seat 2: MDKristian (€2 in chips) 
Seat 3: spoke_6969 (€2.72 in chips) 
Seat 4: pipinoelbreve9 (€2.94 in chips) 
Seat 5: SrLyrox (€6.15 in chips) 
Seat 6: ehbraga (€1.68 in chips) 
MDKristian: posts small blind €0.01
spoke_6969: posts big blind €0.02
*** HOLE CARDS ***
Dealt to pipinoelbreve9 [Jc 3h]
pipinoelbreve9: folds 
SrLyrox: folds 
ehbraga: folds 
more457: raises €0.02 to €0.04
MDKristian: folds 
spoke_6969: folds 
Uncalled bet (€0.02) returned to more457
more457 collected €0.05 from pot
more457: doesn't show hand 
*** SUMMARY ***
Total pot €0.05 | Rake €0 
Seat 1: more457 (button) collected (€0.05)
Seat 2: MDKristian (small blind) folded before Flop
Seat 3: spoke_6969 (big blind) folded before Flop
Seat 4: pipinoelbreve9 folded before Flop (didn't bet)
Seat 5: SrLyrox folded before Flop (didn't bet)
Seat 6: ehbraga folded before Flop (didn't bet)



PokerStars Zoom Hand #257607275374:  Hold'em No Limit (€0.01/€0.02) - 2025/09/04 12:41:10 CET [2025/09/04 6:41:10 ET]
Table 'Arneb' 6-max Seat #1 is the button
Seat 1: @RobarTevoy99 (€1.69 in chips) 
Seat 2: pipinoelbreve9 (€2.94 in chips) 
Seat 3: ehbraga (€1.12 in chips) 
Seat 4: ocsur (€2.18 in chips) 
Seat 5: seriomarkos (€2.26 in chips) 
Seat 6: Angelo697 (€0.66 in chips) 
pipinoelbreve9: posts small blind €0.01
ehbraga: posts big blind €0.02
*** HOLE CARDS ***
Dealt to pipinoelbreve9 [4h 8d]
ocsur: folds 
seriomarkos: raises €0.03 to €0.05
Angelo697: calls €0.05
@RobarTevoy99: folds 
pipinoelbreve9: folds 
ehbraga: calls €0.03
*** FLOP *** [4c 7h 6d]
ehbraga: checks 
seriomarkos: bets €0.08
Angelo697: folds 
ehbraga: folds 
Uncalled bet (€0.08) returned to seriomarkos
seriomarkos collected €0.15 from pot
seriomarkos: doesn't show hand 
*** SUMMARY ***
Total pot €0.16 | Rake €0.01 
Board [4c 7h 6d]
Seat 1: @RobarTevoy99 (button) folded before Flop (didn't bet)
Seat 2: pipinoelbreve9 (small blind) folded before Flop
Seat 3: ehbraga (big blind) folded on the Flop
Seat 4: ocsur folded before Flop (didn't bet)
Seat 5: seriomarkos collected (€0.15)
Seat 6: Angelo697 folded on the Flop



PokerStars Zoom Hand #257607277628:  Hold'em No Limit (€0.01/€0.02) - 2025/09/04 12:41:32 CET [2025/09/04 6:41:32 ET]
Table 'Arneb' 6-max Seat #1 is the button
Seat 1: canokiller (€2 in chips) 
Seat 2: MDKristian (€2.24 in chips) 
Seat 3: pipinoelbreve9 (€2.93 in chips) 
Seat 4: @RobarTevoy99 (€3.69 in chips) 
Seat 5: more457 (€1.57 in chips) 
Seat 6: Danipro178 (€2.65 in chips) 
MDKristian: posts small blind €0.01
pipinoelbreve9: posts big blind €0.02
*** HOLE CARDS ***
Dealt to pipinoelbreve9 [Tc 2c]
@RobarTevoy99: folds 
more457: folds 
Danipro178: folds 
canokiller: folds 
MDKristian: folds 
Uncalled bet (€0.01) returned to pipinoelbreve9
pipinoelbreve9 collected €0.02 from pot
pipinoelbreve9: doesn't show hand 
*** SUMMARY ***
Total pot €0.02 | Rake €0 
Seat 1: canokiller (button) folded before Flop (didn't bet)
Seat 2: MDKristian (small blind) folded before Flop
Seat 3: pipinoelbreve9 (big blind) collected (€0.02)
Seat 4: @RobarTevoy99 folded before Flop (didn't bet)
Seat 5: more457 folded before Flop (didn't bet)
Seat 6: Danipro178 folded before Flop (didn't bet)



PokerStars Zoom Hand #257607278657:  Hold'em No Limit (€0.01/€0.02) - 2025/09/04 12:41:42 CET [2025/09/04 6:41:42 ET]
Table 'Arneb' 6-max Seat #1 is the button
Seat 1: pipinoelbreve9 (€2.94 in chips) 
Seat 2: more457 (€1.62 in chips) 
Seat 3: 77samuel33 (€4.31 in chips) 
Seat 4: MDKristian (€2 in chips) 
Seat 5: SrLyrox (€6.47 in chips) 
Seat 6: D Tasmania (€1.49 in chips) 
more457: posts small blind €0.01
77samuel33: posts big blind €0.02
*** HOLE CARDS ***
Dealt to pipinoelbreve9 [5d 8d]
MDKristian: folds 
SrLyrox: folds 
D Tasmania: folds 
pipinoelbreve9: folds 
more457: folds 
Uncalled bet (€0.01) returned to 77samuel33
77samuel33 collected €0.02 from pot
77samuel33: doesn't show hand 
*** SUMMARY ***
Total pot €0.02 | Rake €0 
Seat 1: pipinoelbreve9 (button) folded before Flop (didn't bet)
Seat 2: more457 (small blind) folded before Flop
Seat 3: 77samuel33 (big blind) collected (€0.02)
Seat 4: MDKristian folded before Flop (didn't bet)
Seat 5: SrLyrox folded before Flop (didn't bet)
Seat 6: D Tasmania folded before Flop (didn't bet)



PokerStars Zoom Hand #257607279078:  Hold'em No Limit (€0.01/€0.02) - 2025/09/04 12:41:47 CET [2025/09/04 6:41:47 ET]
Table 'Arneb' 6-max Seat #1 is the button
Seat 1: grenha1972 (€0.83 in chips) 
Seat 2: SrLyrox (€6.03 in chips) 
Seat 3: @RobarTevoy99 (€1.87 in chips) 
Seat 4: D Tasmania (€1.49 in chips) 
Seat 5: pipinoelbreve9 (€2.94 in chips) 
Seat 6: burgoa89 (€2.06 in chips) 
SrLyrox: posts small blind €0.01
@RobarTevoy99: posts big blind €0.02
*** HOLE CARDS ***
Dealt to pipinoelbreve9 [7c 8c]
D Tasmania: raises €0.03 to €0.05
pipinoelbreve9: folds 
burgoa89: folds 
grenha1972: folds 
SrLyrox: folds 
@RobarTevoy99: folds 
Uncalled bet (€0.03) returned to D Tasmania
D Tasmania collected €0.05 from pot
D Tasmania: doesn't show hand 
*** SUMMARY ***
Total pot €0.05 | Rake €0 
Seat 1: grenha1972 (button) folded before Flop (didn't bet)
Seat 2: SrLyrox (small blind) folded before Flop
Seat 3: @RobarTevoy99 (big blind) folded before Flop
Seat 4: D Tasmania collected (€0.05)
Seat 5: pipinoelbreve9 folded before Flop (didn't bet)
Seat 6: burgoa89 folded before Flop (didn't bet)



PokerStars Zoom Hand #257607276630:  Hold'em No Limit (€0.01/€0.02) - 2025/09/04 12:41:23 CET [2025/09/04 6:41:23 ET]
Table 'Arneb' 6-max Seat #1 is the button
Seat 1: Grenaund_ (€5.35 in chips) 
Seat 2: @RobarTevoy99 (€1.69 in chips) 
Seat 3: Penha17213 (€2 in chips) 
Seat 4: seriomarkos (€3.01 in chips) 
Seat 5: more457 (€1.57 in chips) 
Seat 6: pipinoelbreve9 (€2.93 in chips) 
@RobarTevoy99: posts small blind €0.01
Penha17213: posts big blind €0.02
*** HOLE CARDS ***
Dealt to pipinoelbreve9 [3s 4s]
seriomarkos: folds 
more457: folds 
pipinoelbreve9: folds 
Grenaund_: raises €0.02 to €0.04
@RobarTevoy99: folds 
Penha17213: calls €0.02
*** FLOP *** [Js Kc Jc]
Penha17213: checks 
Grenaund_: bets €0.05
Penha17213: calls €0.05
*** TURN *** [Js Kc Jc] [Jd]
Penha17213: checks 
Grenaund_: checks 
*** RIVER *** [Js Kc Jc Jd] [Qh]
Penha17213: bets €0.06
Grenaund_: calls €0.06
*** SHOW DOWN ***
Penha17213: shows [Kh Ts] (a full house, Jacks full of Kings)
Grenaund_: mucks hand 
Penha17213 collected €0.29 from pot
*** SUMMARY ***
Total pot €0.31 | Rake €0.02 
Board [Js Kc Jc Jd Qh]
Seat 1: Grenaund_ (button) mucked [6s 8c]
Seat 2: @RobarTevoy99 (small blind) folded before Flop
Seat 3: Penha17213 (big blind) showed [Kh Ts] and won (€0.29) with a full house, Jacks full of Kings
Seat 4: seriomarkos folded before Flop (didn't bet)
Seat 5: more457 folded before Flop (didn't bet)
Seat 6: pipinoelbreve9 folded before Flop (didn't bet)



PokerStars Zoom Hand #257607279825:  Hold'em No Limit (€0.01/€0.02) - 2025/09/04 12:41:54 CET [2025/09/04 6:41:54 ET]
Table 'Arneb' 6-max Seat #1 is the button
Seat 1: Danipro178 (€2.66 in chips) 
Seat 2: seriomarkos (€7.51 in chips) 
Seat 3: EiramSenpai (€3.59 in chips) 
Seat 4: pipinoelbreve9 (€2.94 in chips) 
Seat 5: poteaarte (€4.49 in chips) 
Seat 6: SrLyrox (€6.47 in chips) 
seriomarkos: posts small blind €0.01
EiramSenpai: posts big blind €0.02
*** HOLE CARDS ***
Dealt to pipinoelbreve9 [Ks 4h]
pipinoelbreve9: folds 
poteaarte: folds 
SrLyrox: folds 
Danipro178: folds 
seriomarkos is disconnected 
seriomarkos has timed out while disconnected
seriomarkos: folds 
Uncalled bet (€0.01) returned to EiramSenpai
EiramSenpai collected €0.02 from pot
EiramSenpai: doesn't show hand 
*** SUMMARY ***
Total pot €0.02 | Rake €0 
Seat 1: Danipro178 (button) folded before Flop (didn't bet)
Seat 2: seriomarkos (small blind) folded before Flop
Seat 3: EiramSenpai (big blind) collected (€0.02)
Seat 4: pipinoelbreve9 folded before Flop (didn't bet)
Seat 5: poteaarte folded before Flop (didn't bet)
Seat 6: SrLyrox folded before Flop (didn't bet)



PokerStars Zoom Hand #257607280281:  Hold'em No Limit (€0.01/€0.02) - 2025/09/04 12:41:58 CET [2025/09/04 6:41:58 ET]
Table 'Arneb' 6-max Seat #1 is the button
Seat 1: LaDecimaRAFA (€2.38 in chips) 
Seat 2: pipinoelbreve9 (€2.94 in chips) 
Seat 3: lorocontento (€1.01 in chips) 
Seat 4: MDKristian (€2.03 in chips) 
Seat 5: ocsur (€2.19 in chips) 
Seat 6: D Tasmania (€1.97 in chips) 
pipinoelbreve9: posts small blind €0.01
lorocontento: posts big blind €0.02
*** HOLE CARDS ***
Dealt to pipinoelbreve9 [Kc 2c]
MDKristian: folds 
ocsur: calls €0.02
D Tasmania: folds 
LaDecimaRAFA: folds 
pipinoelbreve9: calls €0.01
lorocontento: checks 
*** FLOP *** [4h 5c 5h]
pipinoelbreve9: checks 
lorocontento: checks 
ocsur: checks 
*** TURN *** [4h 5c 5h] [Js]
pipinoelbreve9: checks 
lorocontento: bets €0.03
ocsur: folds 
pipinoelbreve9: folds 
Uncalled bet (€0.03) returned to lorocontento
lorocontento collected €0.06 from pot
lorocontento: doesn't show hand 
*** SUMMARY ***
Total pot €0.06 | Rake €0 
Board [4h 5c 5h Js]
Seat 1: LaDecimaRAFA (button) folded before Flop (didn't bet)
Seat 2: pipinoelbreve9 (small blind) folded on the Turn
Seat 3: lorocontento (big blind) collected (€0.06)
Seat 4: MDKristian folded before Flop (didn't bet)
Seat 5: ocsur folded on the Turn
Seat 6: D Tasmania folded before Flop (didn't bet)



PokerStars Zoom Hand #257607285640:  Hold'em No Limit (€0.01/€0.02) - 2025/09/04 12:42:50 CET [2025/09/04 6:42:50 ET]
Table 'Arneb' 6-max Seat #1 is the button
Seat 1: ehbraga (€0.63 in chips) 
Seat 2: MDKristian (€2.32 in chips) 
Seat 3: more457 (€1.59 in chips) 
Seat 4: joanmi_sanchez (€2.46 in chips) 
Seat 5: QUIQUE JONES (€0.52 in chips) 
Seat 6: pipinoelbreve9 (€2.92 in chips) 
MDKristian: posts small blind €0.01
more457: posts big blind €0.02
*** HOLE CARDS ***
Dealt to pipinoelbreve9 [Kh 7h]
joanmi_sanchez: raises €0.03 to €0.05
QUIQUE JONES: folds 
pipinoelbreve9: folds 
ehbraga: folds 
MDKristian: folds 
more457: folds 
Uncalled bet (€0.03) returned to joanmi_sanchez
joanmi_sanchez collected €0.05 from pot
joanmi_sanchez: doesn't show hand 
*** SUMMARY ***
Total pot €0.05 | Rake €0 
Seat 1: ehbraga (button) folded before Flop (didn't bet)
Seat 2: MDKristian (small blind) folded before Flop
Seat 3: more457 (big blind) folded before Flop
Seat 4: joanmi_sanchez collected (€0.05)
Seat 5: QUIQUE JONES folded before Flop (didn't bet)
Seat 6: pipinoelbreve9 folded before Flop (didn't bet)



PokerStars Zoom Hand #257607287102:  Hold'em No Limit (€0.01/€0.02) - 2025/09/04 12:43:04 CET [2025/09/04 6:43:04 ET]
Table 'Arneb' 6-max Seat #1 is the button
Seat 1: lorocontento (€1.03 in chips) 
Seat 2: D Tasmania (€1.57 in chips) 
Seat 3: pipinoelbreve9 (€2.92 in chips) 
Seat 4: @RobarTevoy99 (€1.97 in chips) 
Seat 5: ehbraga (€0.63 in chips) 
Seat 6: LaDecimaRAFA (€2.57 in chips) 
D Tasmania: posts small blind €0.01
pipinoelbreve9: posts big blind €0.02
*** HOLE CARDS ***
Dealt to pipinoelbreve9 [2h Qc]
@RobarTevoy99: folds 
ehbraga: folds 
LaDecimaRAFA: raises €0.03 to €0.05
lorocontento: folds 
D Tasmania: folds 
pipinoelbreve9: folds 
Uncalled bet (€0.03) returned to LaDecimaRAFA
LaDecimaRAFA collected €0.05 from pot
LaDecimaRAFA: doesn't show hand 
*** SUMMARY ***
Total pot €0.05 | Rake €0 
Seat 1: lorocontento (button) folded before Flop (didn't bet)
Seat 2: D Tasmania (small blind) folded before Flop
Seat 3: pipinoelbreve9 (big blind) folded before Flop
Seat 4: @RobarTevoy99 folded before Flop (didn't bet)
Seat 5: ehbraga folded before Flop (didn't bet)
Seat 6: LaDecimaRAFA collected (€0.05)



PokerStars Zoom Hand #257607288081:  Hold'em No Limit (€0.01/€0.02) - 2025/09/04 12:43:13 CET [2025/09/04 6:43:13 ET]
Table 'Arneb' 6-max Seat #1 is the button
Seat 1: joanmi_sanchez (€3.32 in chips) 
Seat 2: grenha1972 (€1.94 in chips) 
Seat 3: McMack626 (€1.86 in chips) 
Seat 4: marcel13013 (€2.82 in chips) 
Seat 5: pipinoelbreve9 (€2.90 in chips) 
Seat 6: ehbraga (€1.21 in chips) 
grenha1972: posts small blind €0.01
McMack626: posts big blind €0.02
*** HOLE CARDS ***
Dealt to pipinoelbreve9 [Js 9s]
marcel13013: folds 
pipinoelbreve9: raises €0.04 to €0.06
ehbraga: raises €0.15 to €0.21
joanmi_sanchez: folds 
grenha1972: folds 
McMack626: folds 
pipinoelbreve9: folds 
Uncalled bet (€0.15) returned to ehbraga
ehbraga collected €0.15 from pot
ehbraga: doesn't show hand 
*** SUMMARY ***
Total pot €0.15 | Rake €0 
Seat 1: joanmi_sanchez (button) folded before Flop (didn't bet)
Seat 2: grenha1972 (small blind) folded before Flop
Seat 3: McMack626 (big blind) folded before Flop
Seat 4: marcel13013 folded before Flop (didn't bet)
Seat 5: pipinoelbreve9 folded before Flop
Seat 6: ehbraga collected (€0.15)



PokerStars Zoom Hand #257607290841:  Hold'em No Limit (€0.01/€0.02) - 2025/09/04 12:43:40 CET [2025/09/04 6:43:40 ET]
Table 'Arneb' 6-max Seat #1 is the button
Seat 1: pipinoelbreve9 (€2.84 in chips) 
Seat 2: QUIQUE JONES (€0.74 in chips) 
Seat 3: DavSnook (€1.94 in chips) 
Seat 4: Asensiaco (€4.32 in chips) 
Seat 5: lorocontento (€1.07 in chips) 
Seat 6: marcel13013 (€2.81 in chips) 
QUIQUE JONES: posts small blind €0.01
DavSnook: posts big blind €0.02
*** HOLE CARDS ***
Dealt to pipinoelbreve9 [6s 9h]
Asensiaco: folds 
lorocontento: folds 
marcel13013: folds 
pipinoelbreve9: folds 
QUIQUE JONES: raises €0.02 to €0.04
DavSnook: folds 
Uncalled bet (€0.02) returned to QUIQUE JONES
QUIQUE JONES collected €0.04 from pot
QUIQUE JONES: doesn't show hand 
*** SUMMARY ***
Total pot €0.04 | Rake €0 
Seat 1: pipinoelbreve9 (button) folded before Flop (didn't bet)
Seat 2: QUIQUE JONES (small blind) collected (€0.04)
Seat 3: DavSnook (big blind) folded before Flop
Seat 4: Asensiaco folded before Flop (didn't bet)
Seat 5: lorocontento folded before Flop (didn't bet)
Seat 6: marcel13013 folded before Flop (didn't bet)



PokerStars Zoom Hand #257607291557:  Hold'em No Limit (€0.01/€0.02) - 2025/09/04 12:43:47 CET [2025/09/04 6:43:47 ET]
Table 'Arneb' 6-max Seat #1 is the button
Seat 1: MDKristian (€2 in chips) 
Seat 2: pipinoelbreve9 (€2.84 in chips) 
Seat 3: lorocontento (€1.07 in chips) 
Seat 4: ciguenza (€2.09 in chips) 
Seat 5: DavSnook (€2.09 in chips) 
Seat 6: joanmi_sanchez (€3.31 in chips) 
pipinoelbreve9: posts small blind €0.01
lorocontento: posts big blind €0.02
*** HOLE CARDS ***
Dealt to pipinoelbreve9 [Jh 2s]
ciguenza: folds 
DavSnook: raises €0.05 to €0.07
joanmi_sanchez: folds 
MDKristian: folds 
pipinoelbreve9: folds 
lorocontento: folds 
Uncalled bet (€0.05) returned to DavSnook
DavSnook collected €0.05 from pot
DavSnook: doesn't show hand 
*** SUMMARY ***
Total pot €0.05 | Rake €0 
Seat 1: MDKristian (button) folded before Flop (didn't bet)
Seat 2: pipinoelbreve9 (small blind) folded before Flop
Seat 3: lorocontento (big blind) folded before Flop
Seat 4: ciguenza folded before Flop (didn't bet)
Seat 5: DavSnook collected (€0.05)
Seat 6: joanmi_sanchez folded before Flop (didn't bet)



PokerStars Zoom Hand #257607292492:  Hold'em No Limit (€0.01/€0.02) - 2025/09/04 12:43:56 CET [2025/09/04 6:43:56 ET]
Table 'Arneb' 6-max Seat #1 is the button
Seat 1: Asensiaco (€4.30 in chips) 
Seat 2: lorocontento (€1.05 in chips) 
Seat 3: pipinoelbreve9 (€2.83 in chips) 
Seat 4: MDKristian (€2.25 in chips) 
Seat 5: Hemoro89 (€1.01 in chips) 
Seat 6: LaDecimaRAFA (€2.38 in chips) 
lorocontento: posts small blind €0.01
pipinoelbreve9: posts big blind €0.02
*** HOLE CARDS ***
Dealt to pipinoelbreve9 [2h Ac]
MDKristian: folds 
Hemoro89: folds 
LaDecimaRAFA: folds 
Asensiaco: folds 
lorocontento: folds 
Uncalled bet (€0.01) returned to pipinoelbreve9
pipinoelbreve9 collected €0.02 from pot
pipinoelbreve9: doesn't show hand 
*** SUMMARY ***
Total pot €0.02 | Rake €0 
Seat 1: Asensiaco (button) folded before Flop (didn't bet)
Seat 2: lorocontento (small blind) folded before Flop
Seat 3: pipinoelbreve9 (big blind) collected (€0.02)
Seat 4: MDKristian folded before Flop (didn't bet)
Seat 5: Hemoro89 folded before Flop (didn't bet)
Seat 6: LaDecimaRAFA folded before Flop (didn't bet)



PokerStars Zoom Hand #257607290335:  Hold'em No Limit (€0.01/€0.02) - 2025/09/04 12:43:35 CET [2025/09/04 6:43:35 ET]
Table 'Arneb' 6-max Seat #1 is the button
Seat 1: canokiller (€2.09 in chips) 
Seat 2: ehbraga (€0.73 in chips) 
Seat 3: marcel13013 (€3.87 in chips) 
Seat 4: pipinoelbreve9 (€2.84 in chips) 
Seat 5: SrLyrox (€6.14 in chips) 
Seat 6: damastodas (€2.52 in chips) 
ehbraga: posts small blind €0.01
marcel13013: posts big blind €0.02
*** HOLE CARDS ***
Dealt to pipinoelbreve9 [Th 4h]
pipinoelbreve9: folds 
SrLyrox: folds 
damastodas: folds 
canokiller: raises €0.03 to €0.05
ehbraga: raises €0.12 to €0.17
marcel13013: calls €0.15
canokiller: calls €0.12
*** FLOP *** [Js Qs 9c]
ehbraga: bets €0.24
marcel13013: folds 
canokiller: folds 
Uncalled bet (€0.24) returned to ehbraga
ehbraga collected €0.48 from pot
ehbraga: doesn't show hand 
*** SUMMARY ***
Total pot €0.51 | Rake €0.03 
Board [Js Qs 9c]
Seat 1: canokiller (button) folded on the Flop
Seat 2: ehbraga (small blind) collected (€0.48)
Seat 3: marcel13013 (big blind) folded on the Flop
Seat 4: pipinoelbreve9 folded before Flop (didn't bet)
Seat 5: SrLyrox folded before Flop (didn't bet)
Seat 6: damastodas folded before Flop (didn't bet)



PokerStars Zoom Hand #257607293450:  Hold'em No Limit (€0.01/€0.02) - 2025/09/04 12:44:05 CET [2025/09/04 6:44:05 ET]
Table 'Arneb' 6-max Seat #1 is the button
Seat 1: canokiller (€2 in chips) 
Seat 2: 77samuel33 (€7.06 in chips) 
Seat 3: mari197721 (€1.47 in chips) 
Seat 4: Danipro178 (€2 in chips) 
Seat 5: DavSnook (€1.93 in chips) 
Seat 6: pipinoelbreve9 (€2.84 in chips) 
77samuel33: posts small blind €0.01
mari197721: posts big blind €0.02
*** HOLE CARDS ***
Dealt to pipinoelbreve9 [9s Jh]
Danipro178: folds 
DavSnook: folds 
pipinoelbreve9: folds 
canokiller: folds 
77samuel33: raises €0.04 to €0.06
mari197721: raises €0.12 to €0.18
77samuel33: calls €0.12
*** FLOP *** [9c 8c Kd]
77samuel33: bets €0.12
mari197721: folds 
Uncalled bet (€0.12) returned to 77samuel33
77samuel33 collected €0.34 from pot
77samuel33: doesn't show hand 
*** SUMMARY ***
Total pot €0.36 | Rake €0.02 
Board [9c 8c Kd]
Seat 1: canokiller (button) folded before Flop (didn't bet)
Seat 2: 77samuel33 (small blind) collected (€0.34)
Seat 3: mari197721 (big blind) folded on the Flop
Seat 4: Danipro178 folded before Flop (didn't bet)
Seat 5: DavSnook folded before Flop (didn't bet)
Seat 6: pipinoelbreve9 folded before Flop (didn't bet)



PokerStars Zoom Hand #257607294804:  Hold'em No Limit (€0.01/€0.02) - 2025/09/04 12:44:19 CET [2025/09/04 6:44:19 ET]
Table 'Arneb' 6-max Seat #1 is the button
Seat 1: pipinoelbreve9 (€2.84 in chips) 
Seat 2: marcel13013 (€3.70 in chips) 
Seat 3: canokiller (€2 in chips) 
Seat 4: spoke_6969 (€2.85 in chips) 
Seat 5: @RobarTevoy99 (€1.98 in chips) 
Seat 6: poteaarte (€6.14 in chips) 
marcel13013: posts small blind €0.01
canokiller: posts big blind €0.02
*** HOLE CARDS ***
Dealt to pipinoelbreve9 [9h 5h]
spoke_6969: raises €0.03 to €0.05
@RobarTevoy99: folds 
poteaarte: folds 
pipinoelbreve9: folds 
marcel13013: calls €0.04
canokiller: folds 
*** FLOP *** [7c 6h Kc]
marcel13013: bets €0.02
spoke_6969: calls €0.02
*** TURN *** [7c 6h Kc] [Kh]
marcel13013: bets €0.08
spoke_6969: calls €0.08
*** RIVER *** [7c 6h Kc Kh] [As]
marcel13013: bets €0.15
spoke_6969: folds 
Uncalled bet (€0.15) returned to marcel13013
marcel13013 collected €0.30 from pot
marcel13013: doesn't show hand 
*** SUMMARY ***
Total pot €0.32 | Rake €0.02 
Board [7c 6h Kc Kh As]
Seat 1: pipinoelbreve9 (button) folded before Flop (didn't bet)
Seat 2: marcel13013 (small blind) collected (€0.30)
Seat 3: canokiller (big blind) folded before Flop
Seat 4: spoke_6969 folded on the River
Seat 5: @RobarTevoy99 folded before Flop (didn't bet)
Seat 6: poteaarte folded before Flop (didn't bet)



PokerStars Zoom Hand #257607295566:  Hold'em No Limit (€0.01/€0.02) - 2025/09/04 12:44:26 CET [2025/09/04 6:44:26 ET]
Table 'Arneb' 6-max Seat #1 is the button
Seat 1: SrLyrox (€5.78 in chips) 
Seat 2: ocsur (€2.17 in chips) 
Seat 3: D Tasmania (€1.91 in chips) 
Seat 4: pipinoelbreve9 (€2.84 in chips) 
Seat 5: 77samuel33 (€2.43 in chips) 
Seat 6: LaDecimaRAFA (€2.53 in chips) 
ocsur: posts small blind €0.01
D Tasmania: posts big blind €0.02
*** HOLE CARDS ***
Dealt to pipinoelbreve9 [7s Tc]
pipinoelbreve9: folds 
77samuel33: raises €0.04 to €0.06
LaDecimaRAFA: folds 
SrLyrox: folds 
ocsur: folds 
D Tasmania: calls €0.04
*** FLOP *** [9s Jh 8s]
D Tasmania: checks 
77samuel33: bets €0.09
D Tasmania: folds 
Uncalled bet (€0.09) returned to 77samuel33
77samuel33 collected €0.12 from pot
77samuel33: doesn't show hand 
*** SUMMARY ***
Total pot €0.13 | Rake €0.01 
Board [9s Jh 8s]
Seat 1: SrLyrox (button) folded before Flop (didn't bet)
Seat 2: ocsur (small blind) folded before Flop
Seat 3: D Tasmania (big blind) folded on the Flop
Seat 4: pipinoelbreve9 folded before Flop (didn't bet)
Seat 5: 77samuel33 collected (€0.12)
Seat 6: LaDecimaRAFA folded before Flop (didn't bet)



PokerStars Zoom Hand #257607295953:  Hold'em No Limit (€0.01/€0.02) - 2025/09/04 12:44:30 CET [2025/09/04 6:44:30 ET]
Table 'Arneb' 6-max Seat #1 is the button
Seat 1: poteaarte (€4.34 in chips) 
Seat 2: SrLyrox (€5.78 in chips) 
Seat 3: pipinoelbreve9 (€2.84 in chips) 
Seat 4: joanmi_sanchez (€2.36 in chips) 
Seat 5: grenha1972 (€2.06 in chips) 
Seat 6: QUIQUE JONES (€0.77 in chips) 
SrLyrox: posts small blind €0.01
pipinoelbreve9: posts big blind €0.02
*** HOLE CARDS ***
Dealt to pipinoelbreve9 [3c Td]
joanmi_sanchez: folds 
grenha1972: folds 
QUIQUE JONES: raises €0.02 to €0.04
poteaarte: folds 
SrLyrox: calls €0.03
pipinoelbreve9: folds 
*** FLOP *** [3h Ad 5c]
SrLyrox: checks 
QUIQUE JONES: checks 
*** TURN *** [3h Ad 5c] [Ts]
SrLyrox: bets €0.08
QUIQUE JONES: folds 
Uncalled bet (€0.08) returned to SrLyrox
SrLyrox collected €0.10 from pot
SrLyrox: doesn't show hand 
*** SUMMARY ***
Total pot €0.10 | Rake €0 
Board [3h Ad 5c Ts]
Seat 1: poteaarte (button) folded before Flop (didn't bet)
Seat 2: SrLyrox (small blind) collected (€0.10)
Seat 3: pipinoelbreve9 (big blind) folded before Flop
Seat 4: joanmi_sanchez folded before Flop (didn't bet)
Seat 5: grenha1972 folded before Flop (didn't bet)
Seat 6: QUIQUE JONES folded on the Turn



PokerStars Zoom Hand #257607293874:  Hold'em No Limit (€0.01/€0.02) - 2025/09/04 12:44:09 CET [2025/09/04 6:44:09 ET]
Table 'Arneb' 6-max Seat #1 is the button
Seat 1: ehbraga (€1.04 in chips) 
Seat 2: poteaarte (€4.16 in chips) 
Seat 3: joanmi_sanchez (€3.33 in chips) 
Seat 4: canokiller (€2 in chips) 
Seat 5: pipinoelbreve9 (€2.84 in chips) 
Seat 6: Grenaund_ (€5.87 in chips) 
poteaarte: posts small blind €0.01
joanmi_sanchez: posts big blind €0.02
*** HOLE CARDS ***
Dealt to pipinoelbreve9 [Qd 8h]
canokiller: folds 
pipinoelbreve9: folds 
Grenaund_: raises €0.02 to €0.04
ehbraga: calls €0.04
poteaarte: folds 
joanmi_sanchez: folds 
*** FLOP *** [8s 3s 3c]
Grenaund_: checks 
ehbraga: checks 
*** TURN *** [8s 3s 3c] [2s]
Grenaund_: checks 
ehbraga: bets €0.10
Grenaund_: folds 
Uncalled bet (€0.10) returned to ehbraga
ehbraga collected €0.10 from pot
ehbraga: doesn't show hand 
*** SUMMARY ***
Total pot €0.11 | Rake €0.01 
Board [8s 3s 3c 2s]
Seat 1: ehbraga (button) collected (€0.10)
Seat 2: poteaarte (small blind) folded before Flop
Seat 3: joanmi_sanchez (big blind) folded before Flop
Seat 4: canokiller folded before Flop (didn't bet)
Seat 5: pipinoelbreve9 folded before Flop (didn't bet)
Seat 6: Grenaund_ folded on the Turn



PokerStars Zoom Hand #257607297872:  Hold'em No Limit (€0.01/€0.02) - 2025/09/04 12:44:49 CET [2025/09/04 6:44:49 ET]
Table 'Arneb' 6-max Seat #1 is the button
Seat 1: canokiller (€2 in chips) 
Seat 2: marcel13013 (€2.77 in chips) 
Seat 3: 77samuel33 (€4.34 in chips) 
Seat 4: MDKristian (€2.28 in chips) 
Seat 5: poteaarte (€2.93 in chips) 
Seat 6: pipinoelbreve9 (€2.81 in chips) 
marcel13013: posts small blind €0.01
77samuel33: posts big blind €0.02
*** HOLE CARDS ***
Dealt to pipinoelbreve9 [Ad 2d]
MDKristian: folds 
poteaarte: folds 
pipinoelbreve9: raises €0.04 to €0.06
canokiller: folds 
marcel13013: folds 
77samuel33: calls €0.04
*** FLOP *** [4d 8s Qd]
77samuel33: checks 
pipinoelbreve9: checks 
*** TURN *** [4d 8s Qd] [As]
77samuel33: checks 
pipinoelbreve9: bets €0.06
77samuel33: folds 
Uncalled bet (€0.06) returned to pipinoelbreve9
pipinoelbreve9 collected €0.12 from pot
pipinoelbreve9: doesn't show hand 
*** SUMMARY ***
Total pot €0.13 | Rake €0.01 
Board [4d 8s Qd As]
Seat 1: canokiller (button) folded before Flop (didn't bet)
Seat 2: marcel13013 (small blind) folded before Flop
Seat 3: 77samuel33 (big blind) folded on the Turn
Seat 4: MDKristian folded before Flop (didn't bet)
Seat 5: poteaarte folded before Flop (didn't bet)
Seat 6: pipinoelbreve9 collected (€0.12)



PokerStars Zoom Hand #257607297084:  Hold'em No Limit (€0.01/€0.02) - 2025/09/04 12:44:41 CET [2025/09/04 6:44:41 ET]
Table 'Arneb' 6-max Seat #1 is the button
Seat 1: more457 (€1.72 in chips) 
Seat 2: pipinoelbreve9 (€2.82 in chips) 
Seat 3: D Tasmania (€1.94 in chips) 
Seat 4: marcel13013 (€2.77 in chips) 
Seat 5: Xplotas (€2.96 in chips) 
Seat 6: MDKristian (€2 in chips) 
pipinoelbreve9: posts small blind €0.01
D Tasmania: posts big blind €0.02
*** HOLE CARDS ***
Dealt to pipinoelbreve9 [Jd 6c]
marcel13013: folds 
Xplotas: raises €0.02 to €0.04
MDKristian: folds 
more457: calls €0.04
pipinoelbreve9: folds 
D Tasmania: folds 
*** FLOP *** [Th Jc Qh]
Xplotas: bets €0.06
more457: calls €0.06
*** TURN *** [Th Jc Qh] [Ad]
Xplotas: checks 
more457: checks 
*** RIVER *** [Th Jc Qh Ad] [9h]
Xplotas: bets €0.22
more457: folds 
Uncalled bet (€0.22) returned to Xplotas
Xplotas collected €0.22 from pot
Xplotas: doesn't show hand 
*** SUMMARY ***
Total pot €0.23 | Rake €0.01 
Board [Th Jc Qh Ad 9h]
Seat 1: more457 (button) folded on the River
Seat 2: pipinoelbreve9 (small blind) folded before Flop
Seat 3: D Tasmania (big blind) folded before Flop
Seat 4: marcel13013 folded before Flop (didn't bet)
Seat 5: Xplotas collected (€0.22)
Seat 6: MDKristian folded before Flop (didn't bet)



PokerStars Zoom Hand #257607301982:  Hold'em No Limit (€0.01/€0.02) - 2025/09/04 12:45:29 CET [2025/09/04 6:45:29 ET]
Table 'Arneb' 6-max Seat #1 is the button
Seat 1: pipinoelbreve9 (€2.87 in chips) 
Seat 2: Grenaund_ (€5.83 in chips) 
Seat 3: Danipro178 (€2.03 in chips) 
Seat 4: 77samuel33 (€4.94 in chips) 
Seat 5: ehbraga (€1.08 in chips) 
Seat 6: ocsur (€2.14 in chips) 
Grenaund_: posts small blind €0.01
Danipro178: posts big blind €0.02
*** HOLE CARDS ***
Dealt to pipinoelbreve9 [Ac Ad]
77samuel33: folds 
ehbraga: folds 
ocsur: folds 
pipinoelbreve9: raises €0.04 to €0.06
Grenaund_: folds 
Danipro178: folds 
Uncalled bet (€0.04) returned to pipinoelbreve9
pipinoelbreve9 collected €0.05 from pot
pipinoelbreve9: doesn't show hand 
*** SUMMARY ***
Total pot €0.05 | Rake €0 
Seat 1: pipinoelbreve9 (button) collected (€0.05)
Seat 2: Grenaund_ (small blind) folded before Flop
Seat 3: Danipro178 (big blind) folded before Flop
Seat 4: 77samuel33 folded before Flop (didn't bet)
Seat 5: ehbraga folded before Flop (didn't bet)
Seat 6: ocsur folded before Flop (didn't bet)



PokerStars Zoom Hand #257607303858:  Hold'em No Limit (€0.01/€0.02) - 2025/09/04 12:45:47 CET [2025/09/04 6:45:47 ET]
Table 'Arneb' 6-max Seat #1 is the button
Seat 1: D Tasmania (€1.91 in chips) 
Seat 2: marcel13013 (€3.81 in chips) 
Seat 3: Hemoro89 (€1.10 in chips) 
Seat 4: more457 (€1.62 in chips) 
Seat 5: pipinoelbreve9 (€2.90 in chips) 
Seat 6: ehbraga (€0.84 in chips) 
marcel13013: posts small blind €0.01
Hemoro89: posts big blind €0.02
*** HOLE CARDS ***
Dealt to pipinoelbreve9 [4h 5d]
more457: folds 
pipinoelbreve9: folds 
ehbraga: folds 
D Tasmania: folds 
marcel13013: folds 
Uncalled bet (€0.01) returned to Hemoro89
Hemoro89 collected €0.02 from pot
Hemoro89: doesn't show hand 
*** SUMMARY ***
Total pot €0.02 | Rake €0 
Seat 1: D Tasmania (button) folded before Flop (didn't bet)
Seat 2: marcel13013 (small blind) folded before Flop
Seat 3: Hemoro89 (big blind) collected (€0.02)
Seat 4: more457 folded before Flop (didn't bet)
Seat 5: pipinoelbreve9 folded before Flop (didn't bet)
Seat 6: ehbraga folded before Flop (didn't bet)



PokerStars Zoom Hand #257607304485:  Hold'em No Limit (€0.01/€0.02) - 2025/09/04 12:45:54 CET [2025/09/04 6:45:54 ET]
Table 'Arneb' 6-max Seat #1 is the button
Seat 1: poteaarte (€4.34 in chips) 
Seat 2: Danipro178 (€2.01 in chips) 
Seat 3: more457 (€1.09 in chips) 
Seat 4: pipinoelbreve9 (€2.90 in chips) 
Seat 5: ehbraga (€0.84 in chips) 
Seat 6: 77samuel33 (€7.23 in chips) 
Danipro178: posts small blind €0.01
more457: posts big blind €0.02
*** HOLE CARDS ***
Dealt to pipinoelbreve9 [Qd Ts]
pipinoelbreve9: folds 
ehbraga: folds 
77samuel33: folds 
poteaarte: folds 
Danipro178: folds 
Uncalled bet (€0.01) returned to more457
more457 collected €0.02 from pot
more457: doesn't show hand 
*** SUMMARY ***
Total pot €0.02 | Rake €0 
Seat 1: poteaarte (button) folded before Flop (didn't bet)
Seat 2: Danipro178 (small blind) folded before Flop
Seat 3: more457 (big blind) collected (€0.02)
Seat 4: pipinoelbreve9 folded before Flop (didn't bet)
Seat 5: ehbraga folded before Flop (didn't bet)
Seat 6: 77samuel33 folded before Flop (didn't bet)



PokerStars Zoom Hand #257607305423:  Hold'em No Limit (€0.01/€0.02) - 2025/09/04 12:46:02 CET [2025/09/04 6:46:02 ET]
Table 'Arneb' 6-max Seat #1 is the button
Seat 1: lorocontento (€1.33 in chips) 
Seat 2: canokiller (€2.03 in chips) 
Seat 3: pipinoelbreve9 (€2.89 in chips) 
Seat 4: MDKristian (€2.06 in chips) 
Seat 5: D Tasmania (€1.91 in chips) 
Seat 6: mari197721 (€1.80 in chips) 
canokiller: posts small blind €0.01
pipinoelbreve9: posts big blind €0.02
*** HOLE CARDS ***
Dealt to pipinoelbreve9 [Kc 8d]
MDKristian: folds 
D Tasmania: folds 
mari197721: folds 
lorocontento: folds 
canokiller: folds 
Uncalled bet (€0.01) returned to pipinoelbreve9
pipinoelbreve9 collected €0.02 from pot
pipinoelbreve9: doesn't show hand 
*** SUMMARY ***
Total pot €0.02 | Rake €0 
Seat 1: lorocontento (button) folded before Flop (didn't bet)
Seat 2: canokiller (small blind) folded before Flop
Seat 3: pipinoelbreve9 (big blind) collected (€0.02)
Seat 4: MDKristian folded before Flop (didn't bet)
Seat 5: D Tasmania folded before Flop (didn't bet)
Seat 6: mari197721 folded before Flop (didn't bet)



PokerStars Zoom Hand #257607306318:  Hold'em No Limit (€0.01/€0.02) - 2025/09/04 12:46:11 CET [2025/09/04 6:46:11 ET]
Table 'Arneb' 6-max Seat #1 is the button
Seat 1: pipinoelbreve9 (€2.90 in chips) 
Seat 2: poteaarte (€4.34 in chips) 
Seat 3: DavSnook (€4.36 in chips) 
Seat 4: grenha1972 (€1.63 in chips) 
Seat 5: mari197721 (€1.80 in chips) 
Seat 6: more457 (€1.45 in chips) 
poteaarte: posts small blind €0.01
DavSnook: posts big blind €0.02
*** HOLE CARDS ***
Dealt to pipinoelbreve9 [6h 3d]
grenha1972: raises €0.05 to €0.07
mari197721: calls €0.07
more457: calls €0.07
pipinoelbreve9: folds 
poteaarte: calls €0.06
DavSnook: calls €0.05
*** FLOP *** [Ah 6d Kd]
poteaarte: checks 
DavSnook: checks 
grenha1972: bets €1.56 and is all-in
mari197721: folds 
more457: folds 
poteaarte: folds 
DavSnook: folds 
Uncalled bet (€1.56) returned to grenha1972
grenha1972 collected €0.33 from pot
grenha1972: doesn't show hand 
*** SUMMARY ***
Total pot €0.35 | Rake €0.02 
Board [Ah 6d Kd]
Seat 1: pipinoelbreve9 (button) folded before Flop (didn't bet)
Seat 2: poteaarte (small blind) folded on the Flop
Seat 3: DavSnook (big blind) folded on the Flop
Seat 4: grenha1972 collected (€0.33)
Seat 5: mari197721 folded on the Flop
Seat 6: more457 folded on the Flop



PokerStars Zoom Hand #257607304911:  Hold'em No Limit (€0.01/€0.02) - 2025/09/04 12:45:58 CET [2025/09/04 6:45:58 ET]
Table 'Arneb' 6-max Seat #1 is the button
Seat 1: more457 (€1.45 in chips) 
Seat 2: pipinoelbreve9 (€2.90 in chips) 
Seat 3: grenha1972 (€1.65 in chips) 
Seat 4: damastodas (€1.57 in chips) 
Seat 5: DavSnook (€4.36 in chips) 
Seat 6: @RobarTevoy99 (€2.12 in chips) 
pipinoelbreve9: posts small blind €0.01
grenha1972: posts big blind €0.02
*** HOLE CARDS ***
Dealt to pipinoelbreve9 [9c 4d]
damastodas: calls €0.02
DavSnook: folds 
@RobarTevoy99: raises €0.07 to €0.09
more457: folds 
pipinoelbreve9: folds 
grenha1972: folds 
damastodas: calls €0.07
*** FLOP *** [As 2c 8c]
damastodas: checks 
@RobarTevoy99: bets €0.10
damastodas: calls €0.10
*** TURN *** [As 2c 8c] [Js]
damastodas: checks 
@RobarTevoy99: bets €0.26
damastodas: calls €0.26
*** RIVER *** [As 2c 8c Js] [9s]
damastodas: checks 
@RobarTevoy99: checks 
*** SHOW DOWN ***
damastodas: shows [Ah 6d] (a pair of Aces)
@RobarTevoy99: shows [Ac Qd] (a pair of Aces - Queen kicker)
@RobarTevoy99 collected €0.88 from pot
*** SUMMARY ***
Total pot €0.93 | Rake €0.05 
Board [As 2c 8c Js 9s]
Seat 1: more457 (button) folded before Flop (didn't bet)
Seat 2: pipinoelbreve9 (small blind) folded before Flop
Seat 3: grenha1972 (big blind) folded before Flop
Seat 4: damastodas showed [Ah 6d] and lost with a pair of Aces
Seat 5: DavSnook folded before Flop (didn't bet)
Seat 6: @RobarTevoy99 showed [Ac Qd] and won (€0.88) with a pair of Aces



PokerStars Zoom Hand #257607309314:  Hold'em No Limit (€0.01/€0.02) - 2025/09/04 12:46:39 CET [2025/09/04 6:46:39 ET]
Table 'Arneb' 6-max Seat #1 is the button
Seat 1: MDKristian (€2.10 in chips) 
Seat 2: pipinoelbreve9 (€2.90 in chips) 
Seat 3: poteaarte (€4.27 in chips) 
Seat 4: Hemoro89 (€1.08 in chips) 
Seat 5: lorocontento (€1.30 in chips) 
Seat 6: LaDecimaRAFA (€2.27 in chips) 
pipinoelbreve9: posts small blind €0.01
poteaarte: posts big blind €0.02
*** HOLE CARDS ***
Dealt to pipinoelbreve9 [5s 2c]
Hemoro89: folds 
lorocontento: folds 
LaDecimaRAFA: folds 
MDKristian: folds 
pipinoelbreve9: folds 
Uncalled bet (€0.01) returned to poteaarte
poteaarte collected €0.02 from pot
poteaarte: doesn't show hand 
*** SUMMARY ***
Total pot €0.02 | Rake €0 
Seat 1: MDKristian (button) folded before Flop (didn't bet)
Seat 2: pipinoelbreve9 (small blind) folded before Flop
Seat 3: poteaarte (big blind) collected (€0.02)
Seat 4: Hemoro89 folded before Flop (didn't bet)
Seat 5: lorocontento folded before Flop (didn't bet)
Seat 6: LaDecimaRAFA folded before Flop (didn't bet)



PokerStars Zoom Hand #257607308527:  Hold'em No Limit (€0.01/€0.02) - 2025/09/04 12:46:32 CET [2025/09/04 6:46:32 ET]
Table 'Arneb' 6-max Seat #1 is the button
Seat 1: ocsur (€2.09 in chips) 
Seat 2: poteaarte (€6.48 in chips) 
Seat 3: Danipro178 (€2.09 in chips) 
Seat 4: pipinoelbreve9 (€2.90 in chips) 
Seat 5: marcel13013 (€2.02 in chips) 
Seat 6: QUIQUE JONES (€0.75 in chips) 
poteaarte: posts small blind €0.01
Danipro178: posts big blind €0.02
*** HOLE CARDS ***
Dealt to pipinoelbreve9 [6d Jd]
pipinoelbreve9: folds 
marcel13013: folds 
QUIQUE JONES: raises €0.02 to €0.04
ocsur: folds 
poteaarte: calls €0.03
Danipro178: raises €0.20 to €0.24
QUIQUE JONES: folds 
poteaarte: folds 
Uncalled bet (€0.20) returned to Danipro178
Danipro178 collected €0.12 from pot
Danipro178: doesn't show hand 
*** SUMMARY ***
Total pot €0.12 | Rake €0 
Seat 1: ocsur (button) folded before Flop (didn't bet)
Seat 2: poteaarte (small blind) folded before Flop
Seat 3: Danipro178 (big blind) collected (€0.12)
Seat 4: pipinoelbreve9 folded before Flop (didn't bet)
Seat 5: marcel13013 folded before Flop (didn't bet)
Seat 6: QUIQUE JONES folded before Flop



PokerStars Zoom Hand #257607310757:  Hold'em No Limit (€0.01/€0.02) - 2025/09/04 12:46:53 CET [2025/09/04 6:46:53 ET]
Table 'Arneb' 6-max Seat #1 is the button
Seat 1: damastodas (€1.12 in chips) 
Seat 2: @RobarTevoy99 (€6.74 in chips) 
Seat 3: MDKristian (€2.10 in chips) 
Seat 4: McMack626 (€2.55 in chips) 
Seat 5: lorocontento (€1.30 in chips) 
Seat 6: pipinoelbreve9 (€2.89 in chips) 
@RobarTevoy99: posts small blind €0.01
MDKristian: posts big blind €0.02
*** HOLE CARDS ***
Dealt to pipinoelbreve9 [Th Qh]
McMack626: folds 
lorocontento: folds 
pipinoelbreve9: raises €0.04 to €0.06
damastodas: raises €0.56 to €0.62
@RobarTevoy99: folds 
MDKristian: folds 
pipinoelbreve9: folds 
Uncalled bet (€0.56) returned to damastodas
damastodas collected €0.15 from pot
damastodas: doesn't show hand 
*** SUMMARY ***
Total pot €0.15 | Rake €0 
Seat 1: damastodas (button) collected (€0.15)
Seat 2: @RobarTevoy99 (small blind) folded before Flop
Seat 3: MDKristian (big blind) folded before Flop
Seat 4: McMack626 folded before Flop (didn't bet)
Seat 5: lorocontento folded before Flop (didn't bet)
Seat 6: pipinoelbreve9 folded before Flop



PokerStars Zoom Hand #257607313004:  Hold'em No Limit (€0.01/€0.02) - 2025/09/04 12:47:14 CET [2025/09/04 6:47:14 ET]
Table 'Arneb' 6-max Seat #1 is the button
Seat 1: SrLyrox (€6.12 in chips) 
Seat 2: LaDecimaRAFA (€2.53 in chips) 
Seat 3: @RobarTevoy99 (€6.73 in chips) 
Seat 4: KillVerlaine (€2 in chips) 
Seat 5: Dimusa22 (€0.96 in chips) 
Seat 6: pipinoelbreve9 (€2.83 in chips) 
LaDecimaRAFA: posts small blind €0.01
@RobarTevoy99: posts big blind €0.02
*** HOLE CARDS ***
Dealt to pipinoelbreve9 [6c 9s]
KillVerlaine: folds 
Dimusa22: folds 
pipinoelbreve9: folds 
SrLyrox: folds 
LaDecimaRAFA: folds 
Uncalled bet (€0.01) returned to @RobarTevoy99
@RobarTevoy99 collected €0.02 from pot
@RobarTevoy99: doesn't show hand 
*** SUMMARY ***
Total pot €0.02 | Rake €0 
Seat 1: SrLyrox (button) folded before Flop (didn't bet)
Seat 2: LaDecimaRAFA (small blind) folded before Flop
Seat 3: @RobarTevoy99 (big blind) collected (€0.02)
Seat 4: KillVerlaine folded before Flop (didn't bet)
Seat 5: Dimusa22 folded before Flop (didn't bet)
Seat 6: pipinoelbreve9 folded before Flop (didn't bet)



PokerStars Zoom Hand #257607313962:  Hold'em No Limit (€0.01/€0.02) - 2025/09/04 12:47:23 CET [2025/09/04 6:47:23 ET]
Table 'Arneb' 6-max Seat #1 is the button
Seat 1: poteaarte (€6.42 in chips) 
Seat 2: xaratax (€2 in chips) 
Seat 3: SrLyrox (€6.12 in chips) 
Seat 4: D Tasmania (€2.16 in chips) 
Seat 5: pipinoelbreve9 (€2.83 in chips) 
Seat 6: DavSnook (€1.78 in chips) 
xaratax: posts small blind €0.01
SrLyrox: posts big blind €0.02
*** HOLE CARDS ***
Dealt to pipinoelbreve9 [7h 4h]
D Tasmania: folds 
pipinoelbreve9: folds 
DavSnook: raises €0.05 to €0.07
poteaarte: folds 
xaratax: folds 
SrLyrox: folds 
Uncalled bet (€0.05) returned to DavSnook
DavSnook collected €0.05 from pot
DavSnook: doesn't show hand 
*** SUMMARY ***
Total pot €0.05 | Rake €0 
Seat 1: poteaarte (button) folded before Flop (didn't bet)
Seat 2: xaratax (small blind) folded before Flop
Seat 3: SrLyrox (big blind) folded before Flop
Seat 4: D Tasmania folded before Flop (didn't bet)
Seat 5: pipinoelbreve9 folded before Flop (didn't bet)
Seat 6: DavSnook collected (€0.05)



PokerStars Zoom Hand #257607307330:  Hold'em No Limit (€0.01/€0.02) - 2025/09/04 12:46:21 CET [2025/09/04 6:46:21 ET]
Table 'Arneb' 6-max Seat #1 is the button
Seat 1: canokiller (€2 in chips) 
Seat 2: 77samuel33 (€2.55 in chips) 
Seat 3: joanmi_sanchez (€3.59 in chips) 
Seat 4: lorocontento (€1.13 in chips) 
Seat 5: pipinoelbreve9 (€2.90 in chips) 
Seat 6: ocsur (€2.09 in chips) 
77samuel33: posts small blind €0.01
joanmi_sanchez: posts big blind €0.02
*** HOLE CARDS ***
Dealt to pipinoelbreve9 [9h 2d]
lorocontento: folds 
pipinoelbreve9: folds 
ocsur: folds 
canokiller: folds 
77samuel33: raises €0.04 to €0.06
joanmi_sanchez: calls €0.04
*** FLOP *** [3h 5d 8s]
77samuel33: bets €0.04
joanmi_sanchez: raises €0.06 to €0.10
77samuel33: calls €0.06
*** TURN *** [3h 5d 8s] [Tc]
77samuel33: checks 
joanmi_sanchez: bets €0.20
77samuel33: calls €0.20
*** RIVER *** [3h 5d 8s Tc] [Js]
77samuel33: checks 
joanmi_sanchez: bets €0.43
77samuel33: calls €0.43
*** SHOW DOWN ***
joanmi_sanchez: shows [Qh 9c] (a straight, Eight to Queen)
77samuel33: mucks hand 
joanmi_sanchez collected €1.50 from pot
*** SUMMARY ***
Total pot €1.58 | Rake €0.08 
Board [3h 5d 8s Tc Js]
Seat 1: canokiller (button) folded before Flop (didn't bet)
Seat 2: 77samuel33 (small blind) mucked [Kc Ks]
Seat 3: joanmi_sanchez (big blind) showed [Qh 9c] and won (€1.50) with a straight, Eight to Queen
Seat 4: lorocontento folded before Flop (didn't bet)
Seat 5: pipinoelbreve9 folded before Flop (didn't bet)
Seat 6: ocsur folded before Flop (didn't bet)



PokerStars Zoom Hand #257607314723:  Hold'em No Limit (€0.01/€0.02) - 2025/09/04 12:47:31 CET [2025/09/04 6:47:31 ET]
Table 'Arneb' 6-max Seat #1 is the button
Seat 1: MDKristian (€2 in chips) 
Seat 2: SrLyrox (€6.02 in chips) 
Seat 3: pipinoelbreve9 (€2.83 in chips) 
Seat 4: grenha1972 (€2.12 in chips) 
Seat 5: canokiller (€2.12 in chips) 
Seat 6: Dimusa22 (€0.94 in chips) 
SrLyrox: posts small blind €0.01
pipinoelbreve9: posts big blind €0.02
*** HOLE CARDS ***
Dealt to pipinoelbreve9 [5s Qd]
grenha1972: calls €0.02
canokiller: folds 
Dimusa22: folds 
MDKristian: folds 
SrLyrox: folds 
pipinoelbreve9: checks 
*** FLOP *** [Ad Ah As]
pipinoelbreve9: checks 
grenha1972: bets €0.04
pipinoelbreve9: folds 
Uncalled bet (€0.04) returned to grenha1972
grenha1972 collected €0.05 from pot
grenha1972: doesn't show hand 
*** SUMMARY ***
Total pot €0.05 | Rake €0 
Board [Ad Ah As]
Seat 1: MDKristian (button) folded before Flop (didn't bet)
Seat 2: SrLyrox (small blind) folded before Flop
Seat 3: pipinoelbreve9 (big blind) folded on the Flop
Seat 4: grenha1972 collected (€0.05)
Seat 5: canokiller folded before Flop (didn't bet)
Seat 6: Dimusa22 folded before Flop (didn't bet)



PokerStars Zoom Hand #257607318504:  Hold'em No Limit (€0.01/€0.02) - 2025/09/04 12:48:06 CET [2025/09/04 6:48:06 ET]
Table 'Arneb' 6-max Seat #1 is the button
Seat 1: pipinoelbreve9 (€2.81 in chips) 
Seat 2: QUIQUE JONES (€0.66 in chips) 
Seat 3: grenha1972 (€2.15 in chips) 
Seat 4: spoke_6969 (€2.63 in chips) 
Seat 5: MDKristian (€2.02 in chips) 
Seat 6: Penha17213 (€2.04 in chips) 
QUIQUE JONES: posts small blind €0.01
grenha1972: posts big blind €0.02
*** HOLE CARDS ***
Dealt to pipinoelbreve9 [9c 2s]
spoke_6969: folds 
MDKristian: folds 
Penha17213: folds 
pipinoelbreve9: folds 
QUIQUE JONES: folds 
Uncalled bet (€0.01) returned to grenha1972
grenha1972 collected €0.02 from pot
grenha1972: doesn't show hand 
*** SUMMARY ***
Total pot €0.02 | Rake €0 
Seat 1: pipinoelbreve9 (button) folded before Flop (didn't bet)
Seat 2: QUIQUE JONES (small blind) folded before Flop
Seat 3: grenha1972 (big blind) collected (€0.02)
Seat 4: spoke_6969 folded before Flop (didn't bet)
Seat 5: MDKristian folded before Flop (didn't bet)
Seat 6: Penha17213 folded before Flop (didn't bet)



PokerStars Zoom Hand #257607319158:  Hold'em No Limit (€0.01/€0.02) - 2025/09/04 12:48:12 CET [2025/09/04 6:48:12 ET]
Table 'Arneb' 6-max Seat #1 is the button
Seat 1: xaratax (€2 in chips) 
Seat 2: morganlee66 (€1.09 in chips) 
Seat 3: Penha17213 (€2.04 in chips) 
Seat 4: MDKristian (€2 in chips) 
Seat 5: pipinoelbreve9 (€2.81 in chips) 
Seat 6: marcel13013 (€1.90 in chips) 
morganlee66: posts small blind €0.01
Penha17213: posts big blind €0.02
*** HOLE CARDS ***
Dealt to pipinoelbreve9 [8d Tc]
MDKristian: folds 
pipinoelbreve9: folds 
marcel13013: folds 
xaratax: folds 
morganlee66: folds 
Uncalled bet (€0.01) returned to Penha17213
Penha17213 collected €0.02 from pot
Penha17213: doesn't show hand 
*** SUMMARY ***
Total pot €0.02 | Rake €0 
Seat 1: xaratax (button) folded before Flop (didn't bet)
Seat 2: morganlee66 (small blind) folded before Flop
Seat 3: Penha17213 (big blind) collected (€0.02)
Seat 4: MDKristian folded before Flop (didn't bet)
Seat 5: pipinoelbreve9 folded before Flop (didn't bet)
Seat 6: marcel13013 folded before Flop (didn't bet)



PokerStars Zoom Hand #257607320948:  Hold'em No Limit (€0.01/€0.02) - 2025/09/04 12:48:30 CET [2025/09/04 6:48:30 ET]
Table 'Arneb' 6-max Seat #1 is the button
Seat 1: MDKristian (€2 in chips) 
Seat 2: D Tasmania (€1.46 in chips) 
Seat 3: 77samuel33 (€2.18 in chips) 
Seat 4: pipinoelbreve9 (€2.81 in chips) 
Seat 5: McMack626 (€0.49 in chips) 
Seat 6: marcel13013 (€3.69 in chips) 
D Tasmania: posts small blind €0.01
77samuel33: posts big blind €0.02
*** HOLE CARDS ***
Dealt to pipinoelbreve9 [3c Kc]
pipinoelbreve9: folds 
McMack626: folds 
marcel13013: calls €0.02
MDKristian: folds 
D Tasmania: calls €0.01
77samuel33: raises €0.16 to €0.18
marcel13013: calls €0.16
D Tasmania: folds 
*** FLOP *** [Ts 6d 5c]
77samuel33: bets €0.13
marcel13013: folds 
Uncalled bet (€0.13) returned to 77samuel33
77samuel33 collected €0.36 from pot
77samuel33: doesn't show hand 
*** SUMMARY ***
Total pot €0.38 | Rake €0.02 
Board [Ts 6d 5c]
Seat 1: MDKristian (button) folded before Flop (didn't bet)
Seat 2: D Tasmania (small blind) folded before Flop
Seat 3: 77samuel33 (big blind) collected (€0.36)
Seat 4: pipinoelbreve9 folded before Flop (didn't bet)
Seat 5: McMack626 folded before Flop (didn't bet)
Seat 6: marcel13013 folded on the Flop



PokerStars Zoom Hand #257607323068:  Hold'em No Limit (€0.01/€0.02) - 2025/09/04 12:48:50 CET [2025/09/04 6:48:50 ET]
Table 'Arneb' 6-max Seat #1 is the button
Seat 1: QUIQUE JONES (€0.48 in chips) 
Seat 2: pipinoelbreve9 (€2.79 in chips) 
Seat 3: 77samuel33 (€4.79 in chips) 
Seat 4: MDKristian (€2.03 in chips) 
Seat 5: SrLyrox (€6.12 in chips) 
Seat 6: McMack626 (€0.49 in chips) 
pipinoelbreve9: posts small blind €0.01
77samuel33: posts big blind €0.02
*** HOLE CARDS ***
Dealt to pipinoelbreve9 [4s 8h]
MDKristian: folds 
SrLyrox: folds 
McMack626: folds 
QUIQUE JONES: folds 
pipinoelbreve9: folds 
Uncalled bet (€0.01) returned to 77samuel33
77samuel33 collected €0.02 from pot
77samuel33: doesn't show hand 
*** SUMMARY ***
Total pot €0.02 | Rake €0 
Seat 1: QUIQUE JONES (button) folded before Flop (didn't bet)
Seat 2: pipinoelbreve9 (small blind) folded before Flop
Seat 3: 77samuel33 (big blind) collected (€0.02)
Seat 4: MDKristian folded before Flop (didn't bet)
Seat 5: SrLyrox folded before Flop (didn't bet)
Seat 6: McMack626 folded before Flop (didn't bet)



PokerStars Zoom Hand #257607320293:  Hold'em No Limit (€0.01/€0.02) - 2025/09/04 12:48:24 CET [2025/09/04 6:48:24 ET]
Table 'Arneb' 6-max Seat #1 is the button
Seat 1: Hemoro89 (€1.09 in chips) 
Seat 2: eneko83 (€2.31 in chips) 
Seat 3: joanmi_sanchez (€2 in chips) 
Seat 4: pipinoelbreve9 (€2.81 in chips) 
Seat 5: MDKristian (€2.02 in chips) 
Seat 6: xaratax (€2 in chips) 
eneko83: posts small blind €0.01
joanmi_sanchez: posts big blind €0.02
*** HOLE CARDS ***
Dealt to pipinoelbreve9 [4d Kc]
pipinoelbreve9: folds 
MDKristian: raises €0.02 to €0.04
xaratax: folds 
Hemoro89: folds 
eneko83: folds 
joanmi_sanchez: calls €0.02
*** FLOP *** [Jc Qh 5h]
joanmi_sanchez: checks 
MDKristian: checks 
*** TURN *** [Jc Qh 5h] [Qc]
joanmi_sanchez: bets €0.05
MDKristian: calls €0.05
*** RIVER *** [Jc Qh 5h Qc] [Ac]
joanmi_sanchez: bets €0.12
MDKristian: folds 
Uncalled bet (€0.12) returned to joanmi_sanchez
joanmi_sanchez collected €0.18 from pot
joanmi_sanchez: doesn't show hand 
*** SUMMARY ***
Total pot €0.19 | Rake €0.01 
Board [Jc Qh 5h Qc Ac]
Seat 1: Hemoro89 (button) folded before Flop (didn't bet)
Seat 2: eneko83 (small blind) folded before Flop
Seat 3: joanmi_sanchez (big blind) collected (€0.18)
Seat 4: pipinoelbreve9 folded before Flop (didn't bet)
Seat 5: MDKristian folded on the River
Seat 6: xaratax folded before Flop (didn't bet)



PokerStars Zoom Hand #257607323901:  Hold'em No Limit (€0.01/€0.02) - 2025/09/04 12:48:58 CET [2025/09/04 6:48:58 ET]
Table 'Arneb' 6-max Seat #1 is the button
Seat 1: pipinoelbreve9 (€2.78 in chips) 
Seat 2: DavSnook (€6.33 in chips) 
Seat 3: 77samuel33 (€4.44 in chips) 
Seat 4: MDKristian (€2 in chips) 
Seat 5: SrLyrox (€6.12 in chips) 
Seat 6: marcel13013 (€1.88 in chips) 
DavSnook: posts small blind €0.01
77samuel33: posts big blind €0.02
*** HOLE CARDS ***
Dealt to pipinoelbreve9 [8h 9s]
MDKristian: folds 
SrLyrox: folds 
marcel13013: folds 
pipinoelbreve9: folds 
DavSnook: folds 
Uncalled bet (€0.01) returned to 77samuel33
77samuel33 collected €0.02 from pot
77samuel33: doesn't show hand 
*** SUMMARY ***
Total pot €0.02 | Rake €0 
Seat 1: pipinoelbreve9 (button) folded before Flop (didn't bet)
Seat 2: DavSnook (small blind) folded before Flop
Seat 3: 77samuel33 (big blind) collected (€0.02)
Seat 4: MDKristian folded before Flop (didn't bet)
Seat 5: SrLyrox folded before Flop (didn't bet)
Seat 6: marcel13013 folded before Flop (didn't bet)



PokerStars Zoom Hand #257607324488:  Hold'em No Limit (€0.01/€0.02) - 2025/09/04 12:49:04 CET [2025/09/04 6:49:04 ET]
Table 'Arneb' 6-max Seat #1 is the button
Seat 1: xaratax (€2 in chips) 
Seat 2: McMack626 (€0.47 in chips) 
Seat 3: joanmi_sanchez (€2.66 in chips) 
Seat 4: grenha1972 (€2.16 in chips) 
Seat 5: pipinoelbreve9 (€2.78 in chips) 
Seat 6: Dimusa22 (€0.64 in chips) 
McMack626: posts small blind €0.01
joanmi_sanchez: posts big blind €0.02
*** HOLE CARDS ***
Dealt to pipinoelbreve9 [9d 8d]
grenha1972: folds 
pipinoelbreve9: raises €0.04 to €0.06
Dimusa22: folds 
xaratax: folds 
McMack626: folds 
joanmi_sanchez: folds 
Uncalled bet (€0.04) returned to pipinoelbreve9
pipinoelbreve9 collected €0.05 from pot
pipinoelbreve9: doesn't show hand 
*** SUMMARY ***
Total pot €0.05 | Rake €0 
Seat 1: xaratax (button) folded before Flop (didn't bet)
Seat 2: McMack626 (small blind) folded before Flop
Seat 3: joanmi_sanchez (big blind) folded before Flop
Seat 4: grenha1972 folded before Flop (didn't bet)
Seat 5: pipinoelbreve9 collected (€0.05)
Seat 6: Dimusa22 folded before Flop (didn't bet)



PokerStars Zoom Hand #257607326077:  Hold'em No Limit (€0.01/€0.02) - 2025/09/04 12:49:19 CET [2025/09/04 6:49:19 ET]
Table 'Arneb' 6-max Seat #1 is the button
Seat 1: xaratax (€2 in chips) 
Seat 2: SrLyrox (€6.54 in chips) 
Seat 3: poteaarte (€4.08 in chips) 
Seat 4: more457 (€1.16 in chips) 
Seat 5: Penha17213 (€2.49 in chips) 
Seat 6: pipinoelbreve9 (€2.81 in chips) 
SrLyrox: posts small blind €0.01
poteaarte: posts big blind €0.02
*** HOLE CARDS ***
Dealt to pipinoelbreve9 [2s Kc]
more457: folds 
Penha17213: folds 
pipinoelbreve9: folds 
xaratax: folds 
SrLyrox: raises €0.04 to €0.06
poteaarte: folds 
Uncalled bet (€0.04) returned to SrLyrox
SrLyrox collected €0.04 from pot
SrLyrox: doesn't show hand 
*** SUMMARY ***
Total pot €0.04 | Rake €0 
Seat 1: xaratax (button) folded before Flop (didn't bet)
Seat 2: SrLyrox (small blind) collected (€0.04)
Seat 3: poteaarte (big blind) folded before Flop
Seat 4: more457 folded before Flop (didn't bet)
Seat 5: Penha17213 folded before Flop (didn't bet)
Seat 6: pipinoelbreve9 folded before Flop (didn't bet)



PokerStars Zoom Hand #257607321333:  Hold'em No Limit (€0.01/€0.02) - 2025/09/04 12:48:33 CET [2025/09/04 6:48:33 ET]
Table 'Arneb' 6-max Seat #1 is the button
Seat 1: @RobarTevoy99 (€0.76 in chips) 
Seat 2: poteaarte (€4.10 in chips) 
Seat 3: pipinoelbreve9 (€2.81 in chips) 
Seat 4: Danipro178 (€2.03 in chips) 
Seat 5: joanmi_sanchez (€2.67 in chips) 
Seat 6: damastodas (€3 in chips) 
poteaarte: posts small blind €0.01
pipinoelbreve9: posts big blind €0.02
*** HOLE CARDS ***
Dealt to pipinoelbreve9 [4c Ts]
Danipro178: folds 
joanmi_sanchez: folds 
damastodas: calls €0.02
@RobarTevoy99: folds 
poteaarte: raises €0.06 to €0.08
pipinoelbreve9: folds 
damastodas: calls €0.06
*** FLOP *** [9s 7d 4s]
poteaarte: bets €0.06
damastodas: calls €0.06
*** TURN *** [9s 7d 4s] [9c]
poteaarte: checks 
damastodas: checks 
*** RIVER *** [9s 7d 4s 9c] [Js]
poteaarte: checks 
damastodas: bets €0.20
poteaarte: folds 
Uncalled bet (€0.20) returned to damastodas
damastodas collected €0.28 from pot
damastodas: doesn't show hand 
*** SUMMARY ***
Total pot €0.30 | Rake €0.02 
Board [9s 7d 4s 9c Js]
Seat 1: @RobarTevoy99 (button) folded before Flop (didn't bet)
Seat 2: poteaarte (small blind) folded on the River
Seat 3: pipinoelbreve9 (big blind) folded before Flop
Seat 4: Danipro178 folded before Flop (didn't bet)
Seat 5: joanmi_sanchez folded before Flop (didn't bet)
Seat 6: damastodas collected (€0.28)



PokerStars Zoom Hand #257607328288:  Hold'em No Limit (€0.01/€0.02) - 2025/09/04 12:49:40 CET [2025/09/04 6:49:40 ET]
Table 'Arneb' 6-max Seat #1 is the button
Seat 1: thenry03 (€1.97 in chips) 
Seat 2: MDKristian (€2.07 in chips) 
Seat 3: pipinoelbreve9 (€2.80 in chips) 
Seat 4: Dimusa22 (€0.68 in chips) 
Seat 5: mari197721 (€1.77 in chips) 
Seat 6: 77samuel33 (€2.35 in chips) 
MDKristian: posts small blind €0.01
pipinoelbreve9: posts big blind €0.02
*** HOLE CARDS ***
Dealt to pipinoelbreve9 [3h 3d]
Dimusa22: raises €0.04 to €0.06
mari197721: calls €0.06
77samuel33: folds 
thenry03: folds 
MDKristian: folds 
pipinoelbreve9: calls €0.04
*** FLOP *** [Jh Qc 7h]
pipinoelbreve9: checks 
Dimusa22: checks 
mari197721: bets €0.09
pipinoelbreve9: folds 
Dimusa22: folds 
Uncalled bet (€0.09) returned to mari197721
mari197721 collected €0.18 from pot
mari197721: doesn't show hand 
*** SUMMARY ***
Total pot €0.19 | Rake €0.01 
Board [Jh Qc 7h]
Seat 1: thenry03 (button) folded before Flop (didn't bet)
Seat 2: MDKristian (small blind) folded before Flop
Seat 3: pipinoelbreve9 (big blind) folded on the Flop
Seat 4: Dimusa22 folded on the Flop
Seat 5: mari197721 collected (€0.18)
Seat 6: 77samuel33 folded before Flop (didn't bet)



PokerStars Zoom Hand #257607326945:  Hold'em No Limit (€0.01/€0.02) - 2025/09/04 12:49:27 CET [2025/09/04 6:49:27 ET]
Table 'Arneb' 6-max Seat #1 is the button
Seat 1: Grenaund_ (€7.44 in chips) 
Seat 2: pipinoelbreve9 (€2.81 in chips) 
Seat 3: Asensiaco (€5.20 in chips) 
Seat 4: McMack626 (€2.37 in chips) 
Seat 5: @RobarTevoy99 (€1.90 in chips) 
Seat 6: more457 (€1.64 in chips) 
pipinoelbreve9: posts small blind €0.01
Asensiaco: posts big blind €0.02
*** HOLE CARDS ***
Dealt to pipinoelbreve9 [2d 5c]
McMack626: folds 
@RobarTevoy99: folds 
more457: folds 
Grenaund_: raises €0.02 to €0.04
pipinoelbreve9: folds 
Asensiaco: calls €0.02
*** FLOP *** [5d Jh Js]
Asensiaco: checks 
Grenaund_: checks 
*** TURN *** [5d Jh Js] [Ts]
Asensiaco: bets €0.07
Grenaund_: calls €0.07
*** RIVER *** [5d Jh Js Ts] [4s]
Asensiaco: bets €0.07
Grenaund_: calls €0.07
*** SHOW DOWN ***
Asensiaco: shows [Ad Td] (two pair, Jacks and Tens)
Grenaund_: mucks hand 
Asensiaco collected €0.35 from pot
*** SUMMARY ***
Total pot €0.37 | Rake €0.02 
Board [5d Jh Js Ts 4s]
Seat 1: Grenaund_ (button) mucked [Qs Tc]
Seat 2: pipinoelbreve9 (small blind) folded before Flop
Seat 3: Asensiaco (big blind) showed [Ad Td] and won (€0.35) with two pair, Jacks and Tens
Seat 4: McMack626 folded before Flop (didn't bet)
Seat 5: @RobarTevoy99 folded before Flop (didn't bet)
Seat 6: more457 folded before Flop (didn't bet)



PokerStars Zoom Hand #257607330253:  Hold'em No Limit (€0.01/€0.02) - 2025/09/04 12:49:59 CET [2025/09/04 6:49:59 ET]
Table 'Arneb' 6-max Seat #1 is the button
Seat 1: DavSnook (€4.76 in chips) 
Seat 2: MDKristian (€2 in chips) 
Seat 3: canokiller (€2.09 in chips) 
Seat 4: pipinoelbreve9 (€2.74 in chips) 
Seat 5: @RobarTevoy99 (€6.60 in chips) 
Seat 6: grenha1972 (€3.73 in chips) 
MDKristian: posts small blind €0.01
canokiller: posts big blind €0.02
*** HOLE CARDS ***
Dealt to pipinoelbreve9 [2h 4c]
pipinoelbreve9: folds 
@RobarTevoy99: folds 
grenha1972: raises €0.02 to €0.04
DavSnook: folds 
MDKristian: folds 
canokiller: folds 
Uncalled bet (€0.02) returned to grenha1972
grenha1972 collected €0.05 from pot
grenha1972: doesn't show hand 
*** SUMMARY ***
Total pot €0.05 | Rake €0 
Seat 1: DavSnook (button) folded before Flop (didn't bet)
Seat 2: MDKristian (small blind) folded before Flop
Seat 3: canokiller (big blind) folded before Flop
Seat 4: pipinoelbreve9 folded before Flop (didn't bet)
Seat 5: @RobarTevoy99 folded before Flop (didn't bet)
Seat 6: grenha1972 collected (€0.05)



PokerStars Zoom Hand #257607330565:  Hold'em No Limit (€0.01/€0.02) - 2025/09/04 12:50:02 CET [2025/09/04 6:50:02 ET]
Table 'Arneb' 6-max Seat #1 is the button
Seat 1: pipinoelbreve9 (€2.74 in chips) 
Seat 2: SrLyrox (€6.03 in chips) 
Seat 3: spoke_6969 (€2.52 in chips) 
Seat 4: Danipro178 (€2.06 in chips) 
Seat 5: 77samuel33 (€2.33 in chips) 
Seat 6: poteaarte (€6.20 in chips) 
SrLyrox: posts small blind €0.01
spoke_6969: posts big blind €0.02
*** HOLE CARDS ***
Dealt to pipinoelbreve9 [2h Jc]
Danipro178: folds 
77samuel33: folds 
poteaarte: folds 
pipinoelbreve9: folds 
SrLyrox: folds 
Uncalled bet (€0.01) returned to spoke_6969
spoke_6969 collected €0.02 from pot
spoke_6969: doesn't show hand 
*** SUMMARY ***
Total pot €0.02 | Rake €0 
Seat 1: pipinoelbreve9 (button) folded before Flop (didn't bet)
Seat 2: SrLyrox (small blind) folded before Flop
Seat 3: spoke_6969 (big blind) collected (€0.02)
Seat 4: Danipro178 folded before Flop (didn't bet)
Seat 5: 77samuel33 folded before Flop (didn't bet)
Seat 6: poteaarte folded before Flop (didn't bet)



PokerStars Zoom Hand #257607331293:  Hold'em No Limit (€0.01/€0.02) - 2025/09/04 12:50:09 CET [2025/09/04 6:50:09 ET]
Table 'Arneb' 6-max Seat #1 is the button
Seat 1: xaratax (€2 in chips) 
Seat 2: @RobarTevoy99 (€1.91 in chips) 
Seat 3: yaya7938 (€1.05 in chips) 
Seat 4: morganlee66 (€1.09 in chips) 
Seat 5: pipinoelbreve9 (€2.74 in chips) 
Seat 6: joanmi_sanchez (€2.26 in chips) 
@RobarTevoy99: posts small blind €0.01
yaya7938: posts big blind €0.02
*** HOLE CARDS ***
Dealt to pipinoelbreve9 [Tc Qd]
morganlee66: raises €0.04 to €0.06
pipinoelbreve9: folds 
joanmi_sanchez: folds 
xaratax: folds 
@RobarTevoy99: folds 
yaya7938: folds 
Uncalled bet (€0.04) returned to morganlee66
morganlee66 collected €0.05 from pot
morganlee66: doesn't show hand 
*** SUMMARY ***
Total pot €0.05 | Rake €0 
Seat 1: xaratax (button) folded before Flop (didn't bet)
Seat 2: @RobarTevoy99 (small blind) folded before Flop
Seat 3: yaya7938 (big blind) folded before Flop
Seat 4: morganlee66 collected (€0.05)
Seat 5: pipinoelbreve9 folded before Flop (didn't bet)
Seat 6: joanmi_sanchez folded before Flop (didn't bet)



PokerStars Zoom Hand #257607333767:  Hold'em No Limit (€0.01/€0.02) - 2025/09/04 12:50:33 CET [2025/09/04 6:50:33 ET]
Table 'Arneb' 6-max Seat #1 is the button
Seat 1: canokiller (€2.09 in chips) 
Seat 2: joanmi_sanchez (€2.69 in chips) 
Seat 3: thenry03 (€2.09 in chips) 
Seat 4: poteaarte (€4.05 in chips) 
Seat 5: Grenaund_ (€7.25 in chips) 
Seat 6: pipinoelbreve9 (€2.74 in chips) 
joanmi_sanchez: posts small blind €0.01
thenry03: posts big blind €0.02
*** HOLE CARDS ***
Dealt to pipinoelbreve9 [Ac Ad]
poteaarte: folds 
Grenaund_: raises €0.02 to €0.04
pipinoelbreve9: calls €0.04
canokiller: folds 
joanmi_sanchez: folds 
thenry03: calls €0.02
*** FLOP *** [9s 8d 9d]
thenry03: checks 
Grenaund_: checks 
pipinoelbreve9: bets €0.06
thenry03: folds 
Grenaund_: calls €0.06
*** TURN *** [9s 8d 9d] [6d]
Grenaund_: checks 
pipinoelbreve9: bets €0.12
Grenaund_: folds 
Uncalled bet (€0.12) returned to pipinoelbreve9
pipinoelbreve9 collected €0.24 from pot
pipinoelbreve9: doesn't show hand 
*** SUMMARY ***
Total pot €0.25 | Rake €0.01 
Board [9s 8d 9d 6d]
Seat 1: canokiller (button) folded before Flop (didn't bet)
Seat 2: joanmi_sanchez (small blind) folded before Flop
Seat 3: thenry03 (big blind) folded on the Flop
Seat 4: poteaarte folded before Flop (didn't bet)
Seat 5: Grenaund_ folded on the Turn
Seat 6: pipinoelbreve9 collected (€0.24)



PokerStars Zoom Hand #257607339759:  Hold'em No Limit (€0.01/€0.02) - 2025/09/04 12:51:30 CET [2025/09/04 6:51:30 ET]
Table 'Arneb' 6-max Seat #1 is the button
Seat 1: MDKristian (€2.21 in chips) 
Seat 2: pipinoelbreve9 (€2.88 in chips) 
Seat 3: Penha17213 (€2.27 in chips) 
Seat 4: QUIQUE JONES (€0.37 in chips) 
Seat 5: DavSnook (€2.27 in chips) 
Seat 6: more457 (€1.50 in chips) 
pipinoelbreve9: posts small blind €0.01
Penha17213: posts big blind €0.02
*** HOLE CARDS ***
Dealt to pipinoelbreve9 [As Jh]
QUIQUE JONES: folds 
DavSnook: folds 
more457: folds 
MDKristian: folds 
pipinoelbreve9: raises €0.04 to €0.06
Penha17213: folds 
Uncalled bet (€0.04) returned to pipinoelbreve9
pipinoelbreve9 collected €0.04 from pot
pipinoelbreve9: doesn't show hand 
*** SUMMARY ***
Total pot €0.04 | Rake €0 
Seat 1: MDKristian (button) folded before Flop (didn't bet)
Seat 2: pipinoelbreve9 (small blind) collected (€0.04)
Seat 3: Penha17213 (big blind) folded before Flop
Seat 4: QUIQUE JONES folded before Flop (didn't bet)
Seat 5: DavSnook folded before Flop (didn't bet)
Seat 6: more457 folded before Flop (didn't bet)



PokerStars Zoom Hand #257607345810:  Hold'em No Limit (€0.01/€0.02) - 2025/09/04 12:52:28 CET [2025/09/04 6:52:28 ET]
Table 'Arneb' 6-max Seat #1 is the button
Seat 1: MDKristian (€2.17 in chips) 
Seat 2: Bengball (€2.06 in chips) 
Seat 3: pipinoelbreve9 (€2.90 in chips) 
Seat 4: LGC04 (€1.97 in chips) 
Seat 5: KillVerlaine (€2.14 in chips) 
Seat 6: more457 (€1.33 in chips) 
Bengball: posts small blind €0.01
pipinoelbreve9: posts big blind €0.02
*** HOLE CARDS ***
Dealt to pipinoelbreve9 [4d Th]
LGC04: folds 
KillVerlaine: folds 
more457: folds 
MDKristian: raises €0.02 to €0.04
Bengball: folds 
pipinoelbreve9: folds 
Uncalled bet (€0.02) returned to MDKristian
MDKristian collected €0.05 from pot
MDKristian: doesn't show hand 
*** SUMMARY ***
Total pot €0.05 | Rake €0 
Seat 1: MDKristian (button) collected (€0.05)
Seat 2: Bengball (small blind) folded before Flop
Seat 3: pipinoelbreve9 (big blind) folded before Flop
Seat 4: LGC04 folded before Flop (didn't bet)
Seat 5: KillVerlaine folded before Flop (didn't bet)
Seat 6: more457 folded before Flop (didn't bet)



PokerStars Zoom Hand #257607345217:  Hold'em No Limit (€0.01/€0.02) - 2025/09/04 12:52:22 CET [2025/09/04 6:52:22 ET]
Table 'Arneb' 6-max Seat #1 is the button
Seat 1: pipinoelbreve9 (€2.90 in chips) 
Seat 2: DavSnook (€2.25 in chips) 
Seat 3: poteaarte (€4.05 in chips) 
Seat 4: MDKristian (€2.07 in chips) 
Seat 5: more457 (€1.33 in chips) 
Seat 6: xaratax (€2.16 in chips) 
DavSnook: posts small blind €0.01
poteaarte: posts big blind €0.02
*** HOLE CARDS ***
Dealt to pipinoelbreve9 [6h 9h]
MDKristian: raises €0.02 to €0.04
more457: folds 
xaratax: folds 
pipinoelbreve9: folds 
DavSnook: calls €0.03
poteaarte: folds 
*** FLOP *** [As Ks Qs]
DavSnook: checks 
MDKristian: checks 
*** TURN *** [As Ks Qs] [7s]
DavSnook: bets €0.05
MDKristian: calls €0.05
*** RIVER *** [As Ks Qs 7s] [5h]
DavSnook: checks 
MDKristian: checks 
*** SHOW DOWN ***
DavSnook: shows [2d 7d] (a pair of Sevens)
MDKristian: shows [3d 3s] (a flush, Ace high)
MDKristian collected €0.19 from pot
*** SUMMARY ***
Total pot €0.20 | Rake €0.01 
Board [As Ks Qs 7s 5h]
Seat 1: pipinoelbreve9 (button) folded before Flop (didn't bet)
Seat 2: DavSnook (small blind) showed [2d 7d] and lost with a pair of Sevens
Seat 3: poteaarte (big blind) folded before Flop
Seat 4: MDKristian showed [3d 3s] and won (€0.19) with a flush, Ace high
Seat 5: more457 folded before Flop (didn't bet)
Seat 6: xaratax folded before Flop (didn't bet)



PokerStars Zoom Hand #257607347297:  Hold'em No Limit (€0.01/€0.02) - 2025/09/04 12:52:42 CET [2025/09/04 6:52:42 ET]
Table 'Arneb' 6-max Seat #1 is the button
Seat 1: txai56 (€1.92 in chips) 
Seat 2: KillVerlaine (€2.14 in chips) 
Seat 3: more457 (€0.96 in chips) 
Seat 4: pipinoelbreve9 (€2.88 in chips) 
Seat 5: MDKristian (€2.20 in chips) 
Seat 6: LGC04 (€2.22 in chips) 
KillVerlaine: posts small blind €0.01
more457: posts big blind €0.02
*** HOLE CARDS ***
Dealt to pipinoelbreve9 [As Jh]
pipinoelbreve9: raises €0.04 to €0.06
MDKristian: folds 
LGC04: calls €0.06
txai56: folds 
KillVerlaine: folds 
more457: folds 
*** FLOP *** [Tc 7s 9c]
pipinoelbreve9: bets €0.05
LGC04: raises €0.05 to €0.10
pipinoelbreve9: calls €0.05
*** TURN *** [Tc 7s 9c] [6h]
pipinoelbreve9: checks 
LGC04: bets €0.06
pipinoelbreve9: calls €0.06
*** RIVER *** [Tc 7s 9c 6h] [9s]
pipinoelbreve9: checks 
LGC04: bets €0.23
pipinoelbreve9: folds 
Uncalled bet (€0.23) returned to LGC04
LGC04 collected €0.45 from pot
LGC04: doesn't show hand 
*** SUMMARY ***
Total pot €0.47 | Rake €0.02 
Board [Tc 7s 9c 6h 9s]
Seat 1: txai56 (button) folded before Flop (didn't bet)
Seat 2: KillVerlaine (small blind) folded before Flop
Seat 3: more457 (big blind) folded before Flop
Seat 4: pipinoelbreve9 folded on the River
Seat 5: MDKristian folded before Flop (didn't bet)
Seat 6: LGC04 collected (€0.45)



PokerStars Zoom Hand #257607352919:  Hold'em No Limit (€0.01/€0.02) - 2025/09/04 12:53:36 CET [2025/09/04 6:53:36 ET]
Table 'Arneb' 6-max Seat #1 is the button
Seat 1: lorocontento (€1.08 in chips) 
Seat 2: txai56 (€2.35 in chips) 
Seat 3: Bengball (€2.01 in chips) 
Seat 4: Danipro178 (€2.24 in chips) 
Seat 5: canokiller (€2.09 in chips) 
Seat 6: pipinoelbreve9 (€2.66 in chips) 
txai56: posts small blind €0.01
Bengball: posts big blind €0.02
*** HOLE CARDS ***
Dealt to pipinoelbreve9 [2h Kc]
Danipro178: folds 
canokiller: folds 
pipinoelbreve9: folds 
lorocontento: folds 
txai56: folds 
Uncalled bet (€0.01) returned to Bengball
Bengball collected €0.02 from pot
Bengball: doesn't show hand 
*** SUMMARY ***
Total pot €0.02 | Rake €0 
Seat 1: lorocontento (button) folded before Flop (didn't bet)
Seat 2: txai56 (small blind) folded before Flop
Seat 3: Bengball (big blind) collected (€0.02)
Seat 4: Danipro178 folded before Flop (didn't bet)
Seat 5: canokiller folded before Flop (didn't bet)
Seat 6: pipinoelbreve9 folded before Flop (didn't bet)



PokerStars Zoom Hand #257607354229:  Hold'em No Limit (€0.01/€0.02) - 2025/09/04 12:53:48 CET [2025/09/04 6:53:48 ET]
Table 'Arneb' 6-max Seat #1 is the button
Seat 1: @RobarTevoy99 (€1.83 in chips) 
Seat 2: Danipro178 (€2.13 in chips) 
Seat 3: Penha17213 (€2.27 in chips) 
Seat 4: more457 (€1.44 in chips) 
Seat 5: pipinoelbreve9 (€2.66 in chips) 
Seat 6: DavSnook (€7.09 in chips) 
Danipro178: posts small blind €0.01
Penha17213: posts big blind €0.02
*** HOLE CARDS ***
Dealt to pipinoelbreve9 [4h 6c]
more457: folds 
pipinoelbreve9: folds 
DavSnook: folds 
@RobarTevoy99: folds 
Danipro178: folds 
Uncalled bet (€0.01) returned to Penha17213
Penha17213 collected €0.02 from pot
Penha17213: doesn't show hand 
*** SUMMARY ***
Total pot €0.02 | Rake €0 
Seat 1: @RobarTevoy99 (button) folded before Flop (didn't bet)
Seat 2: Danipro178 (small blind) folded before Flop
Seat 3: Penha17213 (big blind) collected (€0.02)
Seat 4: more457 folded before Flop (didn't bet)
Seat 5: pipinoelbreve9 folded before Flop (didn't bet)
Seat 6: DavSnook folded before Flop (didn't bet)



PokerStars Zoom Hand #257607353593:  Hold'em No Limit (€0.01/€0.02) - 2025/09/04 12:53:43 CET [2025/09/04 6:53:43 ET]
Table 'Arneb' 6-max Seat #1 is the button
Seat 1: perkales133 (€2.03 in chips) 
Seat 2: poteaarte (€2.55 in chips) 
Seat 3: Grenaund_ (€7.35 in chips) 
Seat 4: pipinoelbreve9 (€2.66 in chips) 
Seat 5: Danipro178 (€2.24 in chips) 
Seat 6: MDKristian (€2.18 in chips) 
poteaarte: posts small blind €0.01
Grenaund_: posts big blind €0.02
*** HOLE CARDS ***
Dealt to pipinoelbreve9 [3d 6d]
pipinoelbreve9: folds 
Danipro178: folds 
MDKristian: folds 
perkales133: raises €0.04 to €0.06
poteaarte: folds 
Grenaund_: folds 
Uncalled bet (€0.04) returned to perkales133
perkales133 collected €0.05 from pot
perkales133: doesn't show hand 
*** SUMMARY ***
Total pot €0.05 | Rake €0 
Seat 1: perkales133 (button) collected (€0.05)
Seat 2: poteaarte (small blind) folded before Flop
Seat 3: Grenaund_ (big blind) folded before Flop
Seat 4: pipinoelbreve9 folded before Flop (didn't bet)
Seat 5: Danipro178 folded before Flop (didn't bet)
Seat 6: MDKristian folded before Flop (didn't bet)



PokerStars Zoom Hand #257607354968:  Hold'em No Limit (€0.01/€0.02) - 2025/09/04 12:53:56 CET [2025/09/04 6:53:56 ET]
Table 'Arneb' 6-max Seat #1 is the button
Seat 1: canokiller (€2.09 in chips) 
Seat 2: pipinoelbreve9 (€2.66 in chips) 
Seat 3: more457 (€1.44 in chips) 
Seat 4: @RobarTevoy99 (€1.83 in chips) 
Seat 5: lorocontento (€1.07 in chips) 
Seat 6: KillVerlaine (€2.07 in chips) 
pipinoelbreve9: posts small blind €0.01
more457: posts big blind €0.02
*** HOLE CARDS ***
Dealt to pipinoelbreve9 [3c 6s]
@RobarTevoy99: calls €0.02
lorocontento: calls €0.02
KillVerlaine: raises €0.10 to €0.12
canokiller: folds 
pipinoelbreve9: folds 
more457: folds 
@RobarTevoy99: calls €0.10
lorocontento: calls €0.10
*** FLOP *** [Ah 3s 9c]
@RobarTevoy99: checks 
lorocontento: checks 
KillVerlaine: bets €0.19
@RobarTevoy99: folds 
lorocontento: folds 
Uncalled bet (€0.19) returned to KillVerlaine
KillVerlaine collected €0.37 from pot
KillVerlaine: doesn't show hand 
*** SUMMARY ***
Total pot €0.39 | Rake €0.02 
Board [Ah 3s 9c]
Seat 1: canokiller (button) folded before Flop (didn't bet)
Seat 2: pipinoelbreve9 (small blind) folded before Flop
Seat 3: more457 (big blind) folded before Flop
Seat 4: @RobarTevoy99 folded on the Flop
Seat 5: lorocontento folded on the Flop
Seat 6: KillVerlaine collected (€0.37)



PokerStars Zoom Hand #257607356100:  Hold'em No Limit (€0.01/€0.02) - 2025/09/04 12:54:07 CET [2025/09/04 6:54:07 ET]
Table 'Arneb' 6-max Seat #1 is the button
Seat 1: Grenaund_ (€7.33 in chips) 
Seat 2: DavSnook (€4.68 in chips) 
Seat 3: pipinoelbreve9 (€2.65 in chips) 
Seat 4: marcel13013 (€3.24 in chips) 
Seat 5: canokiller (€2.09 in chips) 
Seat 6: QUIQUE JONES (€0.37 in chips) 
DavSnook: posts small blind €0.01
pipinoelbreve9: posts big blind €0.02
*** HOLE CARDS ***
Dealt to pipinoelbreve9 [Kd Jd]
marcel13013: folds 
canokiller: folds 
QUIQUE JONES: raises €0.02 to €0.04
Grenaund_: folds 
DavSnook: folds 
pipinoelbreve9: calls €0.02
*** FLOP *** [6c 4c Qs]
pipinoelbreve9: checks 
QUIQUE JONES: bets €0.09
pipinoelbreve9: calls €0.09
*** TURN *** [6c 4c Qs] [9c]
pipinoelbreve9: checks 
QUIQUE JONES: checks 
*** RIVER *** [6c 4c Qs 9c] [Ac]
pipinoelbreve9: checks 
QUIQUE JONES: checks 
*** SHOW DOWN ***
pipinoelbreve9: shows [Kd Jd] (high card Ace)
QUIQUE JONES: shows [Th Qh] (a pair of Queens)
QUIQUE JONES collected €0.26 from pot
*** SUMMARY ***
Total pot €0.27 | Rake €0.01 
Board [6c 4c Qs 9c Ac]
Seat 1: Grenaund_ (button) folded before Flop (didn't bet)
Seat 2: DavSnook (small blind) folded before Flop
Seat 3: pipinoelbreve9 (big blind) showed [Kd Jd] and lost with high card Ace
Seat 4: marcel13013 folded before Flop (didn't bet)
Seat 5: canokiller folded before Flop (didn't bet)
Seat 6: QUIQUE JONES showed [Th Qh] and won (€0.26) with a pair of Queens



PokerStars Zoom Hand #257607361849:  Hold'em No Limit (€0.01/€0.02) - 2025/09/04 12:55:01 CET [2025/09/04 6:55:01 ET]
Table 'Arneb' 6-max Seat #1 is the button
Seat 1: eneko83 (€1.80 in chips) 
Seat 2: bufu92 (€1.66 in chips) 
Seat 3: MDKristian (€2.09 in chips) 
Seat 4: D Tasmania (€2.76 in chips) 
Seat 5: canokiller (€2.24 in chips) 
Seat 6: pipinoelbreve9 (€2.52 in chips) 
bufu92: posts small blind €0.01
MDKristian: posts big blind €0.02
*** HOLE CARDS ***
Dealt to pipinoelbreve9 [9c 2h]
D Tasmania: folds 
canokiller: raises €0.04 to €0.06
pipinoelbreve9: folds 
eneko83: folds 
bufu92: folds 
MDKristian: folds 
Uncalled bet (€0.04) returned to canokiller
canokiller collected €0.05 from pot
canokiller: doesn't show hand 
*** SUMMARY ***
Total pot €0.05 | Rake €0 
Seat 1: eneko83 (button) folded before Flop (didn't bet)
Seat 2: bufu92 (small blind) folded before Flop
Seat 3: MDKristian (big blind) folded before Flop
Seat 4: D Tasmania folded before Flop (didn't bet)
Seat 5: canokiller collected (€0.05)
Seat 6: pipinoelbreve9 folded before Flop (didn't bet)



PokerStars Zoom Hand #257607361138:  Hold'em No Limit (€0.01/€0.02) - 2025/09/04 12:54:54 CET [2025/09/04 6:54:54 ET]
Table 'Arneb' 6-max Seat #1 is the button
Seat 1: pipinoelbreve9 (€2.52 in chips) 
Seat 2: Danipro178 (€2.10 in chips) 
Seat 3: DavSnook (€4.43 in chips) 
Seat 4: joanmi_sanchez (€2.39 in chips) 
Seat 5: RCSA2 (€2.15 in chips) 
Seat 6: MDKristian (€2.35 in chips) 
Danipro178: posts small blind €0.01
DavSnook: posts big blind €0.02
*** HOLE CARDS ***
Dealt to pipinoelbreve9 [Kc 4h]
joanmi_sanchez: folds 
RCSA2: folds 
MDKristian: folds 
pipinoelbreve9: folds 
Danipro178: folds 
Uncalled bet (€0.01) returned to DavSnook
DavSnook collected €0.02 from pot
DavSnook: doesn't show hand 
*** SUMMARY ***
Total pot €0.02 | Rake €0 
Seat 1: pipinoelbreve9 (button) folded before Flop (didn't bet)
Seat 2: Danipro178 (small blind) folded before Flop
Seat 3: DavSnook (big blind) collected (€0.02)
Seat 4: joanmi_sanchez folded before Flop (didn't bet)
Seat 5: RCSA2 folded before Flop (didn't bet)
Seat 6: MDKristian folded before Flop (didn't bet)



PokerStars Zoom Hand #257607362278:  Hold'em No Limit (€0.01/€0.02) - 2025/09/04 12:55:05 CET [2025/09/04 6:55:05 ET]
Table 'Arneb' 6-max Seat #1 is the button
Seat 1: joanmi_sanchez (€3.13 in chips) 
Seat 2: elenita_nait (€2.01 in chips) 
Seat 3: D Tasmania (€2.76 in chips) 
Seat 4: pipinoelbreve9 (€2.52 in chips) 
Seat 5: grenha1972 (€1.85 in chips) 
Seat 6: eneko83 (€1.80 in chips) 
elenita_nait: posts small blind €0.01
D Tasmania: posts big blind €0.02
*** HOLE CARDS ***
Dealt to pipinoelbreve9 [3s Kd]
pipinoelbreve9: folds 
grenha1972: folds 
eneko83: folds 
joanmi_sanchez: raises €0.03 to €0.05
elenita_nait: raises €1.96 to €2.01 and is all-in
D Tasmania: folds 
joanmi_sanchez: folds 
Uncalled bet (€1.96) returned to elenita_nait
elenita_nait collected €0.12 from pot
elenita_nait: doesn't show hand 
*** SUMMARY ***
Total pot €0.12 | Rake €0 
Seat 1: joanmi_sanchez (button) folded before Flop
Seat 2: elenita_nait (small blind) collected (€0.12)
Seat 3: D Tasmania (big blind) folded before Flop
Seat 4: pipinoelbreve9 folded before Flop (didn't bet)
Seat 5: grenha1972 folded before Flop (didn't bet)
Seat 6: eneko83 folded before Flop (didn't bet)



PokerStars Zoom Hand #257607362759:  Hold'em No Limit (€0.01/€0.02) - 2025/09/04 12:55:10 CET [2025/09/04 6:55:10 ET]
Table 'Arneb' 6-max Seat #1 is the button
Seat 1: Bengball (€2.23 in chips) 
Seat 2: KillVerlaine (€2.30 in chips) 
Seat 3: more457 (€1.42 in chips) 
Seat 4: grenha1972 (€1.85 in chips) 
Seat 5: txai56 (€2.31 in chips) 
Seat 6: pipinoelbreve9 (€2.52 in chips) 
KillVerlaine: posts small blind €0.01
more457: posts big blind €0.02
*** HOLE CARDS ***
Dealt to pipinoelbreve9 [5c 5d]
grenha1972: folds 
txai56: folds 
pipinoelbreve9: raises €0.04 to €0.06
Bengball: folds 
KillVerlaine: folds 
more457: folds 
Uncalled bet (€0.04) returned to pipinoelbreve9
pipinoelbreve9 collected €0.05 from pot
pipinoelbreve9: doesn't show hand 
*** SUMMARY ***
Total pot €0.05 | Rake €0 
Seat 1: Bengball (button) folded before Flop (didn't bet)
Seat 2: KillVerlaine (small blind) folded before Flop
Seat 3: more457 (big blind) folded before Flop
Seat 4: grenha1972 folded before Flop (didn't bet)
Seat 5: txai56 folded before Flop (didn't bet)
Seat 6: pipinoelbreve9 collected (€0.05)



PokerStars Zoom Hand #257607363766:  Hold'em No Limit (€0.01/€0.02) - 2025/09/04 12:55:21 CET [2025/09/04 6:55:21 ET]
Table 'Arneb' 6-max Seat #1 is the button
Seat 1: MDKristian (€2.08 in chips) 
Seat 2: eneko83 (€1.78 in chips) 
Seat 3: pipinoelbreve9 (€2.55 in chips) 
Seat 4: DavSnook (€1.92 in chips) 
Seat 5: more457 (€1.40 in chips) 
Seat 6: morganlee66 (€1.70 in chips) 
eneko83: posts small blind €0.01
pipinoelbreve9: posts big blind €0.02
*** HOLE CARDS ***
Dealt to pipinoelbreve9 [4h 4c]
DavSnook: folds 
more457: folds 
morganlee66: folds 
MDKristian: folds 
eneko83: folds 
Uncalled bet (€0.01) returned to pipinoelbreve9
pipinoelbreve9 collected €0.02 from pot
pipinoelbreve9: doesn't show hand 
*** SUMMARY ***
Total pot €0.02 | Rake €0 
Seat 1: MDKristian (button) folded before Flop (didn't bet)
Seat 2: eneko83 (small blind) folded before Flop
Seat 3: pipinoelbreve9 (big blind) collected (€0.02)
Seat 4: DavSnook folded before Flop (didn't bet)
Seat 5: more457 folded before Flop (didn't bet)
Seat 6: morganlee66 folded before Flop (didn't bet)



PokerStars Zoom Hand #257607364545:  Hold'em No Limit (€0.01/€0.02) - 2025/09/04 12:55:31 CET [2025/09/04 6:55:31 ET]
Table 'Arneb' 6-max Seat #1 is the button
Seat 1: spoke_6969 (€2.09 in chips) 
Seat 2: pipinoelbreve9 (€2.56 in chips) 
Seat 3: AlonsoSf24 (€1.45 in chips) 
Seat 4: joanmi_sanchez (€2.38 in chips) 
Seat 5: MDKristian (€2.30 in chips) 
Seat 6: D Tasmania (€1.34 in chips) 
pipinoelbreve9: posts small blind €0.01
AlonsoSf24: posts big blind €0.02
*** HOLE CARDS ***
Dealt to pipinoelbreve9 [Qh As]
joanmi_sanchez: folds 
MDKristian: folds 
D Tasmania: folds 
spoke_6969: folds 
pipinoelbreve9: raises €0.04 to €0.06
AlonsoSf24: calls €0.04
*** FLOP *** [Tc Ah Js]
pipinoelbreve9: bets €0.04
AlonsoSf24: folds 
Uncalled bet (€0.04) returned to pipinoelbreve9
pipinoelbreve9 collected €0.11 from pot
pipinoelbreve9: doesn't show hand 
*** SUMMARY ***
Total pot €0.12 | Rake €0.01 
Board [Tc Ah Js]
Seat 1: spoke_6969 (button) folded before Flop (didn't bet)
Seat 2: pipinoelbreve9 (small blind) collected (€0.11)
Seat 3: AlonsoSf24 (big blind) folded on the Flop
Seat 4: joanmi_sanchez folded before Flop (didn't bet)
Seat 5: MDKristian folded before Flop (didn't bet)
Seat 6: D Tasmania folded before Flop (didn't bet)



PokerStars Zoom Hand #257607366696:  Hold'em No Limit (€0.01/€0.02) - 2025/09/04 12:55:56 CET [2025/09/04 6:55:56 ET]
Table 'Arneb' 6-max Seat #1 is the button
Seat 1: pipinoelbreve9 (€2.61 in chips) 
Seat 2: joanmi_sanchez (€2.36 in chips) 
Seat 3: D Tasmania (€1.34 in chips) 
Seat 4: Danipro178 (€2.05 in chips) 
Seat 5: grenha1972 (€3.39 in chips) 
Seat 6: more457 (€0.61 in chips) 
joanmi_sanchez: posts small blind €0.01
D Tasmania: posts big blind €0.02
*** HOLE CARDS ***
Dealt to pipinoelbreve9 [5s 2d]
Danipro178: folds 
grenha1972: folds 
more457: folds 
pipinoelbreve9: folds 
joanmi_sanchez: folds 
Uncalled bet (€0.01) returned to D Tasmania
D Tasmania collected €0.02 from pot
D Tasmania: doesn't show hand 
*** SUMMARY ***
Total pot €0.02 | Rake €0 
Seat 1: pipinoelbreve9 (button) folded before Flop (didn't bet)
Seat 2: joanmi_sanchez (small blind) folded before Flop
Seat 3: D Tasmania (big blind) collected (€0.02)
Seat 4: Danipro178 folded before Flop (didn't bet)
Seat 5: grenha1972 folded before Flop (didn't bet)
Seat 6: more457 folded before Flop (didn't bet)



PokerStars Zoom Hand #257607367318:  Hold'em No Limit (€0.01/€0.02) - 2025/09/04 12:56:04 CET [2025/09/04 6:56:04 ET]
Table 'Arneb' 6-max Seat #1 is the button
Seat 1: MDKristian (€2.05 in chips) 
Seat 2: more457 (€1.29 in chips) 
Seat 3: ThePunisher73 (€1.31 in chips) 
Seat 4: Bengball (€2.22 in chips) 
Seat 5: pipinoelbreve9 (€2.61 in chips) 
Seat 6: Danipro178 (€2 in chips) 
more457: posts small blind €0.01
ThePunisher73: posts big blind €0.02
*** HOLE CARDS ***
Dealt to pipinoelbreve9 [Th 4h]
Bengball: folds 
pipinoelbreve9: folds 
Danipro178: raises €0.04 to €0.06
MDKristian: folds 
more457: folds 
ThePunisher73: calls €0.04
*** FLOP *** [Ah Qs Qh]
ThePunisher73: checks 
Danipro178: checks 
*** TURN *** [Ah Qs Qh] [4d]
ThePunisher73: checks 
Danipro178: checks 
*** RIVER *** [Ah Qs Qh 4d] [Ts]
ThePunisher73: bets €0.02
Danipro178: folds 
Uncalled bet (€0.02) returned to ThePunisher73
ThePunisher73 collected €0.12 from pot
ThePunisher73: doesn't show hand 
*** SUMMARY ***
Total pot €0.13 | Rake €0.01 
Board [Ah Qs Qh 4d Ts]
Seat 1: MDKristian (button) folded before Flop (didn't bet)
Seat 2: more457 (small blind) folded before Flop
Seat 3: ThePunisher73 (big blind) collected (€0.12)
Seat 4: Bengball folded before Flop (didn't bet)
Seat 5: pipinoelbreve9 folded before Flop (didn't bet)
Seat 6: Danipro178 folded on the River



PokerStars Zoom Hand #257607368353:  Hold'em No Limit (€0.01/€0.02) - 2025/09/04 12:56:16 CET [2025/09/04 6:56:16 ET]
Table 'Arneb' 6-max Seat #1 is the button
Seat 1: DavSnook (€4.57 in chips) 
Seat 2: morenovlcia (€1.11 in chips) 
Seat 3: MDKristian (€2.05 in chips) 
Seat 4: thenry03 (€2.63 in chips) 
Seat 5: pipinoelbreve9 (€2.61 in chips) 
Seat 6: Bengball (€2.28 in chips) 
morenovlcia: posts small blind €0.01
MDKristian: posts big blind €0.02
*** HOLE CARDS ***
Dealt to pipinoelbreve9 [9c 3s]
thenry03: folds 
pipinoelbreve9: folds 
Bengball: raises €0.03 to €0.05
DavSnook: folds 
morenovlcia: calls €0.04
MDKristian: calls €0.03
*** FLOP *** [Td Jc 4h]
morenovlcia: checks 
MDKristian: checks 
Bengball: bets €0.05
morenovlcia: calls €0.05
MDKristian: folds 
*** TURN *** [Td Jc 4h] [Kd]
morenovlcia: checks 
Bengball: bets €0.20
morenovlcia: folds 
Uncalled bet (€0.20) returned to Bengball
Bengball collected €0.24 from pot
Bengball: doesn't show hand 
*** SUMMARY ***
Total pot €0.25 | Rake €0.01 
Board [Td Jc 4h Kd]
Seat 1: DavSnook (button) folded before Flop (didn't bet)
Seat 2: morenovlcia (small blind) folded on the Turn
Seat 3: MDKristian (big blind) folded on the Flop
Seat 4: thenry03 folded before Flop (didn't bet)
Seat 5: pipinoelbreve9 folded before Flop (didn't bet)
Seat 6: Bengball collected (€0.24)



PokerStars Zoom Hand #257607368881:  Hold'em No Limit (€0.01/€0.02) - 2025/09/04 12:56:22 CET [2025/09/04 6:56:22 ET]
Table 'Arneb' 6-max Seat #1 is the button
Seat 1: pipinoelbreve9 (€2.61 in chips) 
Seat 2: grenha1972 (€3.35 in chips) 
Seat 3: yaya7938 (€0.64 in chips) 
Seat 4: more457 (€1.28 in chips) 
Seat 5: @RobarTevoy99 (€1.64 in chips) 
Seat 6: mari197721 (€1.78 in chips) 
grenha1972: posts small blind €0.01
yaya7938: posts big blind €0.02
*** HOLE CARDS ***
Dealt to pipinoelbreve9 [8s 8d]
more457: folds 
@RobarTevoy99: folds 
mari197721: raises €0.02 to €0.04
pipinoelbreve9: raises €0.08 to €0.12
grenha1972: folds 
yaya7938: folds 
mari197721: calls €0.08
*** FLOP *** [2d 8h 9s]
mari197721: checks 
pipinoelbreve9: bets €0.11
mari197721: raises €0.48 to €0.59
pipinoelbreve9: raises €1.90 to €2.49 and is all-in
mari197721: calls €1.07 and is all-in
Uncalled bet (€0.83) returned to pipinoelbreve9
*** TURN *** [2d 8h 9s] [5h]
*** RIVER *** [2d 8h 9s 5h] [Qh]
*** SHOW DOWN ***
mari197721: shows [7h 9d] (a pair of Nines)
pipinoelbreve9: shows [8s 8d] (three of a kind, Eights)
pipinoelbreve9 collected €3.41 from pot
*** SUMMARY ***
Total pot €3.59 | Rake €0.18 
Board [2d 8h 9s 5h Qh]
Seat 1: pipinoelbreve9 (button) showed [8s 8d] and won (€3.41) with three of a kind, Eights
Seat 2: grenha1972 (small blind) folded before Flop
Seat 3: yaya7938 (big blind) folded before Flop
Seat 4: more457 folded before Flop (didn't bet)
Seat 5: @RobarTevoy99 folded before Flop (didn't bet)
Seat 6: mari197721 showed [7h 9d] and lost with a pair of Nines



PokerStars Zoom Hand #257607372307:  Hold'em No Limit (€0.01/€0.02) - 2025/09/04 12:57:02 CET [2025/09/04 6:57:02 ET]
Table 'Arneb' 6-max Seat #1 is the button
Seat 1: marcel13013 (€1.48 in chips) 
Seat 2: Danipro178 (€2 in chips) 
Seat 3: Zorgue1080 (€2 in chips) 
Seat 4: AlonsoSf24 (€1.44 in chips) 
Seat 5: mathangele (€1.97 in chips) 
Seat 6: pipinoelbreve9 (€4.24 in chips) 
Danipro178: posts small blind €0.01
Zorgue1080: posts big blind €0.02
*** HOLE CARDS ***
Dealt to pipinoelbreve9 [Td Qd]
AlonsoSf24: calls €0.02
mathangele: folds 
pipinoelbreve9: raises €0.04 to €0.06
marcel13013: folds 
Danipro178: raises €0.18 to €0.24
Zorgue1080: folds 
AlonsoSf24: folds 
pipinoelbreve9: calls €0.18
*** FLOP *** [Kh 4c Qc]
Danipro178: bets €0.16
pipinoelbreve9: calls €0.16
*** TURN *** [Kh 4c Qc] [7d]
Danipro178: bets €0.60
pipinoelbreve9: folds 
Uncalled bet (€0.60) returned to Danipro178
Danipro178 collected €0.80 from pot
Danipro178: doesn't show hand 
*** SUMMARY ***
Total pot €0.84 | Rake €0.04 
Board [Kh 4c Qc 7d]
Seat 1: marcel13013 (button) folded before Flop (didn't bet)
Seat 2: Danipro178 (small blind) collected (€0.80)
Seat 3: Zorgue1080 (big blind) folded before Flop
Seat 4: AlonsoSf24 folded before Flop
Seat 5: mathangele folded before Flop (didn't bet)
Seat 6: pipinoelbreve9 folded on the Turn



PokerStars Zoom Hand #257607379524:  Hold'em No Limit (€0.01/€0.02) - 2025/09/04 12:58:28 CET [2025/09/04 6:58:28 ET]
Table 'Arneb' 6-max Seat #1 is the button
Seat 1: marcel13013 (€3.19 in chips) 
Seat 2: pipinoelbreve9 (€3.84 in chips) 
Seat 3: perkales133 (€1.92 in chips) 
Seat 4: elenita_nait (€2.05 in chips) 
Seat 5: @RobarTevoy99 (€2.75 in chips) 
Seat 6: McMack626 (€3.51 in chips) 
pipinoelbreve9: posts small blind €0.01
perkales133: posts big blind €0.02
*** HOLE CARDS ***
Dealt to pipinoelbreve9 [3d 5c]
elenita_nait: folds 
@RobarTevoy99: raises €0.05 to €0.07
McMack626: folds 
marcel13013: calls €0.07
pipinoelbreve9: folds 
perkales133: folds 
*** FLOP *** [5s Kh Qs]
@RobarTevoy99: checks 
marcel13013: checks 
*** TURN *** [5s Kh Qs] [7d]
@RobarTevoy99: bets €0.08
marcel13013: folds 
Uncalled bet (€0.08) returned to @RobarTevoy99
@RobarTevoy99 collected €0.16 from pot
@RobarTevoy99: doesn't show hand 
*** SUMMARY ***
Total pot €0.17 | Rake €0.01 
Board [5s Kh Qs 7d]
Seat 1: marcel13013 (button) folded on the Turn
Seat 2: pipinoelbreve9 (small blind) folded before Flop
Seat 3: perkales133 (big blind) folded before Flop
Seat 4: elenita_nait folded before Flop (didn't bet)
Seat 5: @RobarTevoy99 collected (€0.16)
Seat 6: McMack626 folded before Flop (didn't bet)



PokerStars Zoom Hand #257607411261:  Hold'em No Limit (€0.01/€0.02) - 2025/09/04 13:03:57 CET [2025/09/04 7:03:57 ET]
Table 'Arneb' 6-max Seat #1 is the button
Seat 1: Zorgue1080 (€2.55 in chips) 
Seat 2: pipinoelbreve9 (€3.81 in chips) 
Seat 3: chouchenne47400 (€2.05 in chips) 
Seat 4: dav306 (€1.77 in chips) 
Seat 5: belcebubu (€2 in chips) 
Seat 6: MDKristian (€2.03 in chips) 
pipinoelbreve9: posts small blind €0.01
chouchenne47400: posts big blind €0.02
*** HOLE CARDS ***
Dealt to pipinoelbreve9 [Ts 2c]
dav306: folds 
belcebubu: folds 
MDKristian: raises €0.02 to €0.04
Zorgue1080: folds 
pipinoelbreve9: folds 
chouchenne47400: folds 
Uncalled bet (€0.02) returned to MDKristian
MDKristian collected €0.05 from pot
MDKristian: doesn't show hand 
*** SUMMARY ***
Total pot €0.05 | Rake €0 
Seat 1: Zorgue1080 (button) folded before Flop (didn't bet)
Seat 2: pipinoelbreve9 (small blind) folded before Flop
Seat 3: chouchenne47400 (big blind) folded before Flop
Seat 4: dav306 folded before Flop (didn't bet)
Seat 5: belcebubu folded before Flop (didn't bet)
Seat 6: MDKristian collected (€0.05)



PokerStars Zoom Hand #257607409965:  Hold'em No Limit (€0.01/€0.02) - 2025/09/04 13:03:45 CET [2025/09/04 7:03:45 ET]
Table 'Arneb' 6-max Seat #1 is the button
Seat 1: QUIB76 (€1.97 in chips) 
Seat 2: thenry03 (€2.36 in chips) 
Seat 3: pipinoelbreve9 (€3.83 in chips) 
Seat 4: 77samuel33 (€6.93 in chips) 
Seat 5: Bengball (€2.86 in chips) 
Seat 6: MDKristian (€2 in chips) 
thenry03: posts small blind €0.01
pipinoelbreve9: posts big blind €0.02
*** HOLE CARDS ***
Dealt to pipinoelbreve9 [Ad 4c]
77samuel33: folds 
Bengball: folds 
MDKristian: raises €0.04 to €0.06
QUIB76: calls €0.06
thenry03: folds 
pipinoelbreve9: folds 
*** FLOP *** [8h 2s 6s]
MDKristian: checks 
QUIB76: checks 
*** TURN *** [8h 2s 6s] [2h]
MDKristian: checks 
QUIB76: checks 
*** RIVER *** [8h 2s 6s 2h] [Kd]
MDKristian: bets €0.07
QUIB76: folds 
Uncalled bet (€0.07) returned to MDKristian
MDKristian collected €0.14 from pot
MDKristian: doesn't show hand 
*** SUMMARY ***
Total pot €0.15 | Rake €0.01 
Board [8h 2s 6s 2h Kd]
Seat 1: QUIB76 (button) folded on the River
Seat 2: thenry03 (small blind) folded before Flop
Seat 3: pipinoelbreve9 (big blind) folded before Flop
Seat 4: 77samuel33 folded before Flop (didn't bet)
Seat 5: Bengball folded before Flop (didn't bet)
Seat 6: MDKristian collected (€0.14)



PokerStars Zoom Hand #257607411745:  Hold'em No Limit (€0.01/€0.02) - 2025/09/04 13:04:02 CET [2025/09/04 7:04:02 ET]
Table 'Arneb' 6-max Seat #1 is the button
Seat 1: pipinoelbreve9 (€3.80 in chips) 
Seat 2: Zorgue1080 (€2.55 in chips) 
Seat 3: odace15 (€2 in chips) 
Seat 4: SrLyrox (€5.54 in chips) 
Seat 5: CondeVnCount (€2.05 in chips) 
Seat 6: belcebubu (€2 in chips) 
Zorgue1080: posts small blind €0.01
odace15: posts big blind €0.02
*** HOLE CARDS ***
Dealt to pipinoelbreve9 [4d 9d]
SrLyrox: folds 
CondeVnCount: folds 
belcebubu: folds 
pipinoelbreve9: folds 
Zorgue1080: folds 
Uncalled bet (€0.01) returned to odace15
odace15 collected €0.02 from pot
odace15: doesn't show hand 
*** SUMMARY ***
Total pot €0.02 | Rake €0 
Seat 1: pipinoelbreve9 (button) folded before Flop (didn't bet)
Seat 2: Zorgue1080 (small blind) folded before Flop
Seat 3: odace15 (big blind) collected (€0.02)
Seat 4: SrLyrox folded before Flop (didn't bet)
Seat 5: CondeVnCount folded before Flop (didn't bet)
Seat 6: belcebubu folded before Flop (didn't bet)



PokerStars Zoom Hand #257607412532:  Hold'em No Limit (€0.01/€0.02) - 2025/09/04 13:04:09 CET [2025/09/04 7:04:09 ET]
Table 'Arneb' 6-max Seat #1 is the button
Seat 1: SrLyrox (€5.53 in chips) 
Seat 2: dav306 (€1.77 in chips) 
Seat 3: David el Santos (€2 in chips) 
Seat 4: Xplotas (€3.44 in chips) 
Seat 5: QUIB76 (€1.91 in chips) 
Seat 6: pipinoelbreve9 (€3.80 in chips) 
dav306: posts small blind €0.01
David el Santos: posts big blind €0.02
*** HOLE CARDS ***
Dealt to pipinoelbreve9 [Qs Qd]
Xplotas: raises €0.03 to €0.05
QUIB76: calls €0.05
pipinoelbreve9: raises €0.15 to €0.20
SrLyrox: folds 
dav306: folds 
David el Santos: folds 
Xplotas: folds 
QUIB76: folds 
Uncalled bet (€0.15) returned to pipinoelbreve9
pipinoelbreve9 collected €0.18 from pot
pipinoelbreve9: doesn't show hand 
*** SUMMARY ***
Total pot €0.18 | Rake €0 
Seat 1: SrLyrox (button) folded before Flop (didn't bet)
Seat 2: dav306 (small blind) folded before Flop
Seat 3: David el Santos (big blind) folded before Flop
Seat 4: Xplotas folded before Flop
Seat 5: QUIB76 folded before Flop
Seat 6: pipinoelbreve9 collected (€0.18)



PokerStars Zoom Hand #257607415326:  Hold'em No Limit (€0.01/€0.02) - 2025/09/04 13:04:35 CET [2025/09/04 7:04:35 ET]
Table 'Arneb' 6-max Seat #1 is the button
Seat 1: odace15 (€2 in chips) 
Seat 2: CondeVnCount (€2.03 in chips) 
Seat 3: morganlee66 (€2.37 in chips) 
Seat 4: Danipro178 (€2.20 in chips) 
Seat 5: pipinoelbreve9 (€3.93 in chips) 
Seat 6: QUIB76 (€1.86 in chips) 
CondeVnCount: posts small blind €0.01
morganlee66: posts big blind €0.02
*** HOLE CARDS ***
Dealt to pipinoelbreve9 [9d 8c]
Danipro178: folds 
pipinoelbreve9: folds 
QUIB76: calls €0.02
odace15: raises €0.06 to €0.08
CondeVnCount: folds 
morganlee66: folds 
QUIB76: calls €0.06
*** FLOP *** [6h Td 8d]
QUIB76: checks 
odace15: bets €0.14
QUIB76: folds 
Uncalled bet (€0.14) returned to odace15
odace15 collected €0.18 from pot
odace15: doesn't show hand 
*** SUMMARY ***
Total pot €0.19 | Rake €0.01 
Board [6h Td 8d]
Seat 1: odace15 (button) collected (€0.18)
Seat 2: CondeVnCount (small blind) folded before Flop
Seat 3: morganlee66 (big blind) folded before Flop
Seat 4: Danipro178 folded before Flop (didn't bet)
Seat 5: pipinoelbreve9 folded before Flop (didn't bet)
Seat 6: QUIB76 folded on the Flop



PokerStars Zoom Hand #257607415831:  Hold'em No Limit (€0.01/€0.02) - 2025/09/04 13:04:40 CET [2025/09/04 7:04:40 ET]
Table 'Arneb' 6-max Seat #1 is the button
Seat 1: MDKristian (€2.01 in chips) 
Seat 2: pipinoelbreve9 (€3.93 in chips) 
Seat 3: AngelAvilaAA (€1.62 in chips) 
Seat 4: belcebubu (€1.99 in chips) 
Seat 5: D Tasmania (€2.87 in chips) 
Seat 6: CondeVnCount (€2.19 in chips) 
pipinoelbreve9: posts small blind €0.01
AngelAvilaAA: posts big blind €0.02
*** HOLE CARDS ***
Dealt to pipinoelbreve9 [8c 9s]
belcebubu: folds 
D Tasmania: raises €0.03 to €0.05
CondeVnCount: folds 
MDKristian: folds 
pipinoelbreve9: folds 
AngelAvilaAA: calls €0.03
*** FLOP *** [2c 8d Qd]
AngelAvilaAA: bets €0.04
D Tasmania: folds 
Uncalled bet (€0.04) returned to AngelAvilaAA
AngelAvilaAA collected €0.10 from pot
AngelAvilaAA: doesn't show hand 
*** SUMMARY ***
Total pot €0.11 | Rake €0.01 
Board [2c 8d Qd]
Seat 1: MDKristian (button) folded before Flop (didn't bet)
Seat 2: pipinoelbreve9 (small blind) folded before Flop
Seat 3: AngelAvilaAA (big blind) collected (€0.10)
Seat 4: belcebubu folded before Flop (didn't bet)
Seat 5: D Tasmania folded on the Flop
Seat 6: CondeVnCount folded before Flop (didn't bet)



PokerStars Zoom Hand #257607416572:  Hold'em No Limit (€0.01/€0.02) - 2025/09/04 13:04:47 CET [2025/09/04 7:04:47 ET]
Table 'Arneb' 6-max Seat #1 is the button
Seat 1: morganlee66 (€2.35 in chips) 
Seat 2: @RobarTevoy99 (€2.57 in chips) 
Seat 3: Bengball (€2.82 in chips) 
Seat 4: cruass (€1.96 in chips) 
Seat 5: pipinoelbreve9 (€3.92 in chips) 
Seat 6: belcebubu (€2.06 in chips) 
@RobarTevoy99: posts small blind €0.01
Bengball: posts big blind €0.02
*** HOLE CARDS ***
Dealt to pipinoelbreve9 [5s Tc]
cruass: folds 
pipinoelbreve9: folds 
belcebubu: raises €0.04 to €0.06
morganlee66: raises €0.12 to €0.18
@RobarTevoy99: folds 
Bengball: folds 
belcebubu: calls €0.12
*** FLOP *** [6s 8s 8h]
belcebubu: checks 
morganlee66: bets €0.19
belcebubu: folds 
Uncalled bet (€0.19) returned to morganlee66
morganlee66 collected €0.37 from pot
morganlee66: doesn't show hand 
*** SUMMARY ***
Total pot €0.39 | Rake €0.02 
Board [6s 8s 8h]
Seat 1: morganlee66 (button) collected (€0.37)
Seat 2: @RobarTevoy99 (small blind) folded before Flop
Seat 3: Bengball (big blind) folded before Flop
Seat 4: cruass folded before Flop (didn't bet)
Seat 5: pipinoelbreve9 folded before Flop (didn't bet)
Seat 6: belcebubu folded on the Flop



PokerStars Zoom Hand #257607417185:  Hold'em No Limit (€0.01/€0.02) - 2025/09/04 13:04:53 CET [2025/09/04 7:04:53 ET]
Table 'Arneb' 6-max Seat #1 is the button
Seat 1: Danipro178 (€2.85 in chips) 
Seat 2: CondeVnCount (€2.02 in chips) 
Seat 3: pipinoelbreve9 (€3.92 in chips) 
Seat 4: 77samuel33 (€6.90 in chips) 
Seat 5: pokerikb (€2.21 in chips) 
Seat 6: odace15 (€2 in chips) 
CondeVnCount: posts small blind €0.01
pipinoelbreve9: posts big blind €0.02
*** HOLE CARDS ***
Dealt to pipinoelbreve9 [Ah 8s]
77samuel33: folds 
pokerikb has timed out
pokerikb: folds 
odace15: raises €0.04 to €0.06
Danipro178: folds 
CondeVnCount: folds 
pipinoelbreve9: calls €0.04
*** FLOP *** [Qc Ad Js]
pipinoelbreve9: checks 
odace15: bets €0.06
pipinoelbreve9: calls €0.06
*** TURN *** [Qc Ad Js] [9s]
pipinoelbreve9: bets €0.12
odace15: folds 
Uncalled bet (€0.12) returned to pipinoelbreve9
pipinoelbreve9 collected €0.24 from pot
pipinoelbreve9: doesn't show hand 
*** SUMMARY ***
Total pot €0.25 | Rake €0.01 
Board [Qc Ad Js 9s]
Seat 1: Danipro178 (button) folded before Flop (didn't bet)
Seat 2: CondeVnCount (small blind) folded before Flop
Seat 3: pipinoelbreve9 (big blind) collected (€0.24)
Seat 4: 77samuel33 folded before Flop (didn't bet)
Seat 5: pokerikb folded before Flop (didn't bet)
Seat 6: odace15 folded on the Turn



PokerStars Zoom Hand #257607423063:  Hold'em No Limit (€0.01/€0.02) - 2025/09/04 13:05:49 CET [2025/09/04 7:05:49 ET]
Table 'Arneb' 6-max Seat #1 is the button
Seat 1: pipinoelbreve9 (€4.04 in chips) 
Seat 2: MDKristian (€2.10 in chips) 
Seat 3: damastodas (€1.31 in chips) 
Seat 4: cruass (€1.91 in chips) 
Seat 5: Zorgue1080 (€2.89 in chips) 
Seat 6: 77samuel33 (€2.36 in chips) 
MDKristian: posts small blind €0.01
damastodas: posts big blind €0.02
*** HOLE CARDS ***
Dealt to pipinoelbreve9 [4d Jh]
cruass: folds 
Zorgue1080: folds 
77samuel33: folds 
pipinoelbreve9: folds 
MDKristian: folds 
Uncalled bet (€0.01) returned to damastodas
damastodas collected €0.02 from pot
damastodas: doesn't show hand 
*** SUMMARY ***
Total pot €0.02 | Rake €0 
Seat 1: pipinoelbreve9 (button) folded before Flop (didn't bet)
Seat 2: MDKristian (small blind) folded before Flop
Seat 3: damastodas (big blind) collected (€0.02)
Seat 4: cruass folded before Flop (didn't bet)
Seat 5: Zorgue1080 folded before Flop (didn't bet)
Seat 6: 77samuel33 folded before Flop (didn't bet)



PokerStars Zoom Hand #257607423494:  Hold'em No Limit (€0.01/€0.02) - 2025/09/04 13:05:53 CET [2025/09/04 7:05:53 ET]
Table 'Arneb' 6-max Seat #1 is the button
Seat 1: hernandS&G (€2.02 in chips) 
Seat 2: @RobarTevoy99 (€1.44 in chips) 
Seat 3: Zorgue1080 (€0.97 in chips) 
Seat 4: pipinoelbreve9 (€4.04 in chips) 
Seat 5: pokerikb (€2.35 in chips) 
Seat 6: Danipro178 (€2.78 in chips) 
@RobarTevoy99: posts small blind €0.01
Zorgue1080: posts big blind €0.02
*** HOLE CARDS ***
Dealt to pipinoelbreve9 [7c Ac]
pipinoelbreve9: raises €0.04 to €0.06
pokerikb: folds 
Danipro178: folds 
hernandS&G: folds 
@RobarTevoy99: folds 
Zorgue1080: folds 
Uncalled bet (€0.04) returned to pipinoelbreve9
pipinoelbreve9 collected €0.05 from pot
pipinoelbreve9: doesn't show hand 
*** SUMMARY ***
Total pot €0.05 | Rake €0 
Seat 1: hernandS&G (button) folded before Flop (didn't bet)
Seat 2: @RobarTevoy99 (small blind) folded before Flop
Seat 3: Zorgue1080 (big blind) folded before Flop
Seat 4: pipinoelbreve9 collected (€0.05)
Seat 5: pokerikb folded before Flop (didn't bet)
Seat 6: Danipro178 folded before Flop (didn't bet)



PokerStars Zoom Hand #257607426466:  Hold'em No Limit (€0.01/€0.02) - 2025/09/04 13:06:23 CET [2025/09/04 7:06:23 ET]
Table 'Arneb' 6-max Seat #1 is the button
Seat 1: pokerikb (€2.37 in chips) 
Seat 2: Danipro178 (€2.14 in chips) 
Seat 3: MDKristian (€2.14 in chips) 
Seat 4: damastodas (€1.32 in chips) 
Seat 5: odace15 (€2 in chips) 
Seat 6: pipinoelbreve9 (€4.07 in chips) 
Danipro178: posts small blind €0.01
MDKristian: posts big blind €0.02
*** HOLE CARDS ***
Dealt to pipinoelbreve9 [3s Js]
damastodas: folds 
odace15: folds 
pipinoelbreve9: folds 
pokerikb: raises €0.03 to €0.05
Danipro178: folds 
MDKristian: folds 
Uncalled bet (€0.03) returned to pokerikb
pokerikb collected €0.05 from pot
pokerikb: doesn't show hand 
*** SUMMARY ***
Total pot €0.05 | Rake €0 
Seat 1: pokerikb (button) collected (€0.05)
Seat 2: Danipro178 (small blind) folded before Flop
Seat 3: MDKristian (big blind) folded before Flop
Seat 4: damastodas folded before Flop (didn't bet)
Seat 5: odace15 folded before Flop (didn't bet)
Seat 6: pipinoelbreve9 folded before Flop (didn't bet)



PokerStars Zoom Hand #257607428047:  Hold'em No Limit (€0.01/€0.02) - 2025/09/04 13:06:38 CET [2025/09/04 7:06:38 ET]
Table 'Arneb' 6-max Seat #1 is the button
Seat 1: thenry03 (€2.50 in chips) 
Seat 2: AngelAvilaAA (€1.84 in chips) 
Seat 3: morganlee66 (€2.65 in chips) 
Seat 4: pokerikb (€2.30 in chips) 
Seat 5: pipinoelbreve9 (€4.07 in chips) 
Seat 6: D Tasmania (€3.06 in chips) 
AngelAvilaAA: posts small blind €0.01
morganlee66: posts big blind €0.02
*** HOLE CARDS ***
Dealt to pipinoelbreve9 [6c Td]
pokerikb: folds 
pipinoelbreve9: folds 
D Tasmania: folds 
thenry03: folds 
AngelAvilaAA: folds 
Uncalled bet (€0.01) returned to morganlee66
morganlee66 collected €0.02 from pot
morganlee66: doesn't show hand 
*** SUMMARY ***
Total pot €0.02 | Rake €0 
Seat 1: thenry03 (button) folded before Flop (didn't bet)
Seat 2: AngelAvilaAA (small blind) folded before Flop
Seat 3: morganlee66 (big blind) collected (€0.02)
Seat 4: pokerikb folded before Flop (didn't bet)
Seat 5: pipinoelbreve9 folded before Flop (didn't bet)
Seat 6: D Tasmania folded before Flop (didn't bet)



PokerStars Zoom Hand #257607428714:  Hold'em No Limit (€0.01/€0.02) - 2025/09/04 13:06:45 CET [2025/09/04 7:06:45 ET]
Table 'Arneb' 6-max Seat #1 is the button
Seat 1: MDKristian (€2.11 in chips) 
Seat 2: D Tasmania (€1.67 in chips) 
Seat 3: pipinoelbreve9 (€4.07 in chips) 
Seat 4: David el Santos (€1.50 in chips) 
Seat 5: AngelAvilaAA (€1.83 in chips) 
Seat 6: hernandS&G (€2.14 in chips) 
D Tasmania: posts small blind €0.01
pipinoelbreve9: posts big blind €0.02
*** HOLE CARDS ***
Dealt to pipinoelbreve9 [8c Qh]
David el Santos: folds 
AngelAvilaAA: folds 
hernandS&G: raises €0.04 to €0.06
MDKristian: folds 
D Tasmania: folds 
pipinoelbreve9: folds 
Uncalled bet (€0.04) returned to hernandS&G
hernandS&G collected €0.05 from pot
hernandS&G: doesn't show hand 
*** SUMMARY ***
Total pot €0.05 | Rake €0 
Seat 1: MDKristian (button) folded before Flop (didn't bet)
Seat 2: D Tasmania (small blind) folded before Flop
Seat 3: pipinoelbreve9 (big blind) folded before Flop
Seat 4: David el Santos folded before Flop (didn't bet)
Seat 5: AngelAvilaAA folded before Flop (didn't bet)
Seat 6: hernandS&G collected (€0.05)



PokerStars Zoom Hand #257607427412:  Hold'em No Limit (€0.01/€0.02) - 2025/09/04 13:06:32 CET [2025/09/04 7:06:32 ET]
Table 'Arneb' 6-max Seat #1 is the button
Seat 1: spoke_6969 (€3.05 in chips) 
Seat 2: belcebubu (€1.92 in chips) 
Seat 3: RCSA2 (€1.85 in chips) 
Seat 4: pipinoelbreve9 (€4.07 in chips) 
Seat 5: canokiller (€2.13 in chips) 
Seat 6: Zorgue1080 (€3.32 in chips) 
belcebubu: posts small blind €0.01
RCSA2: posts big blind €0.02
*** HOLE CARDS ***
Dealt to pipinoelbreve9 [4h 4s]
pipinoelbreve9: folds 
canokiller: folds 
Zorgue1080: folds 
spoke_6969: folds 
belcebubu: raises €0.02 to €0.04
RCSA2: calls €0.02
*** FLOP *** [2h Ks 2s]
belcebubu: bets €0.04
RCSA2: folds 
Uncalled bet (€0.04) returned to belcebubu
belcebubu collected €0.08 from pot
belcebubu: doesn't show hand 
*** SUMMARY ***
Total pot €0.08 | Rake €0 
Board [2h Ks 2s]
Seat 1: spoke_6969 (button) folded before Flop (didn't bet)
Seat 2: belcebubu (small blind) collected (€0.08)
Seat 3: RCSA2 (big blind) folded on the Flop
Seat 4: pipinoelbreve9 folded before Flop (didn't bet)
Seat 5: canokiller folded before Flop (didn't bet)
Seat 6: Zorgue1080 folded before Flop (didn't bet)



PokerStars Zoom Hand #257607430143:  Hold'em No Limit (€0.01/€0.02) - 2025/09/04 13:06:59 CET [2025/09/04 7:06:59 ET]
Table 'Arneb' 6-max Seat #1 is the button
Seat 1: TheKing2K888 (€1.17 in chips) 
Seat 2: pipinoelbreve9 (€4.05 in chips) 
Seat 3: odace15 (€2 in chips) 
Seat 4: MDKristian (€2.11 in chips) 
Seat 5: eneko83 (€2 in chips) 
Seat 6: Danipro178 (€2.16 in chips) 
pipinoelbreve9: posts small blind €0.01
odace15: posts big blind €0.02
*** HOLE CARDS ***
Dealt to pipinoelbreve9 [4d 4h]
MDKristian: folds 
eneko83: folds 
Danipro178: folds 
TheKing2K888: raises €0.04 to €0.06
pipinoelbreve9: calls €0.05
odace15: calls €0.04
*** FLOP *** [9s 5s Th]
pipinoelbreve9: checks 
odace15: checks 
TheKing2K888: bets €0.24
pipinoelbreve9: folds 
odace15: folds 
Uncalled bet (€0.24) returned to TheKing2K888
TheKing2K888 collected €0.17 from pot
TheKing2K888: doesn't show hand 
*** SUMMARY ***
Total pot €0.18 | Rake €0.01 
Board [9s 5s Th]
Seat 1: TheKing2K888 (button) collected (€0.17)
Seat 2: pipinoelbreve9 (small blind) folded on the Flop
Seat 3: odace15 (big blind) folded on the Flop
Seat 4: MDKristian folded before Flop (didn't bet)
Seat 5: eneko83 folded before Flop (didn't bet)
Seat 6: Danipro178 folded before Flop (didn't bet)



PokerStars Zoom Hand #257607433551:  Hold'em No Limit (€0.01/€0.02) - 2025/09/04 13:07:31 CET [2025/09/04 7:07:31 ET]
Table 'Arneb' 6-max Seat #1 is the button
Seat 1: David el Santos (€1.64 in chips) 
Seat 2: RCSA2 (€1.80 in chips) 
Seat 3: QUIB76 (€2.51 in chips) 
Seat 4: CondeVnCount (€2.30 in chips) 
Seat 5: @RobarTevoy99 (€7.73 in chips) 
Seat 6: pipinoelbreve9 (€3.99 in chips) 
RCSA2: posts small blind €0.01
QUIB76: posts big blind €0.02
*** HOLE CARDS ***
Dealt to pipinoelbreve9 [Ah Tc]
CondeVnCount: folds 
@RobarTevoy99: folds 
pipinoelbreve9: raises €0.04 to €0.06
David el Santos: folds 
RCSA2: calls €0.05
QUIB76: folds 
*** FLOP *** [Qd 8c Qh]
RCSA2: checks 
pipinoelbreve9: bets €0.05
RCSA2: folds 
Uncalled bet (€0.05) returned to pipinoelbreve9
pipinoelbreve9 collected €0.13 from pot
pipinoelbreve9: doesn't show hand 
*** SUMMARY ***
Total pot €0.14 | Rake €0.01 
Board [Qd 8c Qh]
Seat 1: David el Santos (button) folded before Flop (didn't bet)
Seat 2: RCSA2 (small blind) folded on the Flop
Seat 3: QUIB76 (big blind) folded before Flop
Seat 4: CondeVnCount folded before Flop (didn't bet)
Seat 5: @RobarTevoy99 folded before Flop (didn't bet)
Seat 6: pipinoelbreve9 collected (€0.13)



PokerStars Zoom Hand #257607437962:  Hold'em No Limit (€0.01/€0.02) - 2025/09/04 13:08:15 CET [2025/09/04 7:08:15 ET]
Table 'Arneb' 6-max Seat #1 is the button
Seat 1: Zorgue1080 (€1.09 in chips) 
Seat 2: MDKristian (€2.09 in chips) 
Seat 3: morganlee66 (€2.42 in chips) 
Seat 4: belcebubu (€1.83 in chips) 
Seat 5: odace15 (€2 in chips) 
Seat 6: pipinoelbreve9 (€4.06 in chips) 
MDKristian: posts small blind €0.01
morganlee66: posts big blind €0.02
*** HOLE CARDS ***
Dealt to pipinoelbreve9 [6d Kh]
belcebubu: folds 
odace15: folds 
pipinoelbreve9: folds 
Zorgue1080: folds 
MDKristian: folds 
Uncalled bet (€0.01) returned to morganlee66
morganlee66 collected €0.02 from pot
morganlee66: doesn't show hand 
*** SUMMARY ***
Total pot €0.02 | Rake €0 
Seat 1: Zorgue1080 (button) folded before Flop (didn't bet)
Seat 2: MDKristian (small blind) folded before Flop
Seat 3: morganlee66 (big blind) collected (€0.02)
Seat 4: belcebubu folded before Flop (didn't bet)
Seat 5: odace15 folded before Flop (didn't bet)
Seat 6: pipinoelbreve9 folded before Flop (didn't bet)



