PokerStars Zoom Hand #257554677495:  Hold'em No Limit (€0.01/€0.02) - 2025/08/31 11:41:56 CET [2025/08/31 5:41:56 ET]
Table 'Arneb' 6-max Seat #1 is the button
Seat 1: datkeire01 (€2.96 in chips) 
Seat 2: KKKJJJ730 (€5.29 in chips) 
Seat 3: juanico1977 (€2 in chips) 
Seat 4: pipinoelbreve9 (€2 in chips) 
Seat 5: ppatuky (€2.26 in chips) 
Seat 6: orosa (€2 in chips) 
KKKJJJ730: posts small blind €0.01
juanico1977: posts big blind €0.02
*** HOLE CARDS ***
Dealt to pipinoelbreve9 [Ac 5s]
pipinoelbreve9: folds 
ppatuky: folds 
orosa: raises €0.04 to €0.06
datkeire01: folds 
KKKJJJ730: raises €0.14 to €0.20
juanico1977: folds 
orosa: folds 
Uncalled bet (€0.14) returned to KKKJJJ730
KKKJJJ730 collected €0.14 from pot
KKKJJJ730: doesn't show hand 
*** SUMMARY ***
Total pot €0.14 | Rake €0 
Seat 1: datkeire01 (button) folded before Flop (didn't bet)
Seat 2: KKKJJJ730 (small blind) collected (€0.14)
Seat 3: juanico1977 (big blind) folded before Flop
Seat 4: pipinoelbreve9 folded before Flop (didn't bet)
Seat 5: ppatuky folded before Flop (didn't bet)
Seat 6: orosa folded before Flop



PokerStars Zoom Hand #257554678635:  Hold'em No Limit (€0.01/€0.02) - 2025/08/31 11:42:08 CET [2025/08/31 5:42:08 ET]
Table 'Arneb' 6-max Seat #1 is the button
Seat 1: nyko2a (€3.47 in chips) 
Seat 2: crevi_066 (€3.79 in chips) 
Seat 3: pipinoelbreve9 (€2 in chips) 
Seat 4: dragonfly2467 (€2.04 in chips) 
Seat 5: 350ZJHN (€2 in chips) 
Seat 6: orosa (€2 in chips) 
crevi_066: posts small blind €0.01
pipinoelbreve9: posts big blind €0.02
*** HOLE CARDS ***
Dealt to pipinoelbreve9 [8h 9d]
dragonfly2467: folds 
350ZJHN: raises €0.04 to €0.06
orosa: folds 
nyko2a: folds 
crevi_066: folds 
pipinoelbreve9: folds 
Uncalled bet (€0.04) returned to 350ZJHN
350ZJHN collected €0.05 from pot
350ZJHN: doesn't show hand 
*** SUMMARY ***
Total pot €0.05 | Rake €0 
Seat 1: nyko2a (button) folded before Flop (didn't bet)
Seat 2: crevi_066 (small blind) folded before Flop
Seat 3: pipinoelbreve9 (big blind) folded before Flop
Seat 4: dragonfly2467 folded before Flop (didn't bet)
Seat 5: 350ZJHN collected (€0.05)
Seat 6: orosa folded before Flop (didn't bet)



PokerStars Zoom Hand #257554680145:  Hold'em No Limit (€0.01/€0.02) - 2025/08/31 11:42:23 CET [2025/08/31 5:42:23 ET]
Table 'Arneb' 6-max Seat #1 is the button
Seat 1: crevi_066 (€3.20 in chips) 
Seat 2: pipinoelbreve9 (€2 in chips) 
Seat 3: mikpepra (€1.56 in chips) 
Seat 4: juanico1977 (€2 in chips) 
Seat 5: PausGood (€0.76 in chips) 
Seat 6: KKKJJJ730 (€3.73 in chips) 
pipinoelbreve9: posts small blind €0.01
mikpepra: posts big blind €0.02
*** HOLE CARDS ***
Dealt to pipinoelbreve9 [Kh Jd]
juanico1977: folds 
PausGood: folds 
KKKJJJ730: raises €0.03 to €0.05
crevi_066: folds 
pipinoelbreve9: calls €0.04
mikpepra: calls €0.03
*** FLOP *** [Js 9d Tc]
pipinoelbreve9: bets €0.07
mikpepra: calls €0.07
KKKJJJ730: calls €0.07
*** TURN *** [Js 9d Tc] [Qc]
pipinoelbreve9: bets €0.24
mikpepra: calls €0.24
KKKJJJ730: calls €0.24
*** RIVER *** [Js 9d Tc Qc] [8c]
pipinoelbreve9: checks 
mikpepra: checks 
KKKJJJ730: checks 
*** SHOW DOWN ***
pipinoelbreve9: shows [Kh Jd] (a straight, Nine to King)
mikpepra: mucks hand 
KKKJJJ730: mucks hand 
pipinoelbreve9 collected €1.03 from pot
*** SUMMARY ***
Total pot €1.08 | Rake €0.05 
Board [Js 9d Tc Qc 8c]
Seat 1: crevi_066 (button) folded before Flop (didn't bet)
Seat 2: pipinoelbreve9 (small blind) showed [Kh Jd] and won (€1.03) with a straight, Nine to King
Seat 3: mikpepra (big blind) mucked [Ts Qd]
Seat 4: juanico1977 folded before Flop (didn't bet)
Seat 5: PausGood folded before Flop (didn't bet)
Seat 6: KKKJJJ730 mucked [9h Qh]



PokerStars Zoom Hand #257554684994:  Hold'em No Limit (€0.01/€0.02) - 2025/08/31 11:43:11 CET [2025/08/31 5:43:11 ET]
Table 'Arneb' 6-max Seat #1 is the button
Seat 1: pipinoelbreve9 (€2.67 in chips) 
Seat 2: datkeire01 (€2.94 in chips) 
Seat 3: rare12345 (€2 in chips) 
Seat 4: mikpepra (€1.20 in chips) 
Seat 5: KKKJJJ730 (€3.37 in chips) 
Seat 6: juanico1977 (€2 in chips) 
datkeire01: posts small blind €0.01
rare12345: posts big blind €0.02
*** HOLE CARDS ***
Dealt to pipinoelbreve9 [3s Qc]
mikpepra: folds 
KKKJJJ730: folds 
juanico1977: raises €0.04 to €0.06
pipinoelbreve9: folds 
datkeire01: raises €0.18 to €0.24
rare12345: folds 
juanico1977: folds 
Uncalled bet (€0.18) returned to datkeire01
datkeire01 collected €0.14 from pot
datkeire01: doesn't show hand 
*** SUMMARY ***
Total pot €0.14 | Rake €0 
Seat 1: pipinoelbreve9 (button) folded before Flop (didn't bet)
Seat 2: datkeire01 (small blind) collected (€0.14)
Seat 3: rare12345 (big blind) folded before Flop
Seat 4: mikpepra folded before Flop (didn't bet)
Seat 5: KKKJJJ730 folded before Flop (didn't bet)
Seat 6: juanico1977 folded before Flop



PokerStars Zoom Hand #257554686743:  Hold'em No Limit (€0.01/€0.02) - 2025/08/31 11:43:28 CET [2025/08/31 5:43:28 ET]
Table 'Arneb' 6-max Seat #1 is the button
Seat 1: dragonfly2467 (€2 in chips) 
Seat 2: pipinoelbreve9 (€2.67 in chips) 
Seat 3: eyeeel (€0.50 in chips) 
Seat 4: rare12345 (€2.39 in chips) 
Seat 5: datkeire01 (€4.62 in chips) 
Seat 6: orosa (€2.43 in chips) 
pipinoelbreve9: posts small blind €0.01
eyeeel: posts big blind €0.02
*** HOLE CARDS ***
Dealt to pipinoelbreve9 [Kh 6c]
rare12345: folds 
datkeire01: folds 
orosa: folds 
dragonfly2467: folds 
pipinoelbreve9: raises €0.04 to €0.06
eyeeel: calls €0.04
*** FLOP *** [Kc 3s Ks]
pipinoelbreve9: checks 
eyeeel: bets €0.02
pipinoelbreve9: calls €0.02
*** TURN *** [Kc 3s Ks] [3d]
pipinoelbreve9: checks 
eyeeel: bets €0.02
pipinoelbreve9: raises €0.40 to €0.42
eyeeel: calls €0.40 and is all-in
*** RIVER *** [Kc 3s Ks 3d] [3h]
*** SHOW DOWN ***
pipinoelbreve9: shows [Kh 6c] (a full house, Kings full of Threes)
eyeeel: shows [Kd Td] (a full house, Kings full of Threes)
pipinoelbreve9 collected €0.48 from pot
eyeeel collected €0.47 from pot
*** SUMMARY ***
Total pot €1 | Rake €0.05 
Board [Kc 3s Ks 3d 3h]
Seat 1: dragonfly2467 (button) folded before Flop (didn't bet)
Seat 2: pipinoelbreve9 (small blind) showed [Kh 6c] and won (€0.48) with a full house, Kings full of Threes
Seat 3: eyeeel (big blind) showed [Kd Td] and won (€0.47) with a full house, Kings full of Threes
Seat 4: rare12345 folded before Flop (didn't bet)
Seat 5: datkeire01 folded before Flop (didn't bet)
Seat 6: orosa folded before Flop (didn't bet)



PokerStars Zoom Hand #257554691308:  Hold'em No Limit (€0.01/€0.02) - 2025/08/31 11:44:13 CET [2025/08/31 5:44:13 ET]
Table 'Arneb' 6-max Seat #1 is the button
Seat 1: orosa (€2.57 in chips) 
Seat 2: 350ZJHN (€2 in chips) 
Seat 3: pipinoelbreve9 (€2.65 in chips) 
Seat 4: juanico1977 (€2 in chips) 
Seat 5: eyeeel (€0.47 in chips) 
Seat 6: rare12345 (€2.45 in chips) 
350ZJHN: posts small blind €0.01
pipinoelbreve9: posts big blind €0.02
*** HOLE CARDS ***
Dealt to pipinoelbreve9 [Qh 7h]
juanico1977: folds 
eyeeel: calls €0.02
rare12345: folds 
orosa: folds 
350ZJHN: folds 
pipinoelbreve9: raises €0.04 to €0.06
eyeeel: calls €0.04
*** FLOP *** [4h 2d Ah]
pipinoelbreve9: checks 
eyeeel: checks 
*** TURN *** [4h 2d Ah] [Kc]
pipinoelbreve9: bets €0.06
eyeeel: folds 
Uncalled bet (€0.06) returned to pipinoelbreve9
pipinoelbreve9 collected €0.12 from pot
pipinoelbreve9: doesn't show hand 
*** SUMMARY ***
Total pot €0.13 | Rake €0.01 
Board [4h 2d Ah Kc]
Seat 1: orosa (button) folded before Flop (didn't bet)
Seat 2: 350ZJHN (small blind) folded before Flop
Seat 3: pipinoelbreve9 (big blind) collected (€0.12)
Seat 4: juanico1977 folded before Flop (didn't bet)
Seat 5: eyeeel folded on the Turn
Seat 6: rare12345 folded before Flop (didn't bet)



PokerStars Zoom Hand #257554694473:  Hold'em No Limit (€0.01/€0.02) - 2025/08/31 11:44:45 CET [2025/08/31 5:44:45 ET]
Table 'Arneb' 6-max Seat #1 is the button
Seat 1: pipinoelbreve9 (€2.71 in chips) 
Seat 2: FELIPE439 (€2.79 in chips) 
Seat 3: eyeeel (€1.56 in chips) 
Seat 4: Danipro178 (€2 in chips) 
Seat 5: orosa (€2.18 in chips) 
Seat 6: candarias (€1.99 in chips) 
FELIPE439: posts small blind €0.01
eyeeel: posts big blind €0.02
*** HOLE CARDS ***
Dealt to pipinoelbreve9 [7d 6s]
Danipro178: folds 
orosa: folds 
candarias: folds 
pipinoelbreve9: raises €0.04 to €0.06
FELIPE439: raises €0.18 to €0.24
eyeeel: folds 
pipinoelbreve9: folds 
Uncalled bet (€0.18) returned to FELIPE439
FELIPE439 collected €0.14 from pot
FELIPE439: doesn't show hand 
*** SUMMARY ***
Total pot €0.14 | Rake €0 
Seat 1: pipinoelbreve9 (button) folded before Flop
Seat 2: FELIPE439 (small blind) collected (€0.14)
Seat 3: eyeeel (big blind) folded before Flop
Seat 4: Danipro178 folded before Flop (didn't bet)
Seat 5: orosa folded before Flop (didn't bet)
Seat 6: candarias folded before Flop (didn't bet)



PokerStars Zoom Hand #257554696772:  Hold'em No Limit (€0.01/€0.02) - 2025/08/31 11:45:08 CET [2025/08/31 5:45:08 ET]
Table 'Arneb' 6-max Seat #1 is the button
Seat 1: rare12345 (€2.47 in chips) 
Seat 2: candarias (€1.02 in chips) 
Seat 3: FELIPE439 (€2.15 in chips) 
Seat 4: Zbiegnew90 (€2.03 in chips) 
Seat 5: datkeire01 (€3.67 in chips) 
Seat 6: pipinoelbreve9 (€2.65 in chips) 
candarias: posts small blind €0.01
FELIPE439: posts big blind €0.02
*** HOLE CARDS ***
Dealt to pipinoelbreve9 [9c 6d]
Zbiegnew90: folds 
datkeire01: folds 
pipinoelbreve9: folds 
rare12345: folds 
candarias: calls €0.01
FELIPE439: raises €0.10 to €0.12
candarias: folds 
Uncalled bet (€0.10) returned to FELIPE439
FELIPE439 collected €0.04 from pot
FELIPE439: doesn't show hand 
*** SUMMARY ***
Total pot €0.04 | Rake €0 
Seat 1: rare12345 (button) folded before Flop (didn't bet)
Seat 2: candarias (small blind) folded before Flop
Seat 3: FELIPE439 (big blind) collected (€0.04)
Seat 4: Zbiegnew90 folded before Flop (didn't bet)
Seat 5: datkeire01 folded before Flop (didn't bet)
Seat 6: pipinoelbreve9 folded before Flop (didn't bet)



PokerStars Zoom Hand #257554697535:  Hold'em No Limit (€0.01/€0.02) - 2025/08/31 11:45:16 CET [2025/08/31 5:45:16 ET]
Table 'Arneb' 6-max Seat #1 is the button
Seat 1: orosa (€2 in chips) 
Seat 2: juanico1977 (€2 in chips) 
Seat 3: datkeire01 (€3.08 in chips) 
Seat 4: Estrabao (€3 in chips) 
Seat 5: pipinoelbreve9 (€2.65 in chips) 
Seat 6: FELIPE439 (€2.78 in chips) 
juanico1977: posts small blind €0.01
datkeire01: posts big blind €0.02
*** HOLE CARDS ***
Dealt to pipinoelbreve9 [5d 5s]
Estrabao: folds 
pipinoelbreve9: raises €0.04 to €0.06
FELIPE439: folds 
orosa: folds 
juanico1977: calls €0.05
datkeire01: calls €0.04
*** FLOP *** [Kd 2d 8h]
juanico1977: checks 
datkeire01: checks 
pipinoelbreve9: checks 
*** TURN *** [Kd 2d 8h] [5c]
juanico1977: checks 
datkeire01: bets €0.13
pipinoelbreve9: calls €0.13
juanico1977: folds 
*** RIVER *** [Kd 2d 8h 5c] [4h]
datkeire01: checks 
pipinoelbreve9: bets €2.46 and is all-in
datkeire01: calls €2.46
*** SHOW DOWN ***
pipinoelbreve9: shows [5d 5s] (three of a kind, Fives)
datkeire01: shows [Ks Td] (a pair of Kings)
pipinoelbreve9 collected €5.11 from pot
*** SUMMARY ***
Total pot €5.36 | Rake €0.25 
Board [Kd 2d 8h 5c 4h]
Seat 1: orosa (button) folded before Flop (didn't bet)
Seat 2: juanico1977 (small blind) folded on the Turn
Seat 3: datkeire01 (big blind) showed [Ks Td] and lost with a pair of Kings
Seat 4: Estrabao folded before Flop (didn't bet)
Seat 5: pipinoelbreve9 showed [5d 5s] and won (€5.11) with three of a kind, Fives
Seat 6: FELIPE439 folded before Flop (didn't bet)



PokerStars Zoom Hand #257554703993:  Hold'em No Limit (€0.01/€0.02) - 2025/08/31 11:46:21 CET [2025/08/31 5:46:21 ET]
Table 'Arneb' 6-max Seat #1 is the button
Seat 1: thenry03 (€2.37 in chips) 
Seat 2: taquoiman (€1.84 in chips) 
Seat 3: juanico1977 (€2.05 in chips) 
Seat 4: 350ZJHN (€2.02 in chips) 
Seat 5: XXILuv (€2 in chips) 
Seat 6: pipinoelbreve9 (€5.11 in chips) 
taquoiman: posts small blind €0.01
juanico1977: posts big blind €0.02
*** HOLE CARDS ***
Dealt to pipinoelbreve9 [As Td]
350ZJHN: folds 
XXILuv: folds 
pipinoelbreve9: raises €0.04 to €0.06
thenry03: folds 
taquoiman: folds 
juanico1977: folds 
Uncalled bet (€0.04) returned to pipinoelbreve9
pipinoelbreve9 collected €0.05 from pot
pipinoelbreve9: doesn't show hand 
350ZJHN is disconnected 
*** SUMMARY ***
Total pot €0.05 | Rake €0 
Seat 1: thenry03 (button) folded before Flop (didn't bet)
Seat 2: taquoiman (small blind) folded before Flop
Seat 3: juanico1977 (big blind) folded before Flop
Seat 4: 350ZJHN folded before Flop (didn't bet)
Seat 5: XXILuv folded before Flop (didn't bet)
Seat 6: pipinoelbreve9 collected (€0.05)



PokerStars Zoom Hand #257554706637:  Hold'em No Limit (€0.01/€0.02) - 2025/08/31 11:46:49 CET [2025/08/31 5:46:49 ET]
Table 'Arneb' 6-max Seat #1 is the button
Seat 1: XXILuv (€2 in chips) 
Seat 2: Danipro178 (€2.11 in chips) 
Seat 3: pipinoelbreve9 (€5.14 in chips) 
Seat 4: orosa (€2.27 in chips) 
Seat 5: HyennaSafari (€2.09 in chips) 
Seat 6: euse383 (€2.01 in chips) 
Danipro178: posts small blind €0.01
pipinoelbreve9: posts big blind €0.02
*** HOLE CARDS ***
Dealt to pipinoelbreve9 [7h 3h]
orosa: folds 
HyennaSafari: folds 
euse383: calls €0.02
XXILuv: folds 
Danipro178: folds 
pipinoelbreve9: checks 
*** FLOP *** [Kc 2h Ad]
pipinoelbreve9: checks 
euse383: checks 
*** TURN *** [Kc 2h Ad] [8h]
pipinoelbreve9: bets €0.03
euse383: folds 
Uncalled bet (€0.03) returned to pipinoelbreve9
pipinoelbreve9 collected €0.05 from pot
pipinoelbreve9: doesn't show hand 
*** SUMMARY ***
Total pot €0.05 | Rake €0 
Board [Kc 2h Ad 8h]
Seat 1: XXILuv (button) folded before Flop (didn't bet)
Seat 2: Danipro178 (small blind) folded before Flop
Seat 3: pipinoelbreve9 (big blind) collected (€0.05)
Seat 4: orosa folded before Flop (didn't bet)
Seat 5: HyennaSafari folded before Flop (didn't bet)
Seat 6: euse383 folded on the Turn



PokerStars Zoom Hand #257554706154:  Hold'em No Limit (€0.01/€0.02) - 2025/08/31 11:46:44 CET [2025/08/31 5:46:44 ET]
Table 'Arneb' 6-max Seat #1 is the button
Seat 1: metamex (€1.38 in chips) 
Seat 2: LuccAAFelippi (€2 in chips) 
Seat 3: XXILuv (€2 in chips) 
Seat 4: pipinoelbreve9 (€5.14 in chips) 
Seat 5: ppatuky (€7.07 in chips) 
Seat 6: orosa (€2.27 in chips) 
LuccAAFelippi: posts small blind €0.01
XXILuv: posts big blind €0.02
*** HOLE CARDS ***
Dealt to pipinoelbreve9 [6d Kd]
pipinoelbreve9: folds 
ppatuky: folds 
orosa: folds 
metamex: folds 
LuccAAFelippi: raises €0.04 to €0.06
XXILuv: calls €0.04
*** FLOP *** [Tc Ah Kc]
LuccAAFelippi: bets €0.09
XXILuv: folds 
Uncalled bet (€0.09) returned to LuccAAFelippi
LuccAAFelippi collected €0.11 from pot
LuccAAFelippi: doesn't show hand 
*** SUMMARY ***
Total pot €0.12 | Rake €0.01 
Board [Tc Ah Kc]
Seat 1: metamex (button) folded before Flop (didn't bet)
Seat 2: LuccAAFelippi (small blind) collected (€0.11)
Seat 3: XXILuv (big blind) folded on the Flop
Seat 4: pipinoelbreve9 folded before Flop (didn't bet)
Seat 5: ppatuky folded before Flop (didn't bet)
Seat 6: orosa folded before Flop (didn't bet)



PokerStars Zoom Hand #257554709419:  Hold'em No Limit (€0.01/€0.02) - 2025/08/31 11:47:17 CET [2025/08/31 5:47:17 ET]
Table 'Arneb' 6-max Seat #1 is the button
Seat 1: KKKJJJ730 (€3.08 in chips) 
Seat 2: pipinoelbreve9 (€5.17 in chips) 
Seat 3: eyeeel (€0.38 in chips) 
Seat 4: FELIPE439 (€2.34 in chips) 
Seat 5: ppatuky (€2.05 in chips) 
Seat 6: Zbiegnew90 (€2.16 in chips) 
pipinoelbreve9: posts small blind €0.01
eyeeel: posts big blind €0.02
*** HOLE CARDS ***
Dealt to pipinoelbreve9 [4h Ad]
FELIPE439: folds 
ppatuky: folds 
Zbiegnew90: raises €0.04 to €0.06
KKKJJJ730: folds 
pipinoelbreve9: folds 
eyeeel: folds 
Uncalled bet (€0.04) returned to Zbiegnew90
Zbiegnew90 collected €0.05 from pot
Zbiegnew90: doesn't show hand 
*** SUMMARY ***
Total pot €0.05 | Rake €0 
Seat 1: KKKJJJ730 (button) folded before Flop (didn't bet)
Seat 2: pipinoelbreve9 (small blind) folded before Flop
Seat 3: eyeeel (big blind) folded before Flop
Seat 4: FELIPE439 folded before Flop (didn't bet)
Seat 5: ppatuky folded before Flop (didn't bet)
Seat 6: Zbiegnew90 collected (€0.05)



PokerStars Zoom Hand #257554711129:  Hold'em No Limit (€0.01/€0.02) - 2025/08/31 11:47:34 CET [2025/08/31 5:47:34 ET]
Table 'Arneb' 6-max Seat #1 is the button
Seat 1: pipinoelbreve9 (€5.16 in chips) 
Seat 2: datkeire01 (€2.91 in chips) 
Seat 3: candarias (€2 in chips) 
Seat 4: Danipro178 (€2.10 in chips) 
Seat 5: TEVMONIV (€3.11 in chips) 
Seat 6: ppatuky (€7.13 in chips) 
datkeire01: posts small blind €0.01
candarias: posts big blind €0.02
*** HOLE CARDS ***
Dealt to pipinoelbreve9 [Td Jd]
Danipro178: folds 
TEVMONIV: folds 
ppatuky: folds 
pipinoelbreve9: raises €0.04 to €0.06
datkeire01: folds 
candarias: folds 
Uncalled bet (€0.04) returned to pipinoelbreve9
pipinoelbreve9 collected €0.05 from pot
pipinoelbreve9: doesn't show hand 
*** SUMMARY ***
Total pot €0.05 | Rake €0 
Seat 1: pipinoelbreve9 (button) collected (€0.05)
Seat 2: datkeire01 (small blind) folded before Flop
Seat 3: candarias (big blind) folded before Flop
Seat 4: Danipro178 folded before Flop (didn't bet)
Seat 5: TEVMONIV folded before Flop (didn't bet)
Seat 6: ppatuky folded before Flop (didn't bet)



PokerStars Zoom Hand #257554712087:  Hold'em No Limit (€0.01/€0.02) - 2025/08/31 11:47:44 CET [2025/08/31 5:47:44 ET]
Table 'Arneb' 6-max Seat #1 is the button
Seat 1: VEGAMAR (€2 in chips) 
Seat 2: candarias (€1.98 in chips) 
Seat 3: Upandown1 (€2.68 in chips) 
Seat 4: TEVMONIV (€3.11 in chips) 
Seat 5: pipinoelbreve9 (€5.19 in chips) 
Seat 6: KKKJJJ730 (€2.99 in chips) 
candarias: posts small blind €0.01
Upandown1: posts big blind €0.02
*** HOLE CARDS ***
Dealt to pipinoelbreve9 [8c 8d]
TEVMONIV: folds 
pipinoelbreve9: raises €0.04 to €0.06
KKKJJJ730: calls €0.06
VEGAMAR: calls €0.06
candarias: calls €0.05
Upandown1: folds 
*** FLOP *** [6c 2s 3s]
candarias: checks 
pipinoelbreve9: bets €0.10
KKKJJJ730: folds 
VEGAMAR: calls €0.10
candarias: calls €0.10
*** TURN *** [6c 2s 3s] [Kh]
candarias: checks 
pipinoelbreve9: checks 
VEGAMAR: checks 
*** RIVER *** [6c 2s 3s Kh] [Ks]
candarias: bets €0.27
pipinoelbreve9: calls €0.27
VEGAMAR: folds 
*** SHOW DOWN ***
candarias: shows [6s 7s] (a flush, King high)
pipinoelbreve9: mucks hand 
candarias collected €1.04 from pot
*** SUMMARY ***
Total pot €1.10 | Rake €0.06 
Board [6c 2s 3s Kh Ks]
Seat 1: VEGAMAR (button) folded on the River
Seat 2: candarias (small blind) showed [6s 7s] and won (€1.04) with a flush, King high
Seat 3: Upandown1 (big blind) folded before Flop
Seat 4: TEVMONIV folded before Flop (didn't bet)
Seat 5: pipinoelbreve9 mucked [8c 8d]
Seat 6: KKKJJJ730 folded on the Flop



PokerStars Zoom Hand #257554720205:  Hold'em No Limit (€0.01/€0.02) - 2025/08/31 11:49:06 CET [2025/08/31 5:49:06 ET]
Table 'Arneb' 6-max Seat #1 is the button
Seat 1: Estrabao (€2.95 in chips) 
Seat 2: orosa (€2 in chips) 
Seat 3: juanico1977 (€2.06 in chips) 
Seat 4: Upandown1 (€2.24 in chips) 
Seat 5: eyeeel (€0.38 in chips) 
Seat 6: pipinoelbreve9 (€4.76 in chips) 
orosa: posts small blind €0.01
juanico1977: posts big blind €0.02
*** HOLE CARDS ***
Dealt to pipinoelbreve9 [Ah 5d]
Upandown1: folds 
eyeeel: folds 
pipinoelbreve9: folds 
Estrabao: folds 
orosa: folds 
Uncalled bet (€0.01) returned to juanico1977
juanico1977 is disconnected 
juanico1977 collected €0.02 from pot
juanico1977: doesn't show hand 
*** SUMMARY ***
Total pot €0.02 | Rake €0 
Seat 1: Estrabao (button) folded before Flop (didn't bet)
Seat 2: orosa (small blind) folded before Flop
Seat 3: juanico1977 (big blind) collected (€0.02)
Seat 4: Upandown1 folded before Flop (didn't bet)
Seat 5: eyeeel folded before Flop (didn't bet)
Seat 6: pipinoelbreve9 folded before Flop (didn't bet)



PokerStars Zoom Hand #257554719534:  Hold'em No Limit (€0.01/€0.02) - 2025/08/31 11:48:59 CET [2025/08/31 5:48:59 ET]
Table 'Arneb' 6-max Seat #1 is the button
Seat 1: Zbiegnew90 (€2.21 in chips) 
Seat 2: VEGAMAR (€2 in chips) 
Seat 3: thenry03 (€2.43 in chips) 
Seat 4: pipinoelbreve9 (€4.76 in chips) 
Seat 5: XXILuv (€2.32 in chips) 
Seat 6: Abrelatas787 (€2 in chips) 
VEGAMAR: posts small blind €0.01
thenry03: posts big blind €0.02
*** HOLE CARDS ***
Dealt to pipinoelbreve9 [3s 9d]
pipinoelbreve9: folds 
XXILuv: raises €0.03 to €0.05
Abrelatas787: calls €0.05
Zbiegnew90: folds 
VEGAMAR: folds 
thenry03: folds 
*** FLOP *** [Jd 5d 6h]
XXILuv: checks 
Abrelatas787: bets €0.06
XXILuv: folds 
Uncalled bet (€0.06) returned to Abrelatas787
Abrelatas787 collected €0.12 from pot
Abrelatas787: doesn't show hand 
*** SUMMARY ***
Total pot €0.13 | Rake €0.01 
Board [Jd 5d 6h]
Seat 1: Zbiegnew90 (button) folded before Flop (didn't bet)
Seat 2: VEGAMAR (small blind) folded before Flop
Seat 3: thenry03 (big blind) folded before Flop
Seat 4: pipinoelbreve9 folded before Flop (didn't bet)
Seat 5: XXILuv folded on the Flop
Seat 6: Abrelatas787 collected (€0.12)



PokerStars Zoom Hand #257554720582:  Hold'em No Limit (€0.01/€0.02) - 2025/08/31 11:49:10 CET [2025/08/31 5:49:10 ET]
Table 'Arneb' 6-max Seat #1 is the button
Seat 1: pipinoelbreve9 (€4.76 in chips) 
Seat 2: crevi_066 (€3.86 in chips) 
Seat 3: Zbiegnew90 (€2.21 in chips) 
Seat 4: candarias (€0.59 in chips) 
Seat 5: Upandown1 (€2.24 in chips) 
Seat 6: mikpepra (€1.42 in chips) 
crevi_066: posts small blind €0.01
Zbiegnew90: posts big blind €0.02
*** HOLE CARDS ***
Dealt to pipinoelbreve9 [9c Kh]
candarias: folds 
Upandown1: raises €0.04 to €0.06
mikpepra: folds 
pipinoelbreve9: calls €0.06
crevi_066: folds 
Zbiegnew90: calls €0.04
*** FLOP *** [5d 5h 4d]
Zbiegnew90: checks 
Upandown1: checks 
pipinoelbreve9: checks 
*** TURN *** [5d 5h 4d] [8s]
Zbiegnew90: checks 
Upandown1: checks 
pipinoelbreve9: checks 
*** RIVER *** [5d 5h 4d 8s] [7c]
Zbiegnew90: checks 
Upandown1: checks 
pipinoelbreve9: checks 
*** SHOW DOWN ***
Zbiegnew90: shows [Ks 9d] (a pair of Fives)
Upandown1: shows [As Kd] (a pair of Fives - Ace kicker)
pipinoelbreve9: mucks hand 
Upandown1 collected €0.18 from pot
*** SUMMARY ***
Total pot €0.19 | Rake €0.01 
Board [5d 5h 4d 8s 7c]
Seat 1: pipinoelbreve9 (button) mucked [9c Kh]
Seat 2: crevi_066 (small blind) folded before Flop
Seat 3: Zbiegnew90 (big blind) showed [Ks 9d] and lost with a pair of Fives
Seat 4: candarias folded before Flop (didn't bet)
Seat 5: Upandown1 showed [As Kd] and won (€0.18) with a pair of Fives
Seat 6: mikpepra folded before Flop (didn't bet)



PokerStars Zoom Hand #257554725460:  Hold'em No Limit (€0.01/€0.02) - 2025/08/31 11:49:59 CET [2025/08/31 5:49:59 ET]
Table 'Arneb' 6-max Seat #1 is the button
Seat 1: XXILuv (€2.02 in chips) 
Seat 2: Estrabao (€2.96 in chips) 
Seat 3: pipinoelbreve9 (€4.70 in chips) 
Seat 4: Zbiegnew90 (€2.15 in chips) 
Seat 5: VEGAMAR (€2 in chips) 
Seat 6: Upandown1 (€2.36 in chips) 
Estrabao: posts small blind €0.01
pipinoelbreve9: posts big blind €0.02
*** HOLE CARDS ***
Dealt to pipinoelbreve9 [Qd 2d]
Zbiegnew90: raises €0.05 to €0.07
VEGAMAR: folds 
Upandown1: folds 
XXILuv: folds 
Estrabao: folds 
pipinoelbreve9: calls €0.05
*** FLOP *** [5s Ah 9d]
pipinoelbreve9: checks 
Zbiegnew90: bets €0.05
pipinoelbreve9: folds 
Uncalled bet (€0.05) returned to Zbiegnew90
Zbiegnew90 collected €0.14 from pot
Zbiegnew90: doesn't show hand 
*** SUMMARY ***
Total pot €0.15 | Rake €0.01 
Board [5s Ah 9d]
Seat 1: XXILuv (button) folded before Flop (didn't bet)
Seat 2: Estrabao (small blind) folded before Flop
Seat 3: pipinoelbreve9 (big blind) folded on the Flop
Seat 4: Zbiegnew90 collected (€0.14)
Seat 5: VEGAMAR folded before Flop (didn't bet)
Seat 6: Upandown1 folded before Flop (didn't bet)



PokerStars Zoom Hand #257554729874:  Hold'em No Limit (€0.01/€0.02) - 2025/08/31 11:50:43 CET [2025/08/31 5:50:43 ET]
Table 'Arneb' 6-max Seat #1 is the button
Seat 1: orosa (€2 in chips) 
Seat 2: XXILuv (€2 in chips) 
Seat 3: eyeeel (€1.32 in chips) 
Seat 4: Jeffkijay (€1.69 in chips) 
Seat 5: juanlu2000china (€1.76 in chips) 
Seat 6: pipinoelbreve9 (€4.62 in chips) 
XXILuv: posts small blind €0.01
eyeeel: posts big blind €0.02
*** HOLE CARDS ***
Dealt to pipinoelbreve9 [9h Ts]
Jeffkijay: folds 
juanlu2000china: raises €0.02 to €0.04
pipinoelbreve9: folds 
orosa: folds 
XXILuv: folds 
eyeeel: folds 
Uncalled bet (€0.02) returned to juanlu2000china
juanlu2000china collected €0.05 from pot
juanlu2000china: doesn't show hand 
*** SUMMARY ***
Total pot €0.05 | Rake €0 
Seat 1: orosa (button) folded before Flop (didn't bet)
Seat 2: XXILuv (small blind) folded before Flop
Seat 3: eyeeel (big blind) folded before Flop
Seat 4: Jeffkijay folded before Flop (didn't bet)
Seat 5: juanlu2000china collected (€0.05)
Seat 6: pipinoelbreve9 folded before Flop (didn't bet)



PokerStars Zoom Hand #257554731142:  Hold'em No Limit (€0.01/€0.02) - 2025/08/31 11:50:56 CET [2025/08/31 5:50:56 ET]
Table 'Arneb' 6-max Seat #1 is the button
Seat 1: ppatuky (€3.95 in chips) 
Seat 2: XXILuv (€2.11 in chips) 
Seat 3: orosa (€2.96 in chips) 
Seat 4: KKKJJJ730 (€2.75 in chips) 
Seat 5: pipinoelbreve9 (€4.62 in chips) 
Seat 6: Jeffkijay (€1.69 in chips) 
XXILuv: posts small blind €0.01
orosa: posts big blind €0.02
*** HOLE CARDS ***
Dealt to pipinoelbreve9 [5c Jh]
KKKJJJ730: raises €0.03 to €0.05
pipinoelbreve9: folds 
Jeffkijay: folds 
ppatuky: folds 
XXILuv: folds 
orosa: calls €0.03
*** FLOP *** [2h 8h Ts]
orosa: checks 
KKKJJJ730: checks 
*** TURN *** [2h 8h Ts] [Qh]
orosa: checks 
KKKJJJ730: checks 
*** RIVER *** [2h 8h Ts Qh] [2d]
orosa: checks 
KKKJJJ730: checks 
*** SHOW DOWN ***
orosa: shows [Ac Td] (two pair, Tens and Deuces)
KKKJJJ730: mucks hand 
orosa collected €0.10 from pot
*** SUMMARY ***
Total pot €0.11 | Rake €0.01 
Board [2h 8h Ts Qh 2d]
Seat 1: ppatuky (button) folded before Flop (didn't bet)
Seat 2: XXILuv (small blind) folded before Flop
Seat 3: orosa (big blind) showed [Ac Td] and won (€0.10) with two pair, Tens and Deuces
Seat 4: KKKJJJ730 mucked [Kd As]
Seat 5: pipinoelbreve9 folded before Flop (didn't bet)
Seat 6: Jeffkijay folded before Flop (didn't bet)



PokerStars Zoom Hand #257554732227:  Hold'em No Limit (€0.01/€0.02) - 2025/08/31 11:51:06 CET [2025/08/31 5:51:06 ET]
Table 'Arneb' 6-max Seat #1 is the button
Seat 1: Estrabao (€2.90 in chips) 
Seat 2: euse383 (€1.67 in chips) 
Seat 3: thenry03 (€2.18 in chips) 
Seat 4: nukilla888 (€1 in chips) 
Seat 5: orosa (€2 in chips) 
Seat 6: pipinoelbreve9 (€4.62 in chips) 
euse383: posts small blind €0.01
thenry03: posts big blind €0.02
*** HOLE CARDS ***
Dealt to pipinoelbreve9 [Ts Ac]
nukilla888: folds 
orosa: folds 
pipinoelbreve9: raises €0.04 to €0.06
Estrabao: folds 
euse383: folds 
thenry03: folds 
Uncalled bet (€0.04) returned to pipinoelbreve9
pipinoelbreve9 collected €0.05 from pot
pipinoelbreve9: doesn't show hand 
*** SUMMARY ***
Total pot €0.05 | Rake €0 
Seat 1: Estrabao (button) folded before Flop (didn't bet)
Seat 2: euse383 (small blind) folded before Flop
Seat 3: thenry03 (big blind) folded before Flop
Seat 4: nukilla888 folded before Flop (didn't bet)
Seat 5: orosa folded before Flop (didn't bet)
Seat 6: pipinoelbreve9 collected (€0.05)



PokerStars Zoom Hand #257554731688:  Hold'em No Limit (€0.01/€0.02) - 2025/08/31 11:51:01 CET [2025/08/31 5:51:01 ET]
Table 'Arneb' 6-max Seat #1 is the button
Seat 1: pipinoelbreve9 (€4.62 in chips) 
Seat 2: thenry03 (€2.19 in chips) 
Seat 3: XXILuv (€2.10 in chips) 
Seat 4: juanlu2000china (€1.79 in chips) 
Seat 5: FELIPE439 (€2.95 in chips) 
Seat 6: eyeeel (€1.39 in chips) 
thenry03: posts small blind €0.01
XXILuv: posts big blind €0.02
*** HOLE CARDS ***
Dealt to pipinoelbreve9 [Tc 4d]
juanlu2000china: calls €0.02
FELIPE439: folds 
eyeeel: raises €0.02 to €0.04
pipinoelbreve9: folds 
thenry03: folds 
XXILuv: folds 
juanlu2000china: calls €0.02
*** FLOP *** [5s Qs 4s]
juanlu2000china: checks 
eyeeel: checks 
*** TURN *** [5s Qs 4s] [9s]
juanlu2000china: checks 
eyeeel: checks 
*** RIVER *** [5s Qs 4s 9s] [6h]
juanlu2000china: checks 
eyeeel: checks 
*** SHOW DOWN ***
juanlu2000china: shows [Js Td] (a flush, Queen high)
eyeeel: mucks hand 
juanlu2000china collected €0.10 from pot
*** SUMMARY ***
Total pot €0.11 | Rake €0.01 
Board [5s Qs 4s 9s 6h]
Seat 1: pipinoelbreve9 (button) folded before Flop (didn't bet)
Seat 2: thenry03 (small blind) folded before Flop
Seat 3: XXILuv (big blind) folded before Flop
Seat 4: juanlu2000china showed [Js Td] and won (€0.10) with a flush, Queen high
Seat 5: FELIPE439 folded before Flop (didn't bet)
Seat 6: eyeeel mucked [8h Ad]



PokerStars Zoom Hand #257554729099:  Hold'em No Limit (€0.01/€0.02) - 2025/08/31 11:50:35 CET [2025/08/31 5:50:35 ET]
Table 'Arneb' 6-max Seat #1 is the button
Seat 1: Lucian Morel (€3.01 in chips) 
Seat 2: pipinoelbreve9 (€4.63 in chips) 
Seat 3: datkeire01 (€4.54 in chips) 
Seat 4: LuccAAFelippi (€1.93 in chips) 
Seat 5: Fyahrabbit (€3.03 in chips) 
Seat 6: nukilla888 (€1 in chips) 
pipinoelbreve9: posts small blind €0.01
datkeire01: posts big blind €0.02
*** HOLE CARDS ***
Dealt to pipinoelbreve9 [Tc 6h]
LuccAAFelippi: raises €0.03 to €0.05
Fyahrabbit: folds 
nukilla888: folds 
Lucian Morel: calls €0.05
pipinoelbreve9: folds 
datkeire01: folds 
*** FLOP *** [Ts 7d 4c]
LuccAAFelippi: checks 
Lucian Morel: bets €0.09
LuccAAFelippi: raises €0.16 to €0.25
Lucian Morel: folds 
Uncalled bet (€0.16) returned to LuccAAFelippi
LuccAAFelippi collected €0.29 from pot
LuccAAFelippi: doesn't show hand 
*** SUMMARY ***
Total pot €0.31 | Rake €0.02 
Board [Ts 7d 4c]
Seat 1: Lucian Morel (button) folded on the Flop
Seat 2: pipinoelbreve9 (small blind) folded before Flop
Seat 3: datkeire01 (big blind) folded before Flop
Seat 4: LuccAAFelippi collected (€0.29)
Seat 5: Fyahrabbit folded before Flop (didn't bet)
Seat 6: nukilla888 folded before Flop (didn't bet)



PokerStars Zoom Hand #257554733685:  Hold'em No Limit (€0.01/€0.02) - 2025/08/31 11:51:21 CET [2025/08/31 5:51:21 ET]
Table 'Arneb' 6-max Seat #1 is the button
Seat 1: orosa (€3.01 in chips) 
Seat 2: chuskillo9 (€2.03 in chips) 
Seat 3: eyeeel (€0.59 in chips) 
Seat 4: pipinoelbreve9 (€4.65 in chips) 
Seat 5: thenry03 (€2.16 in chips) 
Seat 6: KKKJJJ730 (€2.69 in chips) 
chuskillo9: posts small blind €0.01
eyeeel: posts big blind €0.02
*** HOLE CARDS ***
Dealt to pipinoelbreve9 [Qs 5s]
pipinoelbreve9: folds 
thenry03: raises €0.04 to €0.06
KKKJJJ730: folds 
orosa: folds 
chuskillo9: folds 
eyeeel: folds 
Uncalled bet (€0.04) returned to thenry03
thenry03 collected €0.05 from pot
thenry03: doesn't show hand 
*** SUMMARY ***
Total pot €0.05 | Rake €0 
Seat 1: orosa (button) folded before Flop (didn't bet)
Seat 2: chuskillo9 (small blind) folded before Flop
Seat 3: eyeeel (big blind) folded before Flop
Seat 4: pipinoelbreve9 folded before Flop (didn't bet)
Seat 5: thenry03 collected (€0.05)
Seat 6: KKKJJJ730 folded before Flop (didn't bet)



PokerStars Zoom Hand #257554848122:  Hold'em No Limit (€0.01/€0.02) - 2025/08/31 12:11:06 CET [2025/08/31 6:11:06 ET]
Table 'Arneb' 6-max Seat #1 is the button
Seat 1: datkeire01 (€5.34 in chips) 
Seat 2: velita298 (€1.95 in chips) 
Seat 3: pipinoelbreve9 (€4.65 in chips) 
Seat 4: LuccAAFelippi (€1.82 in chips) 
Seat 5: orosa (€2 in chips) 
Seat 6: crevi_066 (€2.32 in chips) 
velita298: posts small blind €0.01
pipinoelbreve9: posts big blind €0.02
*** HOLE CARDS ***
Dealt to pipinoelbreve9 [3d Ts]
LuccAAFelippi: folds 
orosa: folds 
crevi_066: raises €0.03 to €0.05
datkeire01: raises €0.17 to €0.22
velita298: folds 
pipinoelbreve9: folds 
crevi_066: folds 
Uncalled bet (€0.17) returned to datkeire01
datkeire01 collected €0.13 from pot
datkeire01: doesn't show hand 
*** SUMMARY ***
Total pot €0.13 | Rake €0 
Seat 1: datkeire01 (button) collected (€0.13)
Seat 2: velita298 (small blind) folded before Flop
Seat 3: pipinoelbreve9 (big blind) folded before Flop
Seat 4: LuccAAFelippi folded before Flop (didn't bet)
Seat 5: orosa folded before Flop (didn't bet)
Seat 6: crevi_066 folded before Flop



PokerStars Zoom Hand #257554853374:  Hold'em No Limit (€0.01/€0.02) - 2025/08/31 12:11:56 CET [2025/08/31 6:11:56 ET]
Table 'Arneb' 6-max Seat #1 is the button
Seat 1: pipinoelbreve9 (€4.62 in chips) 
Seat 2: candarias (€0.31 in chips) 
Seat 3: euse383 (€3.04 in chips) 
Seat 4: Capi010 (€0.50 in chips) 
Seat 5: ppatuky (€4.20 in chips) 
Seat 6: datkeire01 (€2.13 in chips) 
candarias: posts small blind €0.01
euse383: posts big blind €0.02
*** HOLE CARDS ***
Dealt to pipinoelbreve9 [Qc 2h]
Capi010: folds 
ppatuky: folds 
datkeire01: folds 
pipinoelbreve9: folds 
candarias: folds 
Uncalled bet (€0.01) returned to euse383
euse383 collected €0.02 from pot
euse383: doesn't show hand 
*** SUMMARY ***
Total pot €0.02 | Rake €0 
Seat 1: pipinoelbreve9 (button) folded before Flop (didn't bet)
Seat 2: candarias (small blind) folded before Flop
Seat 3: euse383 (big blind) collected (€0.02)
Seat 4: Capi010 folded before Flop (didn't bet)
Seat 5: ppatuky folded before Flop (didn't bet)
Seat 6: datkeire01 folded before Flop (didn't bet)



PokerStars Zoom Hand #257554850019:  Hold'em No Limit (€0.01/€0.02) - 2025/08/31 12:11:23 CET [2025/08/31 6:11:23 ET]
Table 'Arneb' 6-max Seat #1 is the button
Seat 1: lck.smfa (€0.98 in chips) 
Seat 2: pipinoelbreve9 (€4.63 in chips) 
Seat 3: LuccAAFelippi (€1.76 in chips) 
Seat 4: ppatuky (€4.23 in chips) 
Seat 5: velita298 (€1.94 in chips) 
Seat 6: SrLyrox (€2.15 in chips) 
pipinoelbreve9: posts small blind €0.01
LuccAAFelippi: posts big blind €0.02
*** HOLE CARDS ***
Dealt to pipinoelbreve9 [Td 2d]
ppatuky: folds 
velita298: folds 
SrLyrox: raises €0.04 to €0.06
lck.smfa: calls €0.06
pipinoelbreve9: folds 
LuccAAFelippi: folds 
*** FLOP *** [6c Qs 8d]
SrLyrox: bets €0.04
lck.smfa: calls €0.04
*** TURN *** [6c Qs 8d] [Qh]
SrLyrox: checks 
lck.smfa: bets €0.14
SrLyrox: folds 
Uncalled bet (€0.14) returned to lck.smfa
lck.smfa collected €0.22 from pot
lck.smfa: doesn't show hand 
*** SUMMARY ***
Total pot €0.23 | Rake €0.01 
Board [6c Qs 8d Qh]
Seat 1: lck.smfa (button) collected (€0.22)
Seat 2: pipinoelbreve9 (small blind) folded before Flop
Seat 3: LuccAAFelippi (big blind) folded before Flop
Seat 4: ppatuky folded before Flop (didn't bet)
Seat 5: velita298 folded before Flop (didn't bet)
Seat 6: SrLyrox folded on the Turn



PokerStars Zoom Hand #257554853978:  Hold'em No Limit (€0.01/€0.02) - 2025/08/31 12:12:02 CET [2025/08/31 6:12:02 ET]
Table 'Arneb' 6-max Seat #1 is the button
Seat 1: ppatuky (€4.20 in chips) 
Seat 2: Fvieira1984 (€2.76 in chips) 
Seat 3: cheminot83 (€2.14 in chips) 
Seat 4: Jeffkijay (€2.45 in chips) 
Seat 5: datkeire01 (€2.13 in chips) 
Seat 6: pipinoelbreve9 (€4.62 in chips) 
Fvieira1984: posts small blind €0.01
cheminot83: posts big blind €0.02
*** HOLE CARDS ***
Dealt to pipinoelbreve9 [5h Jc]
Jeffkijay: folds 
datkeire01: folds 
pipinoelbreve9: folds 
ppatuky: folds 
Fvieira1984: raises €0.04 to €0.06
cheminot83: calls €0.04
*** FLOP *** [4h Kc Qh]
Fvieira1984: checks 
cheminot83: checks 
*** TURN *** [4h Kc Qh] [6s]
Fvieira1984: checks 
cheminot83: checks 
*** RIVER *** [4h Kc Qh 6s] [Ah]
Fvieira1984: bets €0.06
cheminot83: folds 
Uncalled bet (€0.06) returned to Fvieira1984
Fvieira1984 collected €0.11 from pot
Fvieira1984: doesn't show hand 
*** SUMMARY ***
Total pot €0.12 | Rake €0.01 
Board [4h Kc Qh 6s Ah]
Seat 1: ppatuky (button) folded before Flop (didn't bet)
Seat 2: Fvieira1984 (small blind) collected (€0.11)
Seat 3: cheminot83 (big blind) folded on the River
Seat 4: Jeffkijay folded before Flop (didn't bet)
Seat 5: datkeire01 folded before Flop (didn't bet)
Seat 6: pipinoelbreve9 folded before Flop (didn't bet)



PokerStars Zoom Hand #257554855066:  Hold'em No Limit (€0.01/€0.02) - 2025/08/31 12:12:12 CET [2025/08/31 6:12:12 ET]
Table 'Arneb' 6-max Seat #1 is the button
Seat 1: manbas607 (€0.25 in chips) 
Seat 2: Abrelatas787 (€2.01 in chips) 
Seat 3: ppatuky (€3.46 in chips) 
Seat 4: chuskillo9 (€2 in chips) 
Seat 5: pipinoelbreve9 (€4.62 in chips) 
Seat 6: candarias (€0.30 in chips) 
Abrelatas787: posts small blind €0.01
ppatuky: posts big blind €0.02
*** HOLE CARDS ***
Dealt to pipinoelbreve9 [Tc 4h]
chuskillo9: folds 
pipinoelbreve9: folds 
candarias: folds 
manbas607: calls €0.02
Abrelatas787: folds 
ppatuky: checks 
*** FLOP *** [6d 4c As]
ppatuky: checks 
manbas607: checks 
*** TURN *** [6d 4c As] [5d]
ppatuky: checks 
manbas607: checks 
*** RIVER *** [6d 4c As 5d] [8s]
ppatuky: bets €0.05
manbas607: calls €0.05
*** SHOW DOWN ***
ppatuky: shows [7c Jc] (a straight, Four to Eight)
manbas607: mucks hand 
ppatuky collected €0.14 from pot
*** SUMMARY ***
Total pot €0.15 | Rake €0.01 
Board [6d 4c As 5d 8s]
Seat 1: manbas607 (button) mucked [8d Td]
Seat 2: Abrelatas787 (small blind) folded before Flop
Seat 3: ppatuky (big blind) showed [7c Jc] and won (€0.14) with a straight, Four to Eight
Seat 4: chuskillo9 folded before Flop (didn't bet)
Seat 5: pipinoelbreve9 folded before Flop (didn't bet)
Seat 6: candarias folded before Flop (didn't bet)



PokerStars Zoom Hand #257554857469:  Hold'em No Limit (€0.01/€0.02) - 2025/08/31 12:12:35 CET [2025/08/31 6:12:35 ET]
Table 'Arneb' 6-max Seat #1 is the button
Seat 1: euse383 (€3.03 in chips) 
Seat 2: flechebleu06 (€0.96 in chips) 
Seat 3: orosa (€2.98 in chips) 
Seat 4: pipinoelbreve9 (€4.60 in chips) 
Seat 5: SrLyrox (€2.04 in chips) 
Seat 6: ppatuky (€9.93 in chips) 
flechebleu06: posts small blind €0.01
orosa: posts big blind €0.02
*** HOLE CARDS ***
Dealt to pipinoelbreve9 [4c 3c]
pipinoelbreve9: folds 
SrLyrox: raises €0.04 to €0.06
ppatuky: folds 
euse383: folds 
flechebleu06: folds 
orosa: folds 
Uncalled bet (€0.04) returned to SrLyrox
SrLyrox collected €0.05 from pot
SrLyrox: doesn't show hand 
*** SUMMARY ***
Total pot €0.05 | Rake €0 
Seat 1: euse383 (button) folded before Flop (didn't bet)
Seat 2: flechebleu06 (small blind) folded before Flop
Seat 3: orosa (big blind) folded before Flop
Seat 4: pipinoelbreve9 folded before Flop (didn't bet)
Seat 5: SrLyrox collected (€0.05)
Seat 6: ppatuky folded before Flop (didn't bet)



PokerStars Zoom Hand #257554856112:  Hold'em No Limit (€0.01/€0.02) - 2025/08/31 12:12:22 CET [2025/08/31 6:12:22 ET]
Table 'Arneb' 6-max Seat #1 is the button
Seat 1: crevi_066 (€2.24 in chips) 
Seat 2: Eucalypter (€1.76 in chips) 
Seat 3: pipinoelbreve9 (€4.62 in chips) 
Seat 4: lorocontento (€1.47 in chips) 
Seat 5: The4G (€0.45 in chips) 
Seat 6: unaig44 (€1.92 in chips) 
Eucalypter: posts small blind €0.01
pipinoelbreve9: posts big blind €0.02
*** HOLE CARDS ***
Dealt to pipinoelbreve9 [7c Kh]
lorocontento: folds 
The4G: folds 
unaig44: raises €0.03 to €0.05
crevi_066: folds 
Eucalypter: raises €0.13 to €0.18
pipinoelbreve9: folds 
unaig44: calls €0.13
*** FLOP *** [Jh 9d 2h]
Eucalypter: bets €0.12
unaig44: folds 
Uncalled bet (€0.12) returned to Eucalypter
Eucalypter collected €0.36 from pot
Eucalypter: doesn't show hand 
*** SUMMARY ***
Total pot €0.38 | Rake €0.02 
Board [Jh 9d 2h]
Seat 1: crevi_066 (button) folded before Flop (didn't bet)
Seat 2: Eucalypter (small blind) collected (€0.36)
Seat 3: pipinoelbreve9 (big blind) folded before Flop
Seat 4: lorocontento folded before Flop (didn't bet)
Seat 5: The4G folded before Flop (didn't bet)
Seat 6: unaig44 folded on the Flop



PokerStars Zoom Hand #257554858246:  Hold'em No Limit (€0.01/€0.02) - 2025/08/31 12:12:43 CET [2025/08/31 6:12:43 ET]
Table 'Arneb' 6-max Seat #1 is the button
Seat 1: fcbrule (€2.16 in chips) 
Seat 2: euse383 (€3.03 in chips) 
Seat 3: datkeire01 (€2.10 in chips) 
Seat 4: FELIPE439 (€3.89 in chips) 
Seat 5: pipinoelbreve9 (€4.60 in chips) 
Seat 6: Danipro178 (€2.09 in chips) 
euse383: posts small blind €0.01
datkeire01: posts big blind €0.02
*** HOLE CARDS ***
Dealt to pipinoelbreve9 [Tc 6c]
FELIPE439: folds 
pipinoelbreve9: folds 
Danipro178: folds 
fcbrule: folds 
euse383: folds 
Uncalled bet (€0.01) returned to datkeire01
datkeire01 collected €0.02 from pot
datkeire01: doesn't show hand 
*** SUMMARY ***
Total pot €0.02 | Rake €0 
Seat 1: fcbrule (button) folded before Flop (didn't bet)
Seat 2: euse383 (small blind) folded before Flop
Seat 3: datkeire01 (big blind) collected (€0.02)
Seat 4: FELIPE439 folded before Flop (didn't bet)
Seat 5: pipinoelbreve9 folded before Flop (didn't bet)
Seat 6: Danipro178 folded before Flop (didn't bet)



PokerStars Zoom Hand #257554859106:  Hold'em No Limit (€0.01/€0.02) - 2025/08/31 12:12:51 CET [2025/08/31 6:12:51 ET]
Table 'Arneb' 6-max Seat #1 is the button
Seat 1: crevi_066 (€3.37 in chips) 
Seat 2: pipinoelbreve9 (€4.60 in chips) 
Seat 3: candarias (€0.33 in chips) 
Seat 4: orosa (€2.11 in chips) 
Seat 5: TEVMONIV (€2.36 in chips) 
Seat 6: linto2800 (€2.16 in chips) 
pipinoelbreve9: posts small blind €0.01
candarias: posts big blind €0.02
*** HOLE CARDS ***
Dealt to pipinoelbreve9 [Qs Ad]
orosa: folds 
TEVMONIV: raises €0.03 to €0.05
linto2800: folds 
crevi_066: folds 
pipinoelbreve9: raises €0.11 to €0.16
candarias: folds 
TEVMONIV: calls €0.11
*** FLOP *** [3d Js 6s]
pipinoelbreve9: checks 
TEVMONIV: checks 
*** TURN *** [3d Js 6s] [Ks]
pipinoelbreve9: bets €0.16
TEVMONIV: calls €0.16
*** RIVER *** [3d Js 6s Ks] [5h]
pipinoelbreve9: checks 
TEVMONIV: checks 
*** SHOW DOWN ***
pipinoelbreve9: shows [Qs Ad] (high card Ace)
TEVMONIV: shows [7s 7c] (a pair of Sevens)
TEVMONIV collected €0.63 from pot
*** SUMMARY ***
Total pot €0.66 | Rake €0.03 
Board [3d Js 6s Ks 5h]
Seat 1: crevi_066 (button) folded before Flop (didn't bet)
Seat 2: pipinoelbreve9 (small blind) showed [Qs Ad] and lost with high card Ace
Seat 3: candarias (big blind) folded before Flop
Seat 4: orosa folded before Flop (didn't bet)
Seat 5: TEVMONIV showed [7s 7c] and won (€0.63) with a pair of Sevens
Seat 6: linto2800 folded before Flop (didn't bet)



PokerStars Zoom Hand #257556385977:  Hold'em No Limit (€0.01/€0.02) - 2025/08/31 15:30:52 CET [2025/08/31 9:30:52 ET]
Table 'Arneb' 6-max Seat #1 is the button
Seat 1: davidelgnomo747 (€1.72 in chips) 
Seat 2: ehbraga (€0.82 in chips) 
Seat 3: pipinoelbreve9 (€2 in chips) 
Seat 4: NEMOXYX (€2.10 in chips) 
Seat 5: RichyPozo (€2.39 in chips) 
Seat 6: migueldep10 (€1.81 in chips) 
ehbraga: posts small blind €0.01
pipinoelbreve9: posts big blind €0.02
*** HOLE CARDS ***
Dealt to pipinoelbreve9 [8d As]
NEMOXYX: folds 
RichyPozo: folds 
migueldep10: raises €0.04 to €0.06
davidelgnomo747: folds 
ehbraga: folds 
pipinoelbreve9: calls €0.04
*** FLOP *** [9h Ac Tc]
pipinoelbreve9: bets €0.06
migueldep10: calls €0.06
*** TURN *** [9h Ac Tc] [5s]
pipinoelbreve9: bets €0.12
migueldep10: calls €0.12
*** RIVER *** [9h Ac Tc 5s] [3c]
pipinoelbreve9: checks 
migueldep10: checks 
*** SHOW DOWN ***
pipinoelbreve9: shows [8d As] (a pair of Aces)
migueldep10: mucks hand 
pipinoelbreve9 collected €0.47 from pot
*** SUMMARY ***
Total pot €0.49 | Rake €0.02 
Board [9h Ac Tc 5s 3c]
Seat 1: davidelgnomo747 (button) folded before Flop (didn't bet)
Seat 2: ehbraga (small blind) folded before Flop
Seat 3: pipinoelbreve9 (big blind) showed [8d As] and won (€0.47) with a pair of Aces
Seat 4: NEMOXYX folded before Flop (didn't bet)
Seat 5: RichyPozo folded before Flop (didn't bet)
Seat 6: migueldep10 mucked [Jc Jh]



PokerStars Zoom Hand #257556394961:  Hold'em No Limit (€0.01/€0.02) - 2025/08/31 15:31:47 CET [2025/08/31 9:31:47 ET]
Table 'Arneb' 6-max Seat #1 is the button
Seat 1: pipinoelbreve9 (€2.23 in chips) 
Seat 2: chaboargudin (€0.91 in chips) 
Seat 3: DavSnook (€0.58 in chips) 
Seat 4: oriollucena (€5.75 in chips) 
Seat 5: GamerVidal (€2.27 in chips) 
Seat 6: NEMOXYX (€4.48 in chips) 
chaboargudin: posts small blind €0.01
DavSnook: posts big blind €0.02
*** HOLE CARDS ***
Dealt to pipinoelbreve9 [Kd Qh]
oriollucena: folds 
GamerVidal: folds 
NEMOXYX: folds 
pipinoelbreve9: raises €0.04 to €0.06
chaboargudin: folds 
DavSnook: folds 
Uncalled bet (€0.04) returned to pipinoelbreve9
pipinoelbreve9 collected €0.05 from pot
pipinoelbreve9: doesn't show hand 
*** SUMMARY ***
Total pot €0.05 | Rake €0 
Seat 1: pipinoelbreve9 (button) collected (€0.05)
Seat 2: chaboargudin (small blind) folded before Flop
Seat 3: DavSnook (big blind) folded before Flop
Seat 4: oriollucena folded before Flop (didn't bet)
Seat 5: GamerVidal folded before Flop (didn't bet)
Seat 6: NEMOXYX folded before Flop (didn't bet)



PokerStars Zoom Hand #257556397495:  Hold'em No Limit (€0.01/€0.02) - 2025/08/31 15:32:03 CET [2025/08/31 9:32:03 ET]
Table 'Arneb' 6-max Seat #1 is the button
Seat 1: jupiter451 (€1.89 in chips) 
Seat 2: choro244 (€2.79 in chips) 
Seat 3: ehbraga (€0.81 in chips) 
Seat 4: POUPIOU65 (€4.65 in chips) 
Seat 5: pipinoelbreve9 (€2.26 in chips) 
Seat 6: wilbor123 (€1.95 in chips) 
choro244: posts small blind €0.01
ehbraga: posts big blind €0.02
*** HOLE CARDS ***
Dealt to pipinoelbreve9 [2d 3h]
POUPIOU65: raises €0.03 to €0.05
pipinoelbreve9: folds 
wilbor123: folds 
jupiter451: folds 
choro244: folds 
ehbraga: calls €0.03
*** FLOP *** [Jh 6s Qd]
ehbraga: bets €0.10
POUPIOU65: folds 
Uncalled bet (€0.10) returned to ehbraga
ehbraga collected €0.10 from pot
ehbraga: doesn't show hand 
*** SUMMARY ***
Total pot €0.11 | Rake €0.01 
Board [Jh 6s Qd]
Seat 1: jupiter451 (button) folded before Flop (didn't bet)
Seat 2: choro244 (small blind) folded before Flop
Seat 3: ehbraga (big blind) collected (€0.10)
Seat 4: POUPIOU65 folded on the Flop
Seat 5: pipinoelbreve9 folded before Flop (didn't bet)
Seat 6: wilbor123 folded before Flop (didn't bet)



PokerStars Zoom Hand #257556398110:  Hold'em No Limit (€0.01/€0.02) - 2025/08/31 15:32:07 CET [2025/08/31 9:32:07 ET]
Table 'Arneb' 6-max Seat #1 is the button
Seat 1: serviettski(fr) (€2.06 in chips) 
Seat 2: pipinoelbreve9 (€2.26 in chips) 
Seat 3: jorgepinto34 (€2.39 in chips) 
Seat 4: DarkSidious666 (€3.66 in chips) 
Seat 5: wilbor123 (€1.95 in chips) 
Seat 6: koka1151 (€2.01 in chips) 
pipinoelbreve9: posts small blind €0.01
jorgepinto34: posts big blind €0.02
*** HOLE CARDS ***
Dealt to pipinoelbreve9 [Qc 7s]
DarkSidious666: folds 
wilbor123: folds 
koka1151: folds 
serviettski(fr): folds 
pipinoelbreve9: raises €0.04 to €0.06
jorgepinto34: calls €0.04
*** FLOP *** [9h 8h 3d]
pipinoelbreve9: checks 
jorgepinto34: checks 
*** TURN *** [9h 8h 3d] [2s]
pipinoelbreve9: checks 
jorgepinto34: checks 
*** RIVER *** [9h 8h 3d 2s] [Jc]
pipinoelbreve9: checks 
jorgepinto34: checks 
*** SHOW DOWN ***
pipinoelbreve9: shows [Qc 7s] (high card Queen)
jorgepinto34: mucks hand 
pipinoelbreve9 collected €0.11 from pot
*** SUMMARY ***
Total pot €0.12 | Rake €0.01 
Board [9h 8h 3d 2s Jc]
Seat 1: serviettski(fr) (button) folded before Flop (didn't bet)
Seat 2: pipinoelbreve9 (small blind) showed [Qc 7s] and won (€0.11) with high card Queen
Seat 3: jorgepinto34 (big blind) mucked [4d 6d]
Seat 4: DarkSidious666 folded before Flop (didn't bet)
Seat 5: wilbor123 folded before Flop (didn't bet)
Seat 6: koka1151 folded before Flop (didn't bet)



PokerStars Zoom Hand #257556407434:  Hold'em No Limit (€0.01/€0.02) - 2025/08/31 15:33:04 CET [2025/08/31 9:33:04 ET]
Table 'Arneb' 6-max Seat #1 is the button
Seat 1: Jah2U (€0.60 in chips) 
Seat 2: cruass (€2.64 in chips) 
Seat 3: DarkSidious666 (€4.95 in chips) 
Seat 4: jorgepinto34 (€2.33 in chips) 
Seat 5: 34pluto (€1.67 in chips) 
Seat 6: pipinoelbreve9 (€2.31 in chips) 
cruass: posts small blind €0.01
DarkSidious666: posts big blind €0.02
*** HOLE CARDS ***
Dealt to pipinoelbreve9 [Th Qc]
jorgepinto34: folds 
34pluto: raises €0.02 to €0.04
pipinoelbreve9: folds 
Jah2U: folds 
cruass: folds 
DarkSidious666: folds 
Uncalled bet (€0.02) returned to 34pluto
34pluto collected €0.05 from pot
34pluto: doesn't show hand 
*** SUMMARY ***
Total pot €0.05 | Rake €0 
Seat 1: Jah2U (button) folded before Flop (didn't bet)
Seat 2: cruass (small blind) folded before Flop
Seat 3: DarkSidious666 (big blind) folded before Flop
Seat 4: jorgepinto34 folded before Flop (didn't bet)
Seat 5: 34pluto collected (€0.05)
Seat 6: pipinoelbreve9 folded before Flop (didn't bet)



PokerStars Zoom Hand #257556410238:  Hold'em No Limit (€0.01/€0.02) - 2025/08/31 15:33:22 CET [2025/08/31 9:33:22 ET]
Table 'Arneb' 6-max Seat #1 is the button
Seat 1: serviettski(fr) (€2.02 in chips) 
Seat 2: rare12345 (€2.12 in chips) 
Seat 3: pipinoelbreve9 (€2.31 in chips) 
Seat 4: Jah2U (€0.60 in chips) 
Seat 5: eric stl 196 (€1.62 in chips) 
Seat 6: gin_213 (€3.53 in chips) 
rare12345: posts small blind €0.01
pipinoelbreve9: posts big blind €0.02
*** HOLE CARDS ***
Dealt to pipinoelbreve9 [2d 8h]
Jah2U: calls €0.02
eric stl 196: folds 
gin_213: folds 
serviettski(fr): folds 
rare12345: calls €0.01
pipinoelbreve9: checks 
*** FLOP *** [Ac 3c 3h]
rare12345: checks 
pipinoelbreve9: checks 
Jah2U: checks 
*** TURN *** [Ac 3c 3h] [Jd]
rare12345: checks 
pipinoelbreve9: checks 
Jah2U: bets €0.06
rare12345: folds 
pipinoelbreve9: folds 
Uncalled bet (€0.06) returned to Jah2U
Jah2U collected €0.06 from pot
Jah2U: doesn't show hand 
*** SUMMARY ***
Total pot €0.06 | Rake €0 
Board [Ac 3c 3h Jd]
Seat 1: serviettski(fr) (button) folded before Flop (didn't bet)
Seat 2: rare12345 (small blind) folded on the Turn
Seat 3: pipinoelbreve9 (big blind) folded on the Turn
Seat 4: Jah2U collected (€0.06)
Seat 5: eric stl 196 folded before Flop (didn't bet)
Seat 6: gin_213 folded before Flop (didn't bet)



PokerStars Zoom Hand #257556415190:  Hold'em No Limit (€0.01/€0.02) - 2025/08/31 15:33:52 CET [2025/08/31 9:33:52 ET]
Table 'Arneb' 6-max Seat #1 is the button
Seat 1: 34pluto (€2.04 in chips) 
Seat 2: pipinoelbreve9 (€2.29 in chips) 
Seat 3: chaboargudin (€0.90 in chips) 
Seat 4: koka1151 (€2 in chips) 
Seat 5: davidelgnomo747 (€0.44 in chips) 
Seat 6: Giotto000 (€5.75 in chips) 
pipinoelbreve9: posts small blind €0.01
chaboargudin: posts big blind €0.02
*** HOLE CARDS ***
Dealt to pipinoelbreve9 [Qs 3d]
koka1151: folds 
davidelgnomo747: folds 
Giotto000: folds 
34pluto: folds 
pipinoelbreve9: folds 
Uncalled bet (€0.01) returned to chaboargudin
chaboargudin collected €0.02 from pot
chaboargudin: doesn't show hand 
*** SUMMARY ***
Total pot €0.02 | Rake €0 
Seat 1: 34pluto (button) folded before Flop (didn't bet)
Seat 2: pipinoelbreve9 (small blind) folded before Flop
Seat 3: chaboargudin (big blind) collected (€0.02)
Seat 4: koka1151 folded before Flop (didn't bet)
Seat 5: davidelgnomo747 folded before Flop (didn't bet)
Seat 6: Giotto000 folded before Flop (didn't bet)



PokerStars Zoom Hand #257556409746:  Hold'em No Limit (€0.01/€0.02) - 2025/08/31 15:33:19 CET [2025/08/31 9:33:19 ET]
Table 'Arneb' 6-max Seat #1 is the button
Seat 1: RichyPozo (€2.32 in chips) 
Seat 2: 34pluto (€1.52 in chips) 
Seat 3: Mai SA135 (€2 in chips) 
Seat 4: pipinoelbreve9 (€2.31 in chips) 
Seat 5: juanlu2000china (€1.97 in chips) 
Seat 6: Diefa4466 (€2.13 in chips) 
34pluto: posts small blind €0.01
Mai SA135: posts big blind €0.02
*** HOLE CARDS ***
Dealt to pipinoelbreve9 [2d Kd]
pipinoelbreve9: folds 
juanlu2000china: raises €0.04 to €0.06
Diefa4466: folds 
RichyPozo: folds 
34pluto: folds 
Mai SA135: calls €0.04
*** FLOP *** [9h 3s Qh]
Mai SA135: checks 
juanlu2000china: bets €0.06
Mai SA135: raises €0.12 to €0.18
juanlu2000china: calls €0.12
*** TURN *** [9h 3s Qh] [2c]
Mai SA135: checks 
juanlu2000china: bets €0.24
Mai SA135: calls €0.24
*** RIVER *** [9h 3s Qh 2c] [Td]
Mai SA135: bets €0.46
juanlu2000china: calls €0.46
*** SHOW DOWN ***
Mai SA135: shows [Qd Tc] (two pair, Queens and Tens)
juanlu2000china: mucks hand 
Mai SA135 collected €1.80 from pot
*** SUMMARY ***
Total pot €1.89 | Rake €0.09 
Board [9h 3s Qh 2c Td]
Seat 1: RichyPozo (button) folded before Flop (didn't bet)
Seat 2: 34pluto (small blind) folded before Flop
Seat 3: Mai SA135 (big blind) showed [Qd Tc] and won (€1.80) with two pair, Queens and Tens
Seat 4: pipinoelbreve9 folded before Flop (didn't bet)
Seat 5: juanlu2000china mucked [As Ah]
Seat 6: Diefa4466 folded before Flop (didn't bet)



PokerStars Zoom Hand #257556416562:  Hold'em No Limit (€0.01/€0.02) - 2025/08/31 15:34:01 CET [2025/08/31 9:34:01 ET]
Table 'Arneb' 6-max Seat #1 is the button
Seat 1: pipinoelbreve9 (€2.28 in chips) 
Seat 2: TIOGUY7 (€0.93 in chips) 
Seat 3: raptureman1 (€6.44 in chips) 
Seat 4: adaonogueira (€3.53 in chips) 
Seat 5: serviettski(fr) (€2 in chips) 
Seat 6: ratomi (€1.19 in chips) 
TIOGUY7: posts small blind €0.01
raptureman1: posts big blind €0.02
*** HOLE CARDS ***
Dealt to pipinoelbreve9 [Kd Jh]
adaonogueira: folds 
serviettski(fr): folds 
ratomi: folds 
pipinoelbreve9: raises €0.04 to €0.06
TIOGUY7: folds 
raptureman1: folds 
Uncalled bet (€0.04) returned to pipinoelbreve9
pipinoelbreve9 collected €0.05 from pot
pipinoelbreve9: doesn't show hand 
*** SUMMARY ***
Total pot €0.05 | Rake €0 
Seat 1: pipinoelbreve9 (button) collected (€0.05)
Seat 2: TIOGUY7 (small blind) folded before Flop
Seat 3: raptureman1 (big blind) folded before Flop
Seat 4: adaonogueira folded before Flop (didn't bet)
Seat 5: serviettski(fr) folded before Flop (didn't bet)
Seat 6: ratomi folded before Flop (didn't bet)



PokerStars Zoom Hand #257556421194:  Hold'em No Limit (€0.01/€0.02) - 2025/08/31 15:34:29 CET [2025/08/31 9:34:29 ET]
Table 'Arneb' 6-max Seat #1 is the button
Seat 1: Jah2U (€0.64 in chips) 
Seat 2: Lucian Morel (€1.98 in chips) 
Seat 3: candarias (€1.29 in chips) 
Seat 4: wilbor123 (€2.30 in chips) 
Seat 5: serviettski(fr) (€2.03 in chips) 
Seat 6: pipinoelbreve9 (€2.31 in chips) 
Lucian Morel: posts small blind €0.01
candarias: posts big blind €0.02
*** HOLE CARDS ***
Dealt to pipinoelbreve9 [3d 7s]
wilbor123: folds 
serviettski(fr): folds 
pipinoelbreve9: folds 
Jah2U: raises €0.02 to €0.04
Lucian Morel: folds 
candarias: raises €0.09 to €0.13
Jah2U: folds 
Uncalled bet (€0.09) returned to candarias
candarias collected €0.09 from pot
candarias: doesn't show hand 
*** SUMMARY ***
Total pot €0.09 | Rake €0 
Seat 1: Jah2U (button) folded before Flop
Seat 2: Lucian Morel (small blind) folded before Flop
Seat 3: candarias (big blind) collected (€0.09)
Seat 4: wilbor123 folded before Flop (didn't bet)
Seat 5: serviettski(fr) folded before Flop (didn't bet)
Seat 6: pipinoelbreve9 folded before Flop (didn't bet)



PokerStars Zoom Hand #257556423139:  Hold'em No Limit (€0.01/€0.02) - 2025/08/31 15:34:41 CET [2025/08/31 9:34:41 ET]
Table 'Arneb' 6-max Seat #1 is the button
Seat 1: DavSnook (€2.48 in chips) 
Seat 2: Zecapt23 (€1.57 in chips) 
Seat 3: DarkSidious666 (€2.16 in chips) 
Seat 4: POUPIOU65 (€2.08 in chips) 
Seat 5: pipinoelbreve9 (€2.31 in chips) 
Seat 6: jupiter451 (€0.95 in chips) 
Zecapt23: posts small blind €0.01
DarkSidious666: posts big blind €0.02
*** HOLE CARDS ***
Dealt to pipinoelbreve9 [6h Th]
POUPIOU65: folds 
pipinoelbreve9: folds 
jupiter451: calls €0.02
DavSnook: folds 
Zecapt23: calls €0.01
DarkSidious666: checks 
*** FLOP *** [3c 8c 8h]
Zecapt23: checks 
DarkSidious666: checks 
jupiter451: checks 
*** TURN *** [3c 8c 8h] [Ad]
Zecapt23: bets €0.06
DarkSidious666: folds 
jupiter451: folds 
Uncalled bet (€0.06) returned to Zecapt23
Zecapt23 collected €0.06 from pot
Zecapt23: doesn't show hand 
*** SUMMARY ***
Total pot €0.06 | Rake €0 
Board [3c 8c 8h Ad]
Seat 1: DavSnook (button) folded before Flop (didn't bet)
Seat 2: Zecapt23 (small blind) collected (€0.06)
Seat 3: DarkSidious666 (big blind) folded on the Turn
Seat 4: POUPIOU65 folded before Flop (didn't bet)
Seat 5: pipinoelbreve9 folded before Flop (didn't bet)
Seat 6: jupiter451 folded on the Turn



PokerStars Zoom Hand #257556424508:  Hold'em No Limit (€0.01/€0.02) - 2025/08/31 15:34:49 CET [2025/08/31 9:34:49 ET]
Table 'Arneb' 6-max Seat #1 is the button
Seat 1: GamerVidal (€2.64 in chips) 
Seat 2: leobcn9 (€2 in chips) 
Seat 3: pipinoelbreve9 (€2.31 in chips) 
Seat 4: poteaarte (€2.70 in chips) 
Seat 5: NEMOXYX (€4.58 in chips) 
Seat 6: oriollucena (€5.78 in chips) 
leobcn9: posts small blind €0.01
pipinoelbreve9: posts big blind €0.02
*** HOLE CARDS ***
Dealt to pipinoelbreve9 [3c 4c]
poteaarte: folds 
NEMOXYX: folds 
oriollucena: folds 
GamerVidal: folds 
leobcn9: raises €0.04 to €0.06
pipinoelbreve9: calls €0.04
*** FLOP *** [9c Ac 9d]
leobcn9: bets €0.04
pipinoelbreve9: calls €0.04
*** TURN *** [9c Ac 9d] [Qc]
leobcn9: bets €0.06
pipinoelbreve9: calls €0.06
*** RIVER *** [9c Ac 9d Qc] [7d]
leobcn9: checks 
pipinoelbreve9: bets €0.26
leobcn9: folds 
Uncalled bet (€0.26) returned to pipinoelbreve9
pipinoelbreve9 collected €0.30 from pot
pipinoelbreve9: doesn't show hand 
*** SUMMARY ***
Total pot €0.32 | Rake €0.02 
Board [9c Ac 9d Qc 7d]
Seat 1: GamerVidal (button) folded before Flop (didn't bet)
Seat 2: leobcn9 (small blind) folded on the River
Seat 3: pipinoelbreve9 (big blind) collected (€0.30)
Seat 4: poteaarte folded before Flop (didn't bet)
Seat 5: NEMOXYX folded before Flop (didn't bet)
Seat 6: oriollucena folded before Flop (didn't bet)



PokerStars Zoom Hand #257556429959:  Hold'em No Limit (€0.01/€0.02) - 2025/08/31 15:35:22 CET [2025/08/31 9:35:22 ET]
Table 'Arneb' 6-max Seat #1 is the button
Seat 1: pipinoelbreve9 (€2.45 in chips) 
Seat 2: odace15 (€4.77 in chips) 
Seat 3: DavSnook (€2.46 in chips) 
Seat 4: ratomi (€1.25 in chips) 
Seat 5: oriollucena (€5.74 in chips) 
Seat 6: MichaëLR7 (€4.23 in chips) 
odace15: posts small blind €0.01
DavSnook: posts big blind €0.02
*** HOLE CARDS ***
Dealt to pipinoelbreve9 [6d 4d]
ratomi: raises €0.04 to €0.06
oriollucena: folds 
MichaëLR7: calls €0.06
pipinoelbreve9: folds 
odace15: folds 
DavSnook: calls €0.04
*** FLOP *** [6h As Kd]
DavSnook: checks 
ratomi: checks 
MichaëLR7: checks 
*** TURN *** [6h As Kd] [4s]
DavSnook: checks 
ratomi: checks 
MichaëLR7: checks 
*** RIVER *** [6h As Kd 4s] [Ad]
DavSnook: bets €0.09
ratomi: folds 
MichaëLR7: folds 
Uncalled bet (€0.09) returned to DavSnook
DavSnook collected €0.18 from pot
DavSnook: doesn't show hand 
*** SUMMARY ***
Total pot €0.19 | Rake €0.01 
Board [6h As Kd 4s Ad]
Seat 1: pipinoelbreve9 (button) folded before Flop (didn't bet)
Seat 2: odace15 (small blind) folded before Flop
Seat 3: DavSnook (big blind) collected (€0.18)
Seat 4: ratomi folded on the River
Seat 5: oriollucena folded before Flop (didn't bet)
Seat 6: MichaëLR7 folded on the River



PokerStars Zoom Hand #257556431970:  Hold'em No Limit (€0.01/€0.02) - 2025/08/31 15:35:34 CET [2025/08/31 9:35:34 ET]
Table 'Arneb' 6-max Seat #1 is the button
Seat 1: leobcn9 (€2 in chips) 
Seat 2: pipinoelbreve9 (€2.45 in chips) 
Seat 3: MagicGitox (€2.31 in chips) 
Seat 4: Diefa4466 (€5.37 in chips) 
Seat 5: Abrelatas787 (€2 in chips) 
Seat 6: flx5757 (€1.61 in chips) 
pipinoelbreve9: posts small blind €0.01
MagicGitox: posts big blind €0.02
*** HOLE CARDS ***
Dealt to pipinoelbreve9 [4s Kc]
Diefa4466: folds 
Abrelatas787: folds 
flx5757: folds 
leobcn9: raises €0.04 to €0.06
pipinoelbreve9: calls €0.05
MagicGitox: calls €0.04
*** FLOP *** [Kd 6d 5h]
pipinoelbreve9: checks 
MagicGitox: checks 
leobcn9: checks 
*** TURN *** [Kd 6d 5h] [As]
pipinoelbreve9: bets €0.09
MagicGitox: folds 
leobcn9: calls €0.09
*** RIVER *** [Kd 6d 5h As] [Js]
pipinoelbreve9: checks 
leobcn9: checks 
*** SHOW DOWN ***
pipinoelbreve9: shows [4s Kc] (a pair of Kings)
leobcn9: mucks hand 
pipinoelbreve9 collected €0.34 from pot
*** SUMMARY ***
Total pot €0.36 | Rake €0.02 
Board [Kd 6d 5h As Js]
Seat 1: leobcn9 (button) mucked [Jd Qh]
Seat 2: pipinoelbreve9 (small blind) showed [4s Kc] and won (€0.34) with a pair of Kings
Seat 3: MagicGitox (big blind) folded on the Turn
Seat 4: Diefa4466 folded before Flop (didn't bet)
Seat 5: Abrelatas787 folded before Flop (didn't bet)
Seat 6: flx5757 folded before Flop (didn't bet)



PokerStars Zoom Hand #257556441640:  Hold'em No Limit (€0.01/€0.02) - 2025/08/31 15:36:32 CET [2025/08/31 9:36:32 ET]
Table 'Arneb' 6-max Seat #1 is the button
Seat 1: DarkSidious666 (€2.10 in chips) 
Seat 2: gustcap98 (€1.49 in chips) 
Seat 3: POUPIOU65 (€3.09 in chips) 
Seat 4: 34pluto (€1.85 in chips) 
Seat 5: odace15 (€3.96 in chips) 
Seat 6: pipinoelbreve9 (€2.64 in chips) 
gustcap98: posts small blind €0.01
POUPIOU65: posts big blind €0.02
*** HOLE CARDS ***
Dealt to pipinoelbreve9 [2c 3d]
34pluto: folds 
odace15: folds 
pipinoelbreve9: folds 
DarkSidious666: folds 
gustcap98: folds 
Uncalled bet (€0.01) returned to POUPIOU65
POUPIOU65 collected €0.02 from pot
POUPIOU65: doesn't show hand 
*** SUMMARY ***
Total pot €0.02 | Rake €0 
Seat 1: DarkSidious666 (button) folded before Flop (didn't bet)
Seat 2: gustcap98 (small blind) folded before Flop
Seat 3: POUPIOU65 (big blind) collected (€0.02)
Seat 4: 34pluto folded before Flop (didn't bet)
Seat 5: odace15 folded before Flop (didn't bet)
Seat 6: pipinoelbreve9 folded before Flop (didn't bet)



PokerStars Zoom Hand #257556443170:  Hold'em No Limit (€0.01/€0.02) - 2025/08/31 15:36:41 CET [2025/08/31 9:36:41 ET]
Table 'Arneb' 6-max Seat #1 is the button
Seat 1: davidelgnomo747 (€2.71 in chips) 
Seat 2: DavSnook (€1.52 in chips) 
Seat 3: ehbraga (€0.82 in chips) 
Seat 4: pipinoelbreve9 (€2.64 in chips) 
Seat 5: odace15 (€3.96 in chips) 
Seat 6: Sanpetas (€2.41 in chips) 
DavSnook: posts small blind €0.01
ehbraga: posts big blind €0.02
*** HOLE CARDS ***
Dealt to pipinoelbreve9 [9c As]
pipinoelbreve9: folds 
odace15: folds 
Sanpetas: folds 
davidelgnomo747: raises €0.04 to €0.06
DavSnook: calls €0.05
ehbraga: calls €0.04
*** FLOP *** [4s Ts Th]
DavSnook: checks 
ehbraga: bets €0.09
davidelgnomo747: folds 
DavSnook: folds 
Uncalled bet (€0.09) returned to ehbraga
ehbraga collected €0.17 from pot
ehbraga: doesn't show hand 
*** SUMMARY ***
Total pot €0.18 | Rake €0.01 
Board [4s Ts Th]
Seat 1: davidelgnomo747 (button) folded on the Flop
Seat 2: DavSnook (small blind) folded on the Flop
Seat 3: ehbraga (big blind) collected (€0.17)
Seat 4: pipinoelbreve9 folded before Flop (didn't bet)
Seat 5: odace15 folded before Flop (didn't bet)
Seat 6: Sanpetas folded before Flop (didn't bet)



PokerStars Zoom Hand #257556440589:  Hold'em No Limit (€0.01/€0.02) - 2025/08/31 15:36:26 CET [2025/08/31 9:36:26 ET]
Table 'Arneb' 6-max Seat #1 is the button
Seat 1: juanktyga (€2 in chips) 
Seat 2: leobcn9 (€2 in chips) 
Seat 3: DarkSidious666 (€9.19 in chips) 
Seat 4: pipinoelbreve9 (€2.64 in chips) 
Seat 5: raptureman1 (€6.39 in chips) 
Seat 6: Lucian Morel (€2.13 in chips) 
leobcn9: posts small blind €0.01
DarkSidious666: posts big blind €0.02
*** HOLE CARDS ***
Dealt to pipinoelbreve9 [4s Th]
pipinoelbreve9: folds 
raptureman1: folds 
Lucian Morel: folds 
juanktyga: raises €0.03 to €0.05
leobcn9: folds 
DarkSidious666: raises €0.11 to €0.16
juanktyga: calls €0.11
*** FLOP *** [8s Ac 8c]
DarkSidious666: bets €0.20
juanktyga: calls €0.20
*** TURN *** [8s Ac 8c] [6h]
DarkSidious666: bets €0.45
juanktyga: raises €1.19 to €1.64 and is all-in
DarkSidious666: folds 
Uncalled bet (€1.19) returned to juanktyga
juanktyga collected €1.55 from pot
juanktyga: doesn't show hand 
*** SUMMARY ***
Total pot €1.63 | Rake €0.08 
Board [8s Ac 8c 6h]
Seat 1: juanktyga (button) collected (€1.55)
Seat 2: leobcn9 (small blind) folded before Flop
Seat 3: DarkSidious666 (big blind) folded on the Turn
Seat 4: pipinoelbreve9 folded before Flop (didn't bet)
Seat 5: raptureman1 folded before Flop (didn't bet)
Seat 6: Lucian Morel folded before Flop (didn't bet)



PokerStars Zoom Hand #257556444480:  Hold'em No Limit (€0.01/€0.02) - 2025/08/31 15:36:49 CET [2025/08/31 9:36:49 ET]
Table 'Arneb' 6-max Seat #1 is the button
Seat 1: 34pluto (€1.43 in chips) 
Seat 2: gin_213 (€1.89 in chips) 
Seat 3: Sanpetas (€2.41 in chips) 
Seat 4: Diefa4466 (€2.30 in chips) 
Seat 5: gustcap98 (€1.48 in chips) 
Seat 6: pipinoelbreve9 (€2.64 in chips) 
gin_213: posts small blind €0.01
Sanpetas: posts big blind €0.02
*** HOLE CARDS ***
Dealt to pipinoelbreve9 [Kh Tc]
Diefa4466: folds 
gustcap98: folds 
pipinoelbreve9: raises €0.04 to €0.06
34pluto: folds 
gin_213: folds 
Sanpetas: calls €0.04
*** FLOP *** [5h Qd 9c]
Sanpetas: checks 
pipinoelbreve9: checks 
*** TURN *** [5h Qd 9c] [3s]
Sanpetas: bets €0.02
pipinoelbreve9: calls €0.02
*** RIVER *** [5h Qd 9c 3s] [6c]
Sanpetas: bets €0.04
pipinoelbreve9: folds 
Uncalled bet (€0.04) returned to Sanpetas
Sanpetas collected €0.16 from pot
Sanpetas: doesn't show hand 
*** SUMMARY ***
Total pot €0.17 | Rake €0.01 
Board [5h Qd 9c 3s 6c]
Seat 1: 34pluto (button) folded before Flop (didn't bet)
Seat 2: gin_213 (small blind) folded before Flop
Seat 3: Sanpetas (big blind) collected (€0.16)
Seat 4: Diefa4466 folded before Flop (didn't bet)
Seat 5: gustcap98 folded before Flop (didn't bet)
Seat 6: pipinoelbreve9 folded on the River



PokerStars Zoom Hand #257556442367:  Hold'em No Limit (€0.01/€0.02) - 2025/08/31 15:36:36 CET [2025/08/31 9:36:36 ET]
Table 'Arneb' 6-max Seat #1 is the button
Seat 1: wilbor123 (€2.02 in chips) 
Seat 2: Mai SA135 (€1.33 in chips) 
Seat 3: ehbraga (€0.71 in chips) 
Seat 4: mandru80 (€2.03 in chips) 
Seat 5: pipinoelbreve9 (€2.64 in chips) 
Seat 6: DarkSidious666 (€2.10 in chips) 
Mai SA135: posts small blind €0.01
ehbraga: posts big blind €0.02
*** HOLE CARDS ***
Dealt to pipinoelbreve9 [Kd 2s]
mandru80: folds 
pipinoelbreve9: folds 
DarkSidious666: folds 
wilbor123: raises €0.04 to €0.06
Mai SA135: calls €0.05
ehbraga: calls €0.04
*** FLOP *** [7c 7s Js]
Mai SA135: checks 
ehbraga: bets €0.09
wilbor123: folds 
Mai SA135: folds 
Uncalled bet (€0.09) returned to ehbraga
ehbraga collected €0.17 from pot
ehbraga: doesn't show hand 
*** SUMMARY ***
Total pot €0.18 | Rake €0.01 
Board [7c 7s Js]
Seat 1: wilbor123 (button) folded on the Flop
Seat 2: Mai SA135 (small blind) folded on the Flop
Seat 3: ehbraga (big blind) collected (€0.17)
Seat 4: mandru80 folded before Flop (didn't bet)
Seat 5: pipinoelbreve9 folded before Flop (didn't bet)
Seat 6: DarkSidious666 folded before Flop (didn't bet)



PokerStars Zoom Hand #257556451534:  Hold'em No Limit (€0.01/€0.02) - 2025/08/31 15:37:32 CET [2025/08/31 9:37:32 ET]
Table 'Arneb' 6-max Seat #1 is the button
Seat 1: candarias (€0.77 in chips) 
Seat 2: juanktyga (€2 in chips) 
Seat 3: pipinoelbreve9 (€2.56 in chips) 
Seat 4: migueldep10 (€1.50 in chips) 
Seat 5: 34pluto (€1.85 in chips) 
Seat 6: gin_213 (€1.85 in chips) 
juanktyga: posts small blind €0.01
pipinoelbreve9: posts big blind €0.02
*** HOLE CARDS ***
Dealt to pipinoelbreve9 [2c 5c]
migueldep10: folds 
34pluto: folds 
gin_213: raises €0.03 to €0.05
candarias: folds 
juanktyga: folds 
pipinoelbreve9: folds 
Uncalled bet (€0.03) returned to gin_213
gin_213 collected €0.05 from pot
gin_213: doesn't show hand 
*** SUMMARY ***
Total pot €0.05 | Rake €0 
Seat 1: candarias (button) folded before Flop (didn't bet)
Seat 2: juanktyga (small blind) folded before Flop
Seat 3: pipinoelbreve9 (big blind) folded before Flop
Seat 4: migueldep10 folded before Flop (didn't bet)
Seat 5: 34pluto folded before Flop (didn't bet)
Seat 6: gin_213 collected (€0.05)



PokerStars Zoom Hand #257556452893:  Hold'em No Limit (€0.01/€0.02) - 2025/08/31 15:37:40 CET [2025/08/31 9:37:40 ET]
Table 'Arneb' 6-max Seat #1 is the button
Seat 1: Diefa4466 (€5.42 in chips) 
Seat 2: pipinoelbreve9 (€2.54 in chips) 
Seat 3: manolo1953 (€0.95 in chips) 
Seat 4: DarkSidious666 (€5 in chips) 
Seat 5: RichyPozo (€2.11 in chips) 
Seat 6: DavSnook (€2.55 in chips) 
pipinoelbreve9: posts small blind €0.01
manolo1953: posts big blind €0.02
*** HOLE CARDS ***
Dealt to pipinoelbreve9 [Jh Ks]
DarkSidious666: raises €0.04 to €0.06
RichyPozo: calls €0.06
DavSnook: folds 
Diefa4466: folds 
pipinoelbreve9: calls €0.05
manolo1953: raises €0.34 to €0.40
DarkSidious666: folds 
RichyPozo: folds 
pipinoelbreve9: folds 
Uncalled bet (€0.34) returned to manolo1953
manolo1953 collected €0.24 from pot
manolo1953: doesn't show hand 
*** SUMMARY ***
Total pot €0.24 | Rake €0 
Seat 1: Diefa4466 (button) folded before Flop (didn't bet)
Seat 2: pipinoelbreve9 (small blind) folded before Flop
Seat 3: manolo1953 (big blind) collected (€0.24)
Seat 4: DarkSidious666 folded before Flop
Seat 5: RichyPozo folded before Flop
Seat 6: DavSnook folded before Flop (didn't bet)



PokerStars Zoom Hand #257556457138:  Hold'em No Limit (€0.01/€0.02) - 2025/08/31 15:38:06 CET [2025/08/31 9:38:06 ET]
Table 'Arneb' 6-max Seat #1 is the button
Seat 1: pipinoelbreve9 (€2.48 in chips) 
Seat 2: juanktyga (€2.66 in chips) 
Seat 3: DarkSidious666 (€3.61 in chips) 
Seat 4: DavSnook (€1.57 in chips) 
Seat 5: candarias (€0.85 in chips) 
Seat 6: jorgepinto34 (€2.18 in chips) 
juanktyga: posts small blind €0.01
DarkSidious666: posts big blind €0.02
*** HOLE CARDS ***
Dealt to pipinoelbreve9 [Ad 7c]
DavSnook: raises €0.05 to €0.07
candarias: folds 
jorgepinto34: folds 
pipinoelbreve9: folds 
juanktyga: folds 
DarkSidious666: folds 
Uncalled bet (€0.05) returned to DavSnook
DavSnook collected €0.05 from pot
DavSnook: doesn't show hand 
*** SUMMARY ***
Total pot €0.05 | Rake €0 
Seat 1: pipinoelbreve9 (button) folded before Flop (didn't bet)
Seat 2: juanktyga (small blind) folded before Flop
Seat 3: DarkSidious666 (big blind) folded before Flop
Seat 4: DavSnook collected (€0.05)
Seat 5: candarias folded before Flop (didn't bet)
Seat 6: jorgepinto34 folded before Flop (didn't bet)



PokerStars Zoom Hand #257556459219:  Hold'em No Limit (€0.01/€0.02) - 2025/08/31 15:38:19 CET [2025/08/31 9:38:19 ET]
Table 'Arneb' 6-max Seat #1 is the button
Seat 1: DarkSidious666 (€4.93 in chips) 
Seat 2: $Lose$All-In (€0.94 in chips) 
Seat 3: pipinoelbreve9 (€2.48 in chips) 
Seat 4: DavSnook (€2.35 in chips) 
Seat 5: rare12345 (€2 in chips) 
Seat 6: anflo13 (€2.35 in chips) 
$Lose$All-In: posts small blind €0.01
pipinoelbreve9: posts big blind €0.02
*** HOLE CARDS ***
Dealt to pipinoelbreve9 [Qs Jc]
DavSnook: folds 
rare12345: folds 
anflo13: folds 
DarkSidious666: folds 
$Lose$All-In: folds 
Uncalled bet (€0.01) returned to pipinoelbreve9
pipinoelbreve9 collected €0.02 from pot
pipinoelbreve9: doesn't show hand 
*** SUMMARY ***
Total pot €0.02 | Rake €0 
Seat 1: DarkSidious666 (button) folded before Flop (didn't bet)
Seat 2: $Lose$All-In (small blind) folded before Flop
Seat 3: pipinoelbreve9 (big blind) collected (€0.02)
Seat 4: DavSnook folded before Flop (didn't bet)
Seat 5: rare12345 folded before Flop (didn't bet)
Seat 6: anflo13 folded before Flop (didn't bet)



PokerStars Zoom Hand #257556458380:  Hold'em No Limit (€0.01/€0.02) - 2025/08/31 15:38:13 CET [2025/08/31 9:38:13 ET]
Table 'Arneb' 6-max Seat #1 is the button
Seat 1: DavSnook (€0.74 in chips) 
Seat 2: DarkSidious666 (€2.11 in chips) 
Seat 3: raptureman1 (€6.35 in chips) 
Seat 4: candarias (€0.85 in chips) 
Seat 5: pipinoelbreve9 (€2.48 in chips) 
Seat 6: migueldep10 (€1.50 in chips) 
DarkSidious666: posts small blind €0.01
raptureman1: posts big blind €0.02
*** HOLE CARDS ***
Dealt to pipinoelbreve9 [8h Js]
candarias: folds 
pipinoelbreve9: folds 
migueldep10: folds 
DavSnook: raises €0.05 to €0.07
DarkSidious666: folds 
raptureman1: folds 
Uncalled bet (€0.05) returned to DavSnook
DavSnook collected €0.05 from pot
DavSnook: doesn't show hand 
*** SUMMARY ***
Total pot €0.05 | Rake €0 
Seat 1: DavSnook (button) collected (€0.05)
Seat 2: DarkSidious666 (small blind) folded before Flop
Seat 3: raptureman1 (big blind) folded before Flop
Seat 4: candarias folded before Flop (didn't bet)
Seat 5: pipinoelbreve9 folded before Flop (didn't bet)
Seat 6: migueldep10 folded before Flop (didn't bet)



PokerStars Zoom Hand #257556460662:  Hold'em No Limit (€0.01/€0.02) - 2025/08/31 15:38:27 CET [2025/08/31 9:38:27 ET]
Table 'Arneb' 6-max Seat #1 is the button
Seat 1: wilbor123 (€1.97 in chips) 
Seat 2: rare12345 (€2 in chips) 
Seat 3: manolo1953 (€1.12 in chips) 
Seat 4: pipinoelbreve9 (€2.49 in chips) 
Seat 5: Lucian Morel (€2.20 in chips) 
Seat 6: GamerVidal (€3.76 in chips) 
rare12345: posts small blind €0.01
manolo1953: posts big blind €0.02
*** HOLE CARDS ***
Dealt to pipinoelbreve9 [Ah Qs]
pipinoelbreve9: raises €0.04 to €0.06
Lucian Morel: folds 
GamerVidal: folds 
wilbor123: folds 
rare12345: folds 
manolo1953: folds 
Uncalled bet (€0.04) returned to pipinoelbreve9
pipinoelbreve9 collected €0.05 from pot
pipinoelbreve9: doesn't show hand 
*** SUMMARY ***
Total pot €0.05 | Rake €0 
Seat 1: wilbor123 (button) folded before Flop (didn't bet)
Seat 2: rare12345 (small blind) folded before Flop
Seat 3: manolo1953 (big blind) folded before Flop
Seat 4: pipinoelbreve9 collected (€0.05)
Seat 5: Lucian Morel folded before Flop (didn't bet)
Seat 6: GamerVidal folded before Flop (didn't bet)



PokerStars Zoom Hand #257556465800:  Hold'em No Limit (€0.01/€0.02) - 2025/08/31 15:38:59 CET [2025/08/31 9:38:59 ET]
Table 'Arneb' 6-max Seat #1 is the button
Seat 1: Sanpetas (€2.87 in chips) 
Seat 2: pipinoelbreve9 (€2.52 in chips) 
Seat 3: DarkSidious666 (€3.58 in chips) 
Seat 4: choro244 (€3.57 in chips) 
Seat 5: serviettski(fr) (€2 in chips) 
Seat 6: raptureman1 (€6.26 in chips) 
pipinoelbreve9: posts small blind €0.01
DarkSidious666: posts big blind €0.02
*** HOLE CARDS ***
Dealt to pipinoelbreve9 [5s 4d]
choro244: folds 
serviettski(fr): folds 
raptureman1: folds 
Sanpetas: folds 
pipinoelbreve9: folds 
Uncalled bet (€0.01) returned to DarkSidious666
DarkSidious666 collected €0.02 from pot
DarkSidious666: doesn't show hand 
*** SUMMARY ***
Total pot €0.02 | Rake €0 
Seat 1: Sanpetas (button) folded before Flop (didn't bet)
Seat 2: pipinoelbreve9 (small blind) folded before Flop
Seat 3: DarkSidious666 (big blind) collected (€0.02)
Seat 4: choro244 folded before Flop (didn't bet)
Seat 5: serviettski(fr) folded before Flop (didn't bet)
Seat 6: raptureman1 folded before Flop (didn't bet)



PokerStars Zoom Hand #257556467422:  Hold'em No Limit (€0.01/€0.02) - 2025/08/31 15:39:10 CET [2025/08/31 9:39:10 ET]
Table 'Arneb' 6-max Seat #1 is the button
Seat 1: GamerVidal (€2.87 in chips) 
Seat 2: candarias (€0.82 in chips) 
Seat 3: pipinoelbreve9 (€2.51 in chips) 
Seat 4: DavSnook (€0.70 in chips) 
Seat 5: davidelgnomo747 (€0.94 in chips) 
Seat 6: wilbor123 (€2.04 in chips) 
candarias: posts small blind €0.01
pipinoelbreve9: posts big blind €0.02
*** HOLE CARDS ***
Dealt to pipinoelbreve9 [3c 5d]
DavSnook: folds 
davidelgnomo747: folds 
wilbor123: folds 
GamerVidal: folds 
candarias: folds 
Uncalled bet (€0.01) returned to pipinoelbreve9
pipinoelbreve9 collected €0.02 from pot
pipinoelbreve9: doesn't show hand 
*** SUMMARY ***
Total pot €0.02 | Rake €0 
Seat 1: GamerVidal (button) folded before Flop (didn't bet)
Seat 2: candarias (small blind) folded before Flop
Seat 3: pipinoelbreve9 (big blind) collected (€0.02)
Seat 4: DavSnook folded before Flop (didn't bet)
Seat 5: davidelgnomo747 folded before Flop (didn't bet)
Seat 6: wilbor123 folded before Flop (didn't bet)



PokerStars Zoom Hand #257556469348:  Hold'em No Limit (€0.01/€0.02) - 2025/08/31 15:39:21 CET [2025/08/31 9:39:21 ET]
Table 'Arneb' 6-max Seat #1 is the button
Seat 1: janjos69 (€2.14 in chips) 
Seat 2: DavSnook (€3.20 in chips) 
Seat 3: wilbor123 (€1.99 in chips) 
Seat 4: candarias (€0.81 in chips) 
Seat 5: dday14540 (€2.06 in chips) 
Seat 6: pipinoelbreve9 (€2.52 in chips) 
DavSnook: posts small blind €0.01
wilbor123: posts big blind €0.02
*** HOLE CARDS ***
Dealt to pipinoelbreve9 [3s Jc]
candarias: folds 
dday14540: folds 
pipinoelbreve9: folds 
janjos69: folds 
DavSnook: folds 
Uncalled bet (€0.01) returned to wilbor123
wilbor123 collected €0.02 from pot
wilbor123: doesn't show hand 
*** SUMMARY ***
Total pot €0.02 | Rake €0 
Seat 1: janjos69 (button) folded before Flop (didn't bet)
Seat 2: DavSnook (small blind) folded before Flop
Seat 3: wilbor123 (big blind) collected (€0.02)
Seat 4: candarias folded before Flop (didn't bet)
Seat 5: dday14540 folded before Flop (didn't bet)
Seat 6: pipinoelbreve9 folded before Flop (didn't bet)



PokerStars Zoom Hand #257556463557:  Hold'em No Limit (€0.01/€0.02) - 2025/08/31 15:38:45 CET [2025/08/31 9:38:45 ET]
Table 'Arneb' 6-max Seat #1 is the button
Seat 1: pipinoelbreve9 (€2.52 in chips) 
Seat 2: Lucian Morel (€2.20 in chips) 
Seat 3: DavSnook (€1.63 in chips) 
Seat 4: poteaarte (€2.21 in chips) 
Seat 5: ehbraga (€1.05 in chips) 
Seat 6: juanktyga (€2.05 in chips) 
Lucian Morel: posts small blind €0.01
DavSnook: posts big blind €0.02
*** HOLE CARDS ***
Dealt to pipinoelbreve9 [7d 8h]
ehbraga is disconnected 
poteaarte: folds 
ehbraga has timed out while disconnected
ehbraga: folds 
juanktyga: folds 
pipinoelbreve9: folds 
Lucian Morel: raises €0.04 to €0.06
DavSnook: calls €0.04
*** FLOP *** [2c 6s 3c]
Lucian Morel: bets €0.04
DavSnook: calls €0.04
*** TURN *** [2c 6s 3c] [5c]
Lucian Morel: checks 
DavSnook: bets €0.10
Lucian Morel: folds 
Uncalled bet (€0.10) returned to DavSnook
DavSnook collected €0.19 from pot
DavSnook: doesn't show hand 
*** SUMMARY ***
Total pot €0.20 | Rake €0.01 
Board [2c 6s 3c 5c]
Seat 1: pipinoelbreve9 (button) folded before Flop (didn't bet)
Seat 2: Lucian Morel (small blind) folded on the Turn
Seat 3: DavSnook (big blind) collected (€0.19)
Seat 4: poteaarte folded before Flop (didn't bet)
Seat 5: ehbraga folded before Flop (didn't bet)
Seat 6: juanktyga folded before Flop (didn't bet)



PokerStars Zoom Hand #257556466855:  Hold'em No Limit (€0.01/€0.02) - 2025/08/31 15:39:06 CET [2025/08/31 9:39:06 ET]
Table 'Arneb' 6-max Seat #1 is the button
Seat 1: juanlu2000china (€1.83 in chips) 
Seat 2: Jah2U (€0.49 in chips) 
Seat 3: candarias (€0.84 in chips) 
Seat 4: elenita_nait (€1.89 in chips) 
Seat 5: pipinoelbreve9 (€2.51 in chips) 
Seat 6: Mikange690 (€3.34 in chips) 
Jah2U: posts small blind €0.01
candarias: posts big blind €0.02
*** HOLE CARDS ***
Dealt to pipinoelbreve9 [2c Td]
elenita_nait: folds 
pipinoelbreve9: folds 
Mikange690: raises €0.02 to €0.04
juanlu2000china: calls €0.04
Jah2U: calls €0.03
candarias: folds 
*** FLOP *** [Ts 3d 8d]
Jah2U: checks 
Mikange690: bets €0.07
juanlu2000china: calls €0.07
Jah2U: folds 
*** TURN *** [Ts 3d 8d] [2d]
Mikange690: checks 
juanlu2000china: checks 
*** RIVER *** [Ts 3d 8d 2d] [Qc]
Mikange690: bets €0.28
juanlu2000china: calls €0.28
*** SHOW DOWN ***
Mikange690: shows [6d 5d] (a flush, Eight high)
juanlu2000china: shows [9c Jc] (a straight, Eight to Queen)
Mikange690 collected €0.80 from pot
*** SUMMARY ***
Total pot €0.84 | Rake €0.04 
Board [Ts 3d 8d 2d Qc]
Seat 1: juanlu2000china (button) showed [9c Jc] and lost with a straight, Eight to Queen
Seat 2: Jah2U (small blind) folded on the Flop
Seat 3: candarias (big blind) folded before Flop
Seat 4: elenita_nait folded before Flop (didn't bet)
Seat 5: pipinoelbreve9 folded before Flop (didn't bet)
Seat 6: Mikange690 showed [6d 5d] and won (€0.80) with a flush, Eight high



PokerStars Zoom Hand #257556470047:  Hold'em No Limit (€0.01/€0.02) - 2025/08/31 15:39:25 CET [2025/08/31 9:39:25 ET]
Table 'Arneb' 6-max Seat #1 is the button
Seat 1: rare12345 (€2.10 in chips) 
Seat 2: pipinoelbreve9 (€2.52 in chips) 
Seat 3: POUPIOU65 (€1.64 in chips) 
Seat 4: choro244 (€3.57 in chips) 
Seat 5: flx5757 (€3.01 in chips) 
Seat 6: DavSnook (€3.19 in chips) 
pipinoelbreve9: posts small blind €0.01
POUPIOU65: posts big blind €0.02
*** HOLE CARDS ***
Dealt to pipinoelbreve9 [Ks As]
choro244: folds 
flx5757: raises €0.04 to €0.06
DavSnook: folds 
rare12345: raises €0.12 to €0.18
pipinoelbreve9: raises €0.24 to €0.42
POUPIOU65: folds 
flx5757: folds 
rare12345: calls €0.24
*** FLOP *** [5d 3d 4d]
pipinoelbreve9: checks 
rare12345: checks 
*** TURN *** [5d 3d 4d] [4c]
pipinoelbreve9: checks 
rare12345: checks 
*** RIVER *** [5d 3d 4d 4c] [8d]
pipinoelbreve9: checks 
rare12345: checks 
*** SHOW DOWN ***
pipinoelbreve9: shows [Ks As] (a pair of Fours)
rare12345: shows [9s 9c] (two pair, Nines and Fours)
rare12345 collected €0.87 from pot
*** SUMMARY ***
Total pot €0.92 | Rake €0.05 
Board [5d 3d 4d 4c 8d]
Seat 1: rare12345 (button) showed [9s 9c] and won (€0.87) with two pair, Nines and Fours
Seat 2: pipinoelbreve9 (small blind) showed [Ks As] and lost with a pair of Fours
Seat 3: POUPIOU65 (big blind) folded before Flop
Seat 4: choro244 folded before Flop (didn't bet)
Seat 5: flx5757 folded before Flop
Seat 6: DavSnook folded before Flop (didn't bet)



PokerStars Zoom Hand #257556480910:  Hold'em No Limit (€0.01/€0.02) - 2025/08/31 15:40:31 CET [2025/08/31 9:40:31 ET]
Table 'Arneb' 6-max Seat #1 is the button
Seat 1: pipinoelbreve9 (€2.10 in chips) 
Seat 2: Lucian Morel (€2.11 in chips) 
Seat 3: cruass (€2.74 in chips) 
Seat 4: chaboargudin (€0.28 in chips) 
Seat 5: odace15 (€4.50 in chips) 
Seat 6: rare12345 (€2.55 in chips) 
Lucian Morel: posts small blind €0.01
cruass: posts big blind €0.02
*** HOLE CARDS ***
Dealt to pipinoelbreve9 [Qs 5c]
chaboargudin: folds 
odace15: folds 
rare12345: folds 
pipinoelbreve9: folds 
Lucian Morel: raises €0.04 to €0.06
cruass: folds 
Uncalled bet (€0.04) returned to Lucian Morel
Lucian Morel collected €0.04 from pot
Lucian Morel: doesn't show hand 
*** SUMMARY ***
Total pot €0.04 | Rake €0 
Seat 1: pipinoelbreve9 (button) folded before Flop (didn't bet)
Seat 2: Lucian Morel (small blind) collected (€0.04)
Seat 3: cruass (big blind) folded before Flop
Seat 4: chaboargudin folded before Flop (didn't bet)
Seat 5: odace15 folded before Flop (didn't bet)
Seat 6: rare12345 folded before Flop (didn't bet)



PokerStars Zoom Hand #257556483002:  Hold'em No Limit (€0.01/€0.02) - 2025/08/31 15:40:43 CET [2025/08/31 9:40:43 ET]
Table 'Arneb' 6-max Seat #1 is the button
Seat 1: ehbraga (€0.97 in chips) 
Seat 2: TIOGUY7 (€0.78 in chips) 
Seat 3: DarkSidious666 (€2.03 in chips) 
Seat 4: pipinoelbreve9 (€2.10 in chips) 
Seat 5: Cruasan17 (€1.96 in chips) 
Seat 6: Lucian Morel (€2.13 in chips) 
TIOGUY7: posts small blind €0.01
DarkSidious666: posts big blind €0.02
*** HOLE CARDS ***
Dealt to pipinoelbreve9 [Ah Tc]
pipinoelbreve9: raises €0.04 to €0.06
Cruasan17: folds 
Lucian Morel: folds 
ehbraga: folds 
TIOGUY7: folds 
DarkSidious666: folds 
Uncalled bet (€0.04) returned to pipinoelbreve9
pipinoelbreve9 collected €0.05 from pot
pipinoelbreve9: doesn't show hand 
*** SUMMARY ***
Total pot €0.05 | Rake €0 
Seat 1: ehbraga (button) folded before Flop (didn't bet)
Seat 2: TIOGUY7 (small blind) folded before Flop
Seat 3: DarkSidious666 (big blind) folded before Flop
Seat 4: pipinoelbreve9 collected (€0.05)
Seat 5: Cruasan17 folded before Flop (didn't bet)
Seat 6: Lucian Morel folded before Flop (didn't bet)



PokerStars Zoom Hand #257556486030:  Hold'em No Limit (€0.01/€0.02) - 2025/08/31 15:41:01 CET [2025/08/31 9:41:01 ET]
Table 'Arneb' 6-max Seat #1 is the button
Seat 1: cruass (€2.72 in chips) 
Seat 2: Sanpetas (€2.50 in chips) 
Seat 3: rare12345 (€2.13 in chips) 
Seat 4: serviettski(fr) (€2.05 in chips) 
Seat 5: POUPIOU65 (€2.02 in chips) 
Seat 6: pipinoelbreve9 (€2.13 in chips) 
Sanpetas: posts small blind €0.01
rare12345: posts big blind €0.02
*** HOLE CARDS ***
Dealt to pipinoelbreve9 [4d 6h]
serviettski(fr): folds 
POUPIOU65: folds 
pipinoelbreve9: folds 
cruass: folds 
Sanpetas: folds 
Uncalled bet (€0.01) returned to rare12345
rare12345 collected €0.02 from pot
rare12345: doesn't show hand 
*** SUMMARY ***
Total pot €0.02 | Rake €0 
Seat 1: cruass (button) folded before Flop (didn't bet)
Seat 2: Sanpetas (small blind) folded before Flop
Seat 3: rare12345 (big blind) collected (€0.02)
Seat 4: serviettski(fr) folded before Flop (didn't bet)
Seat 5: POUPIOU65 folded before Flop (didn't bet)
Seat 6: pipinoelbreve9 folded before Flop (didn't bet)



PokerStars Zoom Hand #257556482393:  Hold'em No Limit (€0.01/€0.02) - 2025/08/31 15:40:40 CET [2025/08/31 9:40:40 ET]
Table 'Arneb' 6-max Seat #1 is the button
Seat 1: GamerVidal (€2.98 in chips) 
Seat 2: DarkSidious666 (€3.53 in chips) 
Seat 3: Tempra_x172 (€2.03 in chips) 
Seat 4: TIOGUY7 (€0.78 in chips) 
Seat 5: pipinoelbreve9 (€2.10 in chips) 
Seat 6: ehbraga (€0.97 in chips) 
DarkSidious666: posts small blind €0.01
Tempra_x172: posts big blind €0.02
*** HOLE CARDS ***
Dealt to pipinoelbreve9 [4h Js]
TIOGUY7: folds 
pipinoelbreve9: folds 
ehbraga: folds 
GamerVidal: folds 
DarkSidious666: raises €0.04 to €0.06
Tempra_x172: calls €0.04
*** FLOP *** [Jc Qd Qc]
DarkSidious666: checks 
Tempra_x172: bets €0.06
DarkSidious666: folds 
Uncalled bet (€0.06) returned to Tempra_x172
Tempra_x172 collected €0.11 from pot
Tempra_x172: doesn't show hand 
*** SUMMARY ***
Total pot €0.12 | Rake €0.01 
Board [Jc Qd Qc]
Seat 1: GamerVidal (button) folded before Flop (didn't bet)
Seat 2: DarkSidious666 (small blind) folded on the Flop
Seat 3: Tempra_x172 (big blind) collected (€0.11)
Seat 4: TIOGUY7 folded before Flop (didn't bet)
Seat 5: pipinoelbreve9 folded before Flop (didn't bet)
Seat 6: ehbraga folded before Flop (didn't bet)



PokerStars Zoom Hand #257557936010:  Hold'em No Limit (€0.01/€0.02) - 2025/08/31 17:50:28 CET [2025/08/31 11:50:28 ET]
Table 'Arneb' 6-max Seat #1 is the button
Seat 1: maximus_powah (€5.04 in chips) 
Seat 2: 1Drazi (€2.17 in chips) 
Seat 3: pipinoelbreve9 (€2 in chips) 
Seat 4: AnxoGM (€2.68 in chips) 
Seat 5: combinius1 (€3.16 in chips) 
Seat 6: 76jusab76 (€1.64 in chips) 
1Drazi: posts small blind €0.01
pipinoelbreve9: posts big blind €0.02
*** HOLE CARDS ***
Dealt to pipinoelbreve9 [3d 7c]
AnxoGM: raises €0.03 to €0.05
combinius1: folds 
76jusab76: raises €0.03 to €0.08
maximus_powah: folds 
1Drazi: folds 
pipinoelbreve9: folds 
AnxoGM: calls €0.03
*** FLOP *** [3s 8d 4h]
AnxoGM: checks 
76jusab76: bets €0.06
AnxoGM: folds 
Uncalled bet (€0.06) returned to 76jusab76
76jusab76 collected €0.18 from pot
76jusab76: doesn't show hand 
*** SUMMARY ***
Total pot €0.19 | Rake €0.01 
Board [3s 8d 4h]
Seat 1: maximus_powah (button) folded before Flop (didn't bet)
Seat 2: 1Drazi (small blind) folded before Flop
Seat 3: pipinoelbreve9 (big blind) folded before Flop
Seat 4: AnxoGM folded on the Flop
Seat 5: combinius1 folded before Flop (didn't bet)
Seat 6: 76jusab76 collected (€0.18)



PokerStars Zoom Hand #257557939673:  Hold'em No Limit (€0.01/€0.02) - 2025/08/31 17:50:44 CET [2025/08/31 11:50:44 ET]
Table 'Arneb' 6-max Seat #1 is the button
Seat 1: NEMOXYX (€3.96 in chips) 
Seat 2: pipinoelbreve9 (€2 in chips) 
Seat 3: 1Drazi (€3.74 in chips) 
Seat 4: BestiaESP12 (€2.79 in chips) 
Seat 5: maximus_powah (€5.03 in chips) 
Seat 6: RamsDios (€3.68 in chips) 
pipinoelbreve9: posts small blind €0.01
1Drazi: posts big blind €0.02
*** HOLE CARDS ***
Dealt to pipinoelbreve9 [Js 5s]
BestiaESP12: folds 
maximus_powah: folds 
RamsDios: folds 
NEMOXYX: folds 
pipinoelbreve9: raises €0.04 to €0.06
1Drazi: folds 
Uncalled bet (€0.04) returned to pipinoelbreve9
pipinoelbreve9 collected €0.04 from pot
pipinoelbreve9: doesn't show hand 
*** SUMMARY ***
Total pot €0.04 | Rake €0 
Seat 1: NEMOXYX (button) folded before Flop (didn't bet)
Seat 2: pipinoelbreve9 (small blind) collected (€0.04)
Seat 3: 1Drazi (big blind) folded before Flop
Seat 4: BestiaESP12 folded before Flop (didn't bet)
Seat 5: maximus_powah folded before Flop (didn't bet)
Seat 6: RamsDios folded before Flop (didn't bet)



PokerStars Zoom Hand #257557947613:  Hold'em No Limit (€0.01/€0.02) - 2025/08/31 17:51:20 CET [2025/08/31 11:51:20 ET]
Table 'Arneb' 6-max Seat #1 is the button
Seat 1: lorocontento (€1.23 in chips) 
Seat 2: K4K1 (€1.14 in chips) 
Seat 3: PerParFr (€2 in chips) 
Seat 4: gin_213 (€2.57 in chips) 
Seat 5: rare12345 (€2 in chips) 
Seat 6: pipinoelbreve9 (€2.02 in chips) 
K4K1: posts small blind €0.01
PerParFr: posts big blind €0.02
*** HOLE CARDS ***
Dealt to pipinoelbreve9 [Kc 5d]
gin_213: folds 
rare12345: raises €0.03 to €0.05
pipinoelbreve9: folds 
lorocontento: folds 
K4K1: folds 
PerParFr: folds 
Uncalled bet (€0.03) returned to rare12345
rare12345 collected €0.05 from pot
rare12345: doesn't show hand 
*** SUMMARY ***
Total pot €0.05 | Rake €0 
Seat 1: lorocontento (button) folded before Flop (didn't bet)
Seat 2: K4K1 (small blind) folded before Flop
Seat 3: PerParFr (big blind) folded before Flop
Seat 4: gin_213 folded before Flop (didn't bet)
Seat 5: rare12345 collected (€0.05)
Seat 6: pipinoelbreve9 folded before Flop (didn't bet)



PokerStars Zoom Hand #257557946056:  Hold'em No Limit (€0.01/€0.02) - 2025/08/31 17:51:13 CET [2025/08/31 11:51:13 ET]
Table 'Arneb' 6-max Seat #1 is the button
Seat 1: HGrenha (€3.62 in chips) 
Seat 2: datkeire01 (€9.61 in chips) 
Seat 3: RamsDios (€3.71 in chips) 
Seat 4: vayewis (€2.66 in chips) 
Seat 5: pipinoelbreve9 (€2.02 in chips) 
Seat 6: lorocontento (€1.04 in chips) 
datkeire01: posts small blind €0.01
RamsDios: posts big blind €0.02
*** HOLE CARDS ***
Dealt to pipinoelbreve9 [Tc Jd]
vayewis: raises €0.03 to €0.05
pipinoelbreve9: folds 
lorocontento: folds 
HGrenha: folds 
datkeire01: calls €0.04
RamsDios: calls €0.03
*** FLOP *** [9c 3s 5c]
datkeire01: checks 
RamsDios: checks 
vayewis: bets €0.04
datkeire01: folds 
RamsDios: folds 
Uncalled bet (€0.04) returned to vayewis
vayewis collected €0.14 from pot
vayewis: doesn't show hand 
*** SUMMARY ***
Total pot €0.15 | Rake €0.01 
Board [9c 3s 5c]
Seat 1: HGrenha (button) folded before Flop (didn't bet)
Seat 2: datkeire01 (small blind) folded on the Flop
Seat 3: RamsDios (big blind) folded on the Flop
Seat 4: vayewis collected (€0.14)
Seat 5: pipinoelbreve9 folded before Flop (didn't bet)
Seat 6: lorocontento folded before Flop (didn't bet)



PokerStars Zoom Hand #257557944374:  Hold'em No Limit (€0.01/€0.02) - 2025/08/31 17:51:05 CET [2025/08/31 11:51:05 ET]
Table 'Arneb' 6-max Seat #1 is the button
Seat 1: pipinoelbreve9 (€2.02 in chips) 
Seat 2: rare12345 (€2 in chips) 
Seat 3: NotClaudio1 (€2.37 in chips) 
Seat 4: abmarc99 (€2.38 in chips) 
Seat 5: RaphaelBP07 (€1.80 in chips) 
Seat 6: orosa (€2.08 in chips) 
rare12345: posts small blind €0.01
NotClaudio1: posts big blind €0.02
*** HOLE CARDS ***
Dealt to pipinoelbreve9 [5h Jd]
abmarc99: folds 
RaphaelBP07: calls €0.02
orosa: folds 
pipinoelbreve9: folds 
rare12345: calls €0.01
NotClaudio1: checks 
*** FLOP *** [4s 6c 8c]
rare12345: checks 
NotClaudio1: bets €0.03
RaphaelBP07: calls €0.03
rare12345: folds 
*** TURN *** [4s 6c 8c] [6s]
NotClaudio1: checks 
RaphaelBP07: bets €0.02
NotClaudio1: folds 
Uncalled bet (€0.02) returned to RaphaelBP07
RaphaelBP07 collected €0.11 from pot
RaphaelBP07: doesn't show hand 
*** SUMMARY ***
Total pot €0.12 | Rake €0.01 
Board [4s 6c 8c 6s]
Seat 1: pipinoelbreve9 (button) folded before Flop (didn't bet)
Seat 2: rare12345 (small blind) folded on the Flop
Seat 3: NotClaudio1 (big blind) folded on the Turn
Seat 4: abmarc99 folded before Flop (didn't bet)
Seat 5: RaphaelBP07 collected (€0.11)
Seat 6: orosa folded before Flop (didn't bet)



PokerStars Zoom Hand #257557950603:  Hold'em No Limit (€0.01/€0.02) - 2025/08/31 17:51:33 CET [2025/08/31 11:51:33 ET]
Table 'Arneb' 6-max Seat #1 is the button
Seat 1: pipinoelbreve9 (€2.02 in chips) 
Seat 2: ehbraga (€0.58 in chips) 
Seat 3: 34pluto (€1.60 in chips) 
Seat 4: lorocontento (€1.22 in chips) 
Seat 5: combinius1 (€3.21 in chips) 
Seat 6: vayewis (€2.25 in chips) 
ehbraga: posts small blind €0.01
34pluto: posts big blind €0.02
*** HOLE CARDS ***
Dealt to pipinoelbreve9 [9s Qs]
lorocontento: folds 
combinius1: folds 
vayewis: folds 
pipinoelbreve9: raises €0.04 to €0.06
ehbraga: folds 
34pluto: calls €0.04
*** FLOP *** [8s 5c Qc]
34pluto: checks 
pipinoelbreve9: bets €0.06
34pluto: folds 
Uncalled bet (€0.06) returned to pipinoelbreve9
pipinoelbreve9 collected €0.12 from pot
pipinoelbreve9: doesn't show hand 
*** SUMMARY ***
Total pot €0.13 | Rake €0.01 
Board [8s 5c Qc]
Seat 1: pipinoelbreve9 (button) collected (€0.12)
Seat 2: ehbraga (small blind) folded before Flop
Seat 3: 34pluto (big blind) folded on the Flop
Seat 4: lorocontento folded before Flop (didn't bet)
Seat 5: combinius1 folded before Flop (didn't bet)
Seat 6: vayewis folded before Flop (didn't bet)



PokerStars Zoom Hand #257557963464:  Hold'em No Limit (€0.01/€0.02) - 2025/08/31 17:52:31 CET [2025/08/31 11:52:31 ET]
Table 'Arneb' 6-max Seat #1 is the button
Seat 1: monsieur881 (€1.90 in chips) 
Seat 2: pipinoelbreve9 (€2.06 in chips) 
Seat 3: maximus_powah (€5 in chips) 
Seat 4: lorocontento (€1 in chips) 
Seat 5: AnxoGM (€2.11 in chips) 
Seat 6: 1Drazi (€2.14 in chips) 
pipinoelbreve9: posts small blind €0.01
maximus_powah: posts big blind €0.02
*** HOLE CARDS ***
Dealt to pipinoelbreve9 [6d Jc]
lorocontento: folds 
AnxoGM: folds 
1Drazi: folds 
monsieur881: folds 
pipinoelbreve9: folds 
Uncalled bet (€0.01) returned to maximus_powah
maximus_powah collected €0.02 from pot
maximus_powah: doesn't show hand 
*** SUMMARY ***
Total pot €0.02 | Rake €0 
Seat 1: monsieur881 (button) folded before Flop (didn't bet)
Seat 2: pipinoelbreve9 (small blind) folded before Flop
Seat 3: maximus_powah (big blind) collected (€0.02)
Seat 4: lorocontento folded before Flop (didn't bet)
Seat 5: AnxoGM folded before Flop (didn't bet)
Seat 6: 1Drazi folded before Flop (didn't bet)



PokerStars Zoom Hand #257557960798:  Hold'em No Limit (€0.01/€0.02) - 2025/08/31 17:52:19 CET [2025/08/31 11:52:19 ET]
Table 'Arneb' 6-max Seat #1 is the button
Seat 1: ZoasHein (€2.68 in chips) 
Seat 2: NotClaudio1 (€2.17 in chips) 
Seat 3: pipinoelbreve9 (€2.08 in chips) 
Seat 4: 77samuel33 (€2.99 in chips) 
Seat 5: rare12345 (€2 in chips) 
Seat 6: biodj666 (€2.93 in chips) 
NotClaudio1: posts small blind €0.01
pipinoelbreve9: posts big blind €0.02
*** HOLE CARDS ***
Dealt to pipinoelbreve9 [7c 2h]
77samuel33: folds 
rare12345: folds 
biodj666: raises €0.03 to €0.05
ZoasHein: folds 
NotClaudio1: calls €0.04
pipinoelbreve9: folds 
*** FLOP *** [Ks 9d Js]
NotClaudio1: bets €0.06
biodj666: calls €0.06
*** TURN *** [Ks 9d Js] [3s]
NotClaudio1: bets €0.08
biodj666: folds 
Uncalled bet (€0.08) returned to NotClaudio1
NotClaudio1 collected €0.23 from pot
NotClaudio1: doesn't show hand 
*** SUMMARY ***
Total pot €0.24 | Rake €0.01 
Board [Ks 9d Js 3s]
Seat 1: ZoasHein (button) folded before Flop (didn't bet)
Seat 2: NotClaudio1 (small blind) collected (€0.23)
Seat 3: pipinoelbreve9 (big blind) folded before Flop
Seat 4: 77samuel33 folded before Flop (didn't bet)
Seat 5: rare12345 folded before Flop (didn't bet)
Seat 6: biodj666 folded on the Turn



PokerStars Zoom Hand #257557965931:  Hold'em No Limit (€0.01/€0.02) - 2025/08/31 17:52:42 CET [2025/08/31 11:52:42 ET]
Table 'Arneb' 6-max Seat #1 is the button
Seat 1: masquisiera (€1 in chips) 
Seat 2: NEMOXYX (€2.14 in chips) 
Seat 3: davidelgnomo747 (€1 in chips) 
Seat 4: DeividBox980 (€0.74 in chips) 
Seat 5: pipinoelbreve9 (€2.05 in chips) 
Seat 6: jcm83640 (€0.32 in chips) 
NEMOXYX: posts small blind €0.01
davidelgnomo747: posts big blind €0.02
*** HOLE CARDS ***
Dealt to pipinoelbreve9 [Jh Ah]
DeividBox980: folds 
pipinoelbreve9: raises €0.04 to €0.06
jcm83640 has timed out
jcm83640: folds 
masquisiera: folds 
NEMOXYX: folds 
davidelgnomo747: calls €0.04
*** FLOP *** [7h 3c 5c]
davidelgnomo747: checks 
pipinoelbreve9: checks 
*** TURN *** [7h 3c 5c] [Kh]
davidelgnomo747: bets €0.08
pipinoelbreve9: calls €0.08
*** RIVER *** [7h 3c 5c Kh] [2h]
davidelgnomo747: bets €0.18
pipinoelbreve9: raises €0.18 to €0.36
davidelgnomo747: folds 
Uncalled bet (€0.18) returned to pipinoelbreve9
pipinoelbreve9 collected €0.62 from pot
pipinoelbreve9: doesn't show hand 
*** SUMMARY ***
Total pot €0.65 | Rake €0.03 
Board [7h 3c 5c Kh 2h]
Seat 1: masquisiera (button) folded before Flop (didn't bet)
Seat 2: NEMOXYX (small blind) folded before Flop
Seat 3: davidelgnomo747 (big blind) folded on the River
Seat 4: DeividBox980 folded before Flop (didn't bet)
Seat 5: pipinoelbreve9 collected (€0.62)
Seat 6: jcm83640 folded before Flop (didn't bet)



PokerStars Zoom Hand #257557978394:  Hold'em No Limit (€0.01/€0.02) - 2025/08/31 17:53:40 CET [2025/08/31 11:53:40 ET]
Table 'Arneb' 6-max Seat #1 is the button
Seat 1: rare12345 (€3.04 in chips) 
Seat 2: vayewis (€2.74 in chips) 
Seat 3: 1Drazi (€2.14 in chips) 
Seat 4: marcooliveira99 (€0.86 in chips) 
Seat 5: marcosbalsaa (€4.59 in chips) 
Seat 6: pipinoelbreve9 (€2.35 in chips) 
vayewis: posts small blind €0.01
1Drazi: posts big blind €0.02
*** HOLE CARDS ***
Dealt to pipinoelbreve9 [Qc Kh]
marcooliveira99: folds 
marcosbalsaa: folds 
pipinoelbreve9: raises €0.04 to €0.06
rare12345: folds 
vayewis: folds 
1Drazi: folds 
Uncalled bet (€0.04) returned to pipinoelbreve9
pipinoelbreve9 collected €0.05 from pot
pipinoelbreve9: doesn't show hand 
*** SUMMARY ***
Total pot €0.05 | Rake €0 
Seat 1: rare12345 (button) folded before Flop (didn't bet)
Seat 2: vayewis (small blind) folded before Flop
Seat 3: 1Drazi (big blind) folded before Flop
Seat 4: marcooliveira99 folded before Flop (didn't bet)
Seat 5: marcosbalsaa folded before Flop (didn't bet)
Seat 6: pipinoelbreve9 collected (€0.05)



PokerStars Zoom Hand #257557977159:  Hold'em No Limit (€0.01/€0.02) - 2025/08/31 17:53:34 CET [2025/08/31 11:53:34 ET]
Table 'Arneb' 6-max Seat #1 is the button
Seat 1: 77samuel33 (€2.99 in chips) 
Seat 2: gregoss054 (€3.60 in chips) 
Seat 3: poteaarte (€3 in chips) 
Seat 4: pipinoelbreve9 (€2.35 in chips) 
Seat 5: juanlu2000china (€1.66 in chips) 
Seat 6: BestiaESP12 (€2.74 in chips) 
gregoss054: posts small blind €0.01
poteaarte: posts big blind €0.02
*** HOLE CARDS ***
Dealt to pipinoelbreve9 [8d Kh]
pipinoelbreve9: folds 
juanlu2000china: raises €0.02 to €0.04
BestiaESP12: folds 
77samuel33: calls €0.04
gregoss054: folds 
poteaarte: folds 
*** FLOP *** [8h 9h 3d]
juanlu2000china: checks 
77samuel33: checks 
*** TURN *** [8h 9h 3d] [Js]
juanlu2000china: checks 
77samuel33: bets €0.08
juanlu2000china: folds 
Uncalled bet (€0.08) returned to 77samuel33
77samuel33 collected €0.10 from pot
77samuel33: doesn't show hand 
*** SUMMARY ***
Total pot €0.11 | Rake €0.01 
Board [8h 9h 3d Js]
Seat 1: 77samuel33 (button) collected (€0.10)
Seat 2: gregoss054 (small blind) folded before Flop
Seat 3: poteaarte (big blind) folded before Flop
Seat 4: pipinoelbreve9 folded before Flop (didn't bet)
Seat 5: juanlu2000china folded on the Turn
Seat 6: BestiaESP12 folded before Flop (didn't bet)



PokerStars Zoom Hand #257557983432:  Hold'em No Limit (€0.01/€0.02) - 2025/08/31 17:54:02 CET [2025/08/31 11:54:02 ET]
Table 'Arneb' 6-max Seat #1 is the button
Seat 1: monsieur881 (€1.92 in chips) 
Seat 2: KillVerlaine (€0.93 in chips) 
Seat 3: pipinoelbreve9 (€2.38 in chips) 
Seat 4: davidelgnomo747 (€0.77 in chips) 
Seat 5: marcooliveira99 (€0.84 in chips) 
Seat 6: koka1151 (€2.28 in chips) 
KillVerlaine: posts small blind €0.01
pipinoelbreve9: posts big blind €0.02
*** HOLE CARDS ***
Dealt to pipinoelbreve9 [3h 9c]
davidelgnomo747: folds 
marcooliveira99: folds 
koka1151: raises €0.06 to €0.08
monsieur881: folds 
KillVerlaine: folds 
pipinoelbreve9: folds 
Uncalled bet (€0.06) returned to koka1151
koka1151 collected €0.05 from pot
koka1151: doesn't show hand 
*** SUMMARY ***
Total pot €0.05 | Rake €0 
Seat 1: monsieur881 (button) folded before Flop (didn't bet)
Seat 2: KillVerlaine (small blind) folded before Flop
Seat 3: pipinoelbreve9 (big blind) folded before Flop
Seat 4: davidelgnomo747 folded before Flop (didn't bet)
Seat 5: marcooliveira99 folded before Flop (didn't bet)
Seat 6: koka1151 collected (€0.05)



PokerStars Zoom Hand #257557982395:  Hold'em No Limit (€0.01/€0.02) - 2025/08/31 17:53:57 CET [2025/08/31 11:53:57 ET]
Table 'Arneb' 6-max Seat #1 is the button
Seat 1: DeividBox980 (€0.69 in chips) 
Seat 2: monsieur881 (€1.93 in chips) 
Seat 3: 34pluto (€1.08 in chips) 
Seat 4: pablosua (€0.81 in chips) 
Seat 5: pipinoelbreve9 (€2.38 in chips) 
Seat 6: marcooliveira99 (€0.84 in chips) 
monsieur881: posts small blind €0.01
34pluto: posts big blind €0.02
*** HOLE CARDS ***
Dealt to pipinoelbreve9 [9c 3d]
pablosua: folds 
pipinoelbreve9: folds 
marcooliveira99: folds 
DeividBox980: folds 
monsieur881: folds 
Uncalled bet (€0.01) returned to 34pluto
34pluto collected €0.02 from pot
34pluto: doesn't show hand 
*** SUMMARY ***
Total pot €0.02 | Rake €0 
Seat 1: DeividBox980 (button) folded before Flop (didn't bet)
Seat 2: monsieur881 (small blind) folded before Flop
Seat 3: 34pluto (big blind) collected (€0.02)
Seat 4: pablosua folded before Flop (didn't bet)
Seat 5: pipinoelbreve9 folded before Flop (didn't bet)
Seat 6: marcooliveira99 folded before Flop (didn't bet)



PokerStars Zoom Hand #257557987129:  Hold'em No Limit (€0.01/€0.02) - 2025/08/31 17:54:19 CET [2025/08/31 11:54:19 ET]
Table 'Arneb' 6-max Seat #1 is the button
Seat 1: pipinoelbreve9 (€2.35 in chips) 
Seat 2: 34pluto (€1.75 in chips) 
Seat 3: 1Drazi (€2.11 in chips) 
Seat 4: monsieur881 (€1.92 in chips) 
Seat 5: gregoss054 (€4.68 in chips) 
Seat 6: rare12345 (€2.09 in chips) 
34pluto: posts small blind €0.01
1Drazi: posts big blind €0.02
*** HOLE CARDS ***
Dealt to pipinoelbreve9 [Qc 6c]
monsieur881: folds 
gregoss054: folds 
rare12345: folds 
pipinoelbreve9: raises €0.04 to €0.06
34pluto: folds 
1Drazi: folds 
Uncalled bet (€0.04) returned to pipinoelbreve9
pipinoelbreve9 collected €0.05 from pot
pipinoelbreve9: doesn't show hand 
*** SUMMARY ***
Total pot €0.05 | Rake €0 
Seat 1: pipinoelbreve9 (button) collected (€0.05)
Seat 2: 34pluto (small blind) folded before Flop
Seat 3: 1Drazi (big blind) folded before Flop
Seat 4: monsieur881 folded before Flop (didn't bet)
Seat 5: gregoss054 folded before Flop (didn't bet)
Seat 6: rare12345 folded before Flop (didn't bet)



PokerStars Zoom Hand #257557992426:  Hold'em No Limit (€0.01/€0.02) - 2025/08/31 17:54:43 CET [2025/08/31 11:54:43 ET]
Table 'Arneb' 6-max Seat #1 is the button
Seat 1: thenry03 (€1.86 in chips) 
Seat 2: iam_xCidx (€3.03 in chips) 
Seat 3: NEMOXYX (€2.24 in chips) 
Seat 4: combinius1 (€2.46 in chips) 
Seat 5: gregoss054 (€2.03 in chips) 
Seat 6: pipinoelbreve9 (€2.38 in chips) 
iam_xCidx: posts small blind €0.01
NEMOXYX: posts big blind €0.02
*** HOLE CARDS ***
Dealt to pipinoelbreve9 [2c 6d]
combinius1: raises €0.03 to €0.05
gregoss054: calls €0.05
pipinoelbreve9: folds 
thenry03: raises €0.13 to €0.18
iam_xCidx: folds 
NEMOXYX: folds 
combinius1: folds 
gregoss054: folds 
Uncalled bet (€0.13) returned to thenry03
thenry03 collected €0.18 from pot
thenry03: doesn't show hand 
*** SUMMARY ***
Total pot €0.18 | Rake €0 
Seat 1: thenry03 (button) collected (€0.18)
Seat 2: iam_xCidx (small blind) folded before Flop
Seat 3: NEMOXYX (big blind) folded before Flop
Seat 4: combinius1 folded before Flop
Seat 5: gregoss054 folded before Flop
Seat 6: pipinoelbreve9 folded before Flop (didn't bet)



PokerStars Zoom Hand #257557995203:  Hold'em No Limit (€0.01/€0.02) - 2025/08/31 17:54:56 CET [2025/08/31 11:54:56 ET]
Table 'Arneb' 6-max Seat #1 is the button
Seat 1: NEMOXYX (€2.22 in chips) 
Seat 2: marcosbalsaa (€4.48 in chips) 
Seat 3: pipinoelbreve9 (€2.38 in chips) 
Seat 4: 77samuel33 (€13.02 in chips) 
Seat 5: datkeire01 (€9.44 in chips) 
Seat 6: PerParFr (€2.34 in chips) 
marcosbalsaa: posts small blind €0.01
pipinoelbreve9: posts big blind €0.02
*** HOLE CARDS ***
Dealt to pipinoelbreve9 [8c 2h]
77samuel33 has timed out
77samuel33: folds 
datkeire01: raises €0.02 to €0.04
PerParFr: folds 
NEMOXYX: folds 
marcosbalsaa: folds 
pipinoelbreve9: folds 
Uncalled bet (€0.02) returned to datkeire01
datkeire01 collected €0.05 from pot
datkeire01: doesn't show hand 
*** SUMMARY ***
Total pot €0.05 | Rake €0 
Seat 1: NEMOXYX (button) folded before Flop (didn't bet)
Seat 2: marcosbalsaa (small blind) folded before Flop
Seat 3: pipinoelbreve9 (big blind) folded before Flop
Seat 4: 77samuel33 folded before Flop (didn't bet)
Seat 5: datkeire01 collected (€0.05)
Seat 6: PerParFr folded before Flop (didn't bet)



PokerStars Zoom Hand #257557985985:  Hold'em No Limit (€0.01/€0.02) - 2025/08/31 17:54:14 CET [2025/08/31 11:54:14 ET]
Table 'Arneb' 6-max Seat #1 is the button
Seat 1: koka1151 (€2.31 in chips) 
Seat 2: pipinoelbreve9 (€2.36 in chips) 
Seat 3: ZoasHein (€2.35 in chips) 
Seat 4: serviettski(fr) (€2.26 in chips) 
Seat 5: teno77 (€1.04 in chips) 
Seat 6: K4K1 (€1.21 in chips) 
pipinoelbreve9: posts small blind €0.01
ZoasHein: posts big blind €0.02
*** HOLE CARDS ***
Dealt to pipinoelbreve9 [Qh 5c]
serviettski(fr): folds 
teno77: folds 
K4K1: calls €0.02
ZoasHein is disconnected 
koka1151: raises €0.06 to €0.08
pipinoelbreve9: folds 
ZoasHein has timed out while disconnected
ZoasHein: folds 
K4K1: calls €0.06
*** FLOP *** [Ad 2s 9d]
K4K1: checks 
koka1151: bets €0.14
K4K1: folds 
Uncalled bet (€0.14) returned to koka1151
koka1151 collected €0.18 from pot
koka1151: doesn't show hand 
*** SUMMARY ***
Total pot €0.19 | Rake €0.01 
Board [Ad 2s 9d]
Seat 1: koka1151 (button) collected (€0.18)
Seat 2: pipinoelbreve9 (small blind) folded before Flop
Seat 3: ZoasHein (big blind) folded before Flop
Seat 4: serviettski(fr) folded before Flop (didn't bet)
Seat 5: teno77 folded before Flop (didn't bet)
Seat 6: K4K1 folded on the Flop



PokerStars Zoom Hand #257557993779:  Hold'em No Limit (€0.01/€0.02) - 2025/08/31 17:54:49 CET [2025/08/31 11:54:49 ET]
Table 'Arneb' 6-max Seat #1 is the button
Seat 1: iam_xCidx (€3.02 in chips) 
Seat 2: marcosbalsaa (€3.24 in chips) 
Seat 3: morganlee66 (€3.08 in chips) 
Seat 4: maximus_powah (€2.48 in chips) 
Seat 5: pipinoelbreve9 (€2.38 in chips) 
Seat 6: koka1151 (€2.24 in chips) 
marcosbalsaa: posts small blind €0.01
morganlee66: posts big blind €0.02
*** HOLE CARDS ***
Dealt to pipinoelbreve9 [2d Jh]
maximus_powah: folds 
pipinoelbreve9: folds 
koka1151: folds 
iam_xCidx: raises €0.03 to €0.05
marcosbalsaa: folds 
morganlee66: calls €0.03
*** FLOP *** [6c 4d Jd]
morganlee66: checks 
iam_xCidx: checks 
*** TURN *** [6c 4d Jd] [3c]
morganlee66: bets €0.03
iam_xCidx: calls €0.03
*** RIVER *** [6c 4d Jd 3c] [Qd]
morganlee66: bets €0.05
iam_xCidx: folds 
Uncalled bet (€0.05) returned to morganlee66
morganlee66 collected €0.16 from pot
morganlee66: doesn't show hand 
*** SUMMARY ***
Total pot €0.17 | Rake €0.01 
Board [6c 4d Jd 3c Qd]
Seat 1: iam_xCidx (button) folded on the River
Seat 2: marcosbalsaa (small blind) folded before Flop
Seat 3: morganlee66 (big blind) collected (€0.16)
Seat 4: maximus_powah folded before Flop (didn't bet)
Seat 5: pipinoelbreve9 folded before Flop (didn't bet)
Seat 6: koka1151 folded before Flop (didn't bet)



PokerStars Zoom Hand #257557998210:  Hold'em No Limit (€0.01/€0.02) - 2025/08/31 17:55:11 CET [2025/08/31 11:55:11 ET]
Table 'Arneb' 6-max Seat #1 is the button
Seat 1: pipinoelbreve9 (€2.36 in chips) 
Seat 2: masquisiera (€1.12 in chips) 
Seat 3: davidelgnomo747 (€0.82 in chips) 
Seat 4: thenry03 (€1.98 in chips) 
Seat 5: boefbram (€1.30 in chips) 
Seat 6: serviettski(fr) (€2.29 in chips) 
masquisiera: posts small blind €0.01
davidelgnomo747: posts big blind €0.02
*** HOLE CARDS ***
Dealt to pipinoelbreve9 [Jc Qh]
thenry03: folds 
boefbram: folds 
serviettski(fr): raises €0.04 to €0.06
pipinoelbreve9: raises €0.12 to €0.18
masquisiera: folds 
davidelgnomo747: folds 
serviettski(fr): raises €0.30 to €0.48
pipinoelbreve9: calls €0.30
*** FLOP *** [7s 4d 2c]
serviettski(fr): bets €1.81 and is all-in
pipinoelbreve9: folds 
Uncalled bet (€1.81) returned to serviettski(fr)
serviettski(fr) collected €0.94 from pot
serviettski(fr): doesn't show hand 
*** SUMMARY ***
Total pot €0.99 | Rake €0.05 
Board [7s 4d 2c]
Seat 1: pipinoelbreve9 (button) folded on the Flop
Seat 2: masquisiera (small blind) folded before Flop
Seat 3: davidelgnomo747 (big blind) folded before Flop
Seat 4: thenry03 folded before Flop (didn't bet)
Seat 5: boefbram folded before Flop (didn't bet)
Seat 6: serviettski(fr) collected (€0.94)



PokerStars Zoom Hand #257558004046:  Hold'em No Limit (€0.01/€0.02) - 2025/08/31 17:55:55 CET [2025/08/31 11:55:55 ET]
Table 'Arneb' 6-max Seat #1 is the button
Seat 1: Gginer2812 (€1.85 in chips) 
Seat 2: 34pluto (€0.96 in chips) 
Seat 3: orosa (€2.54 in chips) 
Seat 4: pipinoelbreve9 (€2 in chips) 
Seat 5: morganlee66 (€3.15 in chips) 
Seat 6: PrendsCa (€2 in chips) 
34pluto: posts small blind €0.01
orosa: posts big blind €0.02
*** HOLE CARDS ***
Dealt to pipinoelbreve9 [3s 5h]
pipinoelbreve9: folds 
morganlee66: folds 
PrendsCa: raises €0.04 to €0.06
Gginer2812: folds 
34pluto: folds 
orosa: folds 
Uncalled bet (€0.04) returned to PrendsCa
PrendsCa collected €0.05 from pot
PrendsCa: doesn't show hand 
*** SUMMARY ***
Total pot €0.05 | Rake €0 
Seat 1: Gginer2812 (button) folded before Flop (didn't bet)
Seat 2: 34pluto (small blind) folded before Flop
Seat 3: orosa (big blind) folded before Flop
Seat 4: pipinoelbreve9 folded before Flop (didn't bet)
Seat 5: morganlee66 folded before Flop (didn't bet)
Seat 6: PrendsCa collected (€0.05)



PokerStars Zoom Hand #257558004965:  Hold'em No Limit (€0.01/€0.02) - 2025/08/31 17:56:02 CET [2025/08/31 11:56:02 ET]
Table 'Arneb' 6-max Seat #1 is the button
Seat 1: ldzepp (€1.94 in chips) 
Seat 2: pipinoelbreve9 (€2 in chips) 
Seat 3: 1Drazi (€3.28 in chips) 
Seat 4: orosa (€2.46 in chips) 
Seat 5: Chendoteam (€2.84 in chips) 
Seat 6: vayewis (€3.03 in chips) 
pipinoelbreve9: posts small blind €0.01
1Drazi: posts big blind €0.02
*** HOLE CARDS ***
Dealt to pipinoelbreve9 [9s Th]
orosa: folds 
Chendoteam: calls €0.02
vayewis: folds 
ldzepp: folds 
pipinoelbreve9: calls €0.01
1Drazi: raises €0.05 to €0.07
Chendoteam: calls €0.05
pipinoelbreve9: calls €0.05
*** FLOP *** [4c 2d 3d]
pipinoelbreve9: checks 
1Drazi: bets €0.07
Chendoteam: folds 
pipinoelbreve9: folds 
Uncalled bet (€0.07) returned to 1Drazi
1Drazi collected €0.20 from pot
1Drazi: doesn't show hand 
*** SUMMARY ***
Total pot €0.21 | Rake €0.01 
Board [4c 2d 3d]
Seat 1: ldzepp (button) folded before Flop (didn't bet)
Seat 2: pipinoelbreve9 (small blind) folded on the Flop
Seat 3: 1Drazi (big blind) collected (€0.20)
Seat 4: orosa folded before Flop (didn't bet)
Seat 5: Chendoteam folded on the Flop
Seat 6: vayewis folded before Flop (didn't bet)



PokerStars Zoom Hand #257558008704:  Hold'em No Limit (€0.01/€0.02) - 2025/08/31 17:56:30 CET [2025/08/31 11:56:30 ET]
Table 'Arneb' 6-max Seat #1 is the button
Seat 1: orosa (€2.54 in chips) 
Seat 2: 1Drazi (€3.41 in chips) 
Seat 3: RaphaelBP07 (€2.11 in chips) 
Seat 4: pipinoelbreve9 (€2 in chips) 
Seat 5: 77samuel33 (€2.62 in chips) 
Seat 6: llocant (€1.81 in chips) 
1Drazi: posts small blind €0.01
RaphaelBP07: posts big blind €0.02
*** HOLE CARDS ***
Dealt to pipinoelbreve9 [4c 3d]
pipinoelbreve9: folds 
77samuel33: folds 
llocant: folds 
orosa: folds 
1Drazi: folds 
Uncalled bet (€0.01) returned to RaphaelBP07
RaphaelBP07 collected €0.02 from pot
RaphaelBP07: doesn't show hand 
*** SUMMARY ***
Total pot €0.02 | Rake €0 
Seat 1: orosa (button) folded before Flop (didn't bet)
Seat 2: 1Drazi (small blind) folded before Flop
Seat 3: RaphaelBP07 (big blind) collected (€0.02)
Seat 4: pipinoelbreve9 folded before Flop (didn't bet)
Seat 5: 77samuel33 folded before Flop (didn't bet)
Seat 6: llocant folded before Flop (didn't bet)



PokerStars Zoom Hand #257558009482:  Hold'em No Limit (€0.01/€0.02) - 2025/08/31 17:56:35 CET [2025/08/31 11:56:35 ET]
Table 'Arneb' 6-max Seat #1 is the button
Seat 1: marcooliveira99 (€0.72 in chips) 
Seat 2: 34pluto (€1.95 in chips) 
Seat 3: vayewis (€2.71 in chips) 
Seat 4: maximus_powah (€2.50 in chips) 
Seat 5: KillVerlaine (€1.71 in chips) 
Seat 6: pipinoelbreve9 (€2 in chips) 
34pluto: posts small blind €0.01
vayewis: posts big blind €0.02
*** HOLE CARDS ***
Dealt to pipinoelbreve9 [7h Ts]
maximus_powah: folds 
KillVerlaine: folds 
pipinoelbreve9: folds 
marcooliveira99: calls €0.02
34pluto: calls €0.01
vayewis: checks 
*** FLOP *** [6h 4h 5d]
34pluto: checks 
vayewis: checks 
marcooliveira99: checks 
*** TURN *** [6h 4h 5d] [6c]
34pluto: checks 
vayewis: bets €0.02
marcooliveira99: calls €0.02
34pluto: folds 
*** RIVER *** [6h 4h 5d 6c] [Td]
vayewis: bets €0.02
marcooliveira99: calls €0.02
*** SHOW DOWN ***
vayewis: shows [Ad 6s] (three of a kind, Sixes)
marcooliveira99: mucks hand 
vayewis collected €0.13 from pot
*** SUMMARY ***
Total pot €0.14 | Rake €0.01 
Board [6h 4h 5d 6c Td]
Seat 1: marcooliveira99 (button) mucked [7c 7s]
Seat 2: 34pluto (small blind) folded on the Turn
Seat 3: vayewis (big blind) showed [Ad 6s] and won (€0.13) with three of a kind, Sixes
Seat 4: maximus_powah folded before Flop (didn't bet)
Seat 5: KillVerlaine folded before Flop (didn't bet)
Seat 6: pipinoelbreve9 folded before Flop (didn't bet)



PokerStars Zoom Hand #257558010102:  Hold'em No Limit (€0.01/€0.02) - 2025/08/31 17:56:40 CET [2025/08/31 11:56:40 ET]
Table 'Arneb' 6-max Seat #1 is the button
Seat 1: pipinoelbreve9 (€2 in chips) 
Seat 2: KillVerlaine (€1.71 in chips) 
Seat 3: josepoker195 (€2.76 in chips) 
Seat 4: dragonfly2467 (€2.11 in chips) 
Seat 5: 1Drazi (€2 in chips) 
Seat 6: orosa (€2.54 in chips) 
KillVerlaine: posts small blind €0.01
josepoker195: posts big blind €0.02
*** HOLE CARDS ***
Dealt to pipinoelbreve9 [4s Ks]
dragonfly2467: folds 
1Drazi: raises €0.04 to €0.06
orosa: folds 
pipinoelbreve9: calls €0.06
KillVerlaine: folds 
josepoker195: calls €0.04
*** FLOP *** [Qh 3c 5h]
josepoker195: checks 
1Drazi: bets €0.06
pipinoelbreve9: folds 
josepoker195: calls €0.06
*** TURN *** [Qh 3c 5h] [Ad]
josepoker195: checks 
1Drazi: checks 
*** RIVER *** [Qh 3c 5h Ad] [Jd]
josepoker195: bets €0.29
1Drazi: folds 
Uncalled bet (€0.29) returned to josepoker195
josepoker195 collected €0.29 from pot
josepoker195: doesn't show hand 
*** SUMMARY ***
Total pot €0.31 | Rake €0.02 
Board [Qh 3c 5h Ad Jd]
Seat 1: pipinoelbreve9 (button) folded on the Flop
Seat 2: KillVerlaine (small blind) folded before Flop
Seat 3: josepoker195 (big blind) collected (€0.29)
Seat 4: dragonfly2467 folded before Flop (didn't bet)
Seat 5: 1Drazi folded on the River
Seat 6: orosa folded before Flop (didn't bet)



PokerStars Zoom Hand #257558013393:  Hold'em No Limit (€0.01/€0.02) - 2025/08/31 17:57:04 CET [2025/08/31 11:57:04 ET]
Table 'Arneb' 6-max Seat #1 is the button
Seat 1: 1Drazi (€2.95 in chips) 
Seat 2: juanlu2000china (€1.45 in chips) 
Seat 3: pipinoelbreve9 (€2 in chips) 
Seat 4: masquisiera (€1.11 in chips) 
Seat 5: 34pluto (€0.95 in chips) 
Seat 6: 77samuel33 (€12.92 in chips) 
juanlu2000china: posts small blind €0.01
pipinoelbreve9: posts big blind €0.02
*** HOLE CARDS ***
Dealt to pipinoelbreve9 [3d Kh]
masquisiera: raises €0.04 to €0.06
34pluto: folds 
77samuel33: folds 
1Drazi: folds 
juanlu2000china: folds 
pipinoelbreve9: calls €0.04
*** FLOP *** [5c 5s 3h]
pipinoelbreve9: checks 
masquisiera: bets €0.05
pipinoelbreve9: calls €0.05
*** TURN *** [5c 5s 3h] [Ts]
pipinoelbreve9: checks 
masquisiera: checks 
*** RIVER *** [5c 5s 3h Ts] [Jc]
pipinoelbreve9: bets €0.11
masquisiera: raises €0.19 to €0.30
pipinoelbreve9: calls €0.19
*** SHOW DOWN ***
masquisiera: shows [Th Td] (a full house, Tens full of Fives)
pipinoelbreve9: mucks hand 
masquisiera collected €0.79 from pot
*** SUMMARY ***
Total pot €0.83 | Rake €0.04 
Board [5c 5s 3h Ts Jc]
Seat 1: 1Drazi (button) folded before Flop (didn't bet)
Seat 2: juanlu2000china (small blind) folded before Flop
Seat 3: pipinoelbreve9 (big blind) mucked [3d Kh]
Seat 4: masquisiera showed [Th Td] and won (€0.79) with a full house, Tens full of Fives
Seat 5: 34pluto folded before Flop (didn't bet)
Seat 6: 77samuel33 folded before Flop (didn't bet)



PokerStars Zoom Hand #257558019124:  Hold'em No Limit (€0.01/€0.02) - 2025/08/31 17:57:47 CET [2025/08/31 11:57:47 ET]
Table 'Arneb' 6-max Seat #1 is the button
Seat 1: marcosbalsaa (€3.36 in chips) 
Seat 2: pipinoelbreve9 (€2 in chips) 
Seat 3: orosa (€2.51 in chips) 
Seat 4: masquisiera (€1.49 in chips) 
Seat 5: poteaarte (€2.16 in chips) 
Seat 6: NEMOXYX (€4.35 in chips) 
pipinoelbreve9: posts small blind €0.01
orosa: posts big blind €0.02
*** HOLE CARDS ***
Dealt to pipinoelbreve9 [3h 2h]
masquisiera: folds 
poteaarte: folds 
NEMOXYX: folds 
marcosbalsaa: raises €0.04 to €0.06
pipinoelbreve9: folds 
orosa: folds 
Uncalled bet (€0.04) returned to marcosbalsaa
marcosbalsaa collected €0.05 from pot
marcosbalsaa: doesn't show hand 
*** SUMMARY ***
Total pot €0.05 | Rake €0 
Seat 1: marcosbalsaa (button) collected (€0.05)
Seat 2: pipinoelbreve9 (small blind) folded before Flop
Seat 3: orosa (big blind) folded before Flop
Seat 4: masquisiera folded before Flop (didn't bet)
Seat 5: poteaarte folded before Flop (didn't bet)
Seat 6: NEMOXYX folded before Flop (didn't bet)



PokerStars Zoom Hand #257558021275:  Hold'em No Limit (€0.01/€0.02) - 2025/08/31 17:58:03 CET [2025/08/31 11:58:03 ET]
Table 'Arneb' 6-max Seat #1 is the button
Seat 1: ldzepp (€2.02 in chips) 
Seat 2: dragonfly2467 (€2 in chips) 
Seat 3: PerParFr (€2.42 in chips) 
Seat 4: pipinoelbreve9 (€2 in chips) 
Seat 5: NEMOXYX (€2.02 in chips) 
Seat 6: poteaarte (€1.98 in chips) 
dragonfly2467: posts small blind €0.01
PerParFr: posts big blind €0.02
*** HOLE CARDS ***
Dealt to pipinoelbreve9 [6s Jd]
pipinoelbreve9: folds 
NEMOXYX: folds 
poteaarte: folds 
ldzepp: folds 
dragonfly2467: folds 
Uncalled bet (€0.01) returned to PerParFr
PerParFr collected €0.02 from pot
PerParFr: doesn't show hand 
*** SUMMARY ***
Total pot €0.02 | Rake €0 
Seat 1: ldzepp (button) folded before Flop (didn't bet)
Seat 2: dragonfly2467 (small blind) folded before Flop
Seat 3: PerParFr (big blind) collected (€0.02)
Seat 4: pipinoelbreve9 folded before Flop (didn't bet)
Seat 5: NEMOXYX folded before Flop (didn't bet)
Seat 6: poteaarte folded before Flop (didn't bet)



PokerStars Zoom Hand #257558021897:  Hold'em No Limit (€0.01/€0.02) - 2025/08/31 17:58:07 CET [2025/08/31 11:58:07 ET]
Table 'Arneb' 6-max Seat #1 is the button
Seat 1: 1Drazi (€3.02 in chips) 
Seat 2: 77samuel33 (€3.28 in chips) 
Seat 3: NotClaudio1 (€3.61 in chips) 
Seat 4: pipinoelbreve9 (€2 in chips) 
Seat 5: AnxoGM (€2.04 in chips) 
Seat 6: dragonfly2467 (€2 in chips) 
77samuel33: posts small blind €0.01
NotClaudio1: posts big blind €0.02
*** HOLE CARDS ***
Dealt to pipinoelbreve9 [5d Ad]
pipinoelbreve9: raises €0.04 to €0.06
AnxoGM: folds 
dragonfly2467: folds 
1Drazi: folds 
77samuel33: folds 
NotClaudio1: folds 
Uncalled bet (€0.04) returned to pipinoelbreve9
pipinoelbreve9 collected €0.05 from pot
pipinoelbreve9: doesn't show hand 
*** SUMMARY ***
Total pot €0.05 | Rake €0 
Seat 1: 1Drazi (button) folded before Flop (didn't bet)
Seat 2: 77samuel33 (small blind) folded before Flop
Seat 3: NotClaudio1 (big blind) folded before Flop
Seat 4: pipinoelbreve9 collected (€0.05)
Seat 5: AnxoGM folded before Flop (didn't bet)
Seat 6: dragonfly2467 folded before Flop (didn't bet)



PokerStars Zoom Hand #257558020445:  Hold'em No Limit (€0.01/€0.02) - 2025/08/31 17:57:56 CET [2025/08/31 11:57:56 ET]
Table 'Arneb' 6-max Seat #1 is the button
Seat 1: NotClaudio1 (€2.64 in chips) 
Seat 2: teno77 (€0.76 in chips) 
Seat 3: abmarc99 (€1 in chips) 
Seat 4: 1Drazi (€3.40 in chips) 
Seat 5: pipinoelbreve9 (€2 in chips) 
Seat 6: DeividBox980 (€1.13 in chips) 
teno77: posts small blind €0.01
abmarc99: posts big blind €0.02
*** HOLE CARDS ***
Dealt to pipinoelbreve9 [8c Ah]
1Drazi: folds 
pipinoelbreve9: folds 
DeividBox980: folds 
NotClaudio1: raises €0.02 to €0.04
teno77: calls €0.03
abmarc99: calls €0.02
*** FLOP *** [9h Jh 6d]
teno77: checks 
abmarc99: checks 
NotClaudio1: bets €0.04
teno77: calls €0.04
abmarc99: folds 
*** TURN *** [9h Jh 6d] [5c]
teno77: checks 
NotClaudio1: bets €0.06
teno77: calls €0.06
*** RIVER *** [9h Jh 6d 5c] [3h]
teno77: checks 
NotClaudio1: bets €0.10
teno77: calls €0.10
*** SHOW DOWN ***
NotClaudio1: shows [Js Qc] (a pair of Jacks)
teno77: mucks hand 
NotClaudio1 collected €0.49 from pot
*** SUMMARY ***
Total pot €0.52 | Rake €0.03 
Board [9h Jh 6d 5c 3h]
Seat 1: NotClaudio1 (button) showed [Js Qc] and won (€0.49) with a pair of Jacks
Seat 2: teno77 (small blind) mucked [Ts 6c]
Seat 3: abmarc99 (big blind) folded on the Flop
Seat 4: 1Drazi folded before Flop (didn't bet)
Seat 5: pipinoelbreve9 folded before Flop (didn't bet)
Seat 6: DeividBox980 folded before Flop (didn't bet)



PokerStars Zoom Hand #257558024355:  Hold'em No Limit (€0.01/€0.02) - 2025/08/31 17:58:25 CET [2025/08/31 11:58:25 ET]
Table 'Arneb' 6-max Seat #1 is the button
Seat 1: 1Drazi (€2 in chips) 
Seat 2: marcosbalsaa (€4.58 in chips) 
Seat 3: 77samuel33 (€2.83 in chips) 
Seat 4: pisuleto (€3.59 in chips) 
Seat 5: ldzepp (€2 in chips) 
Seat 6: pipinoelbreve9 (€2.03 in chips) 
marcosbalsaa: posts small blind €0.01
77samuel33: posts big blind €0.02
*** HOLE CARDS ***
Dealt to pipinoelbreve9 [Kh Th]
ldzepp is disconnected 
pisuleto: folds 
ldzepp has timed out while disconnected
ldzepp: folds 
pipinoelbreve9: raises €0.04 to €0.06
1Drazi: folds 
marcosbalsaa: folds 
77samuel33: calls €0.04
*** FLOP *** [3c 2d 8s]
77samuel33: checks 
pipinoelbreve9: checks 
*** TURN *** [3c 2d 8s] [7h]
77samuel33: checks 
pipinoelbreve9: checks 
*** RIVER *** [3c 2d 8s 7h] [5c]
77samuel33: checks 
pipinoelbreve9: checks 
*** SHOW DOWN ***
77samuel33: shows [As Tc] (high card Ace)
pipinoelbreve9: mucks hand 
77samuel33 collected €0.12 from pot
*** SUMMARY ***
Total pot €0.13 | Rake €0.01 
Board [3c 2d 8s 7h 5c]
Seat 1: 1Drazi (button) folded before Flop (didn't bet)
Seat 2: marcosbalsaa (small blind) folded before Flop
Seat 3: 77samuel33 (big blind) showed [As Tc] and won (€0.12) with high card Ace
Seat 4: pisuleto folded before Flop (didn't bet)
Seat 5: ldzepp folded before Flop (didn't bet)
Seat 6: pipinoelbreve9 mucked [Kh Th]



PokerStars Zoom Hand #257558033153:  Hold'em No Limit (€0.01/€0.02) - 2025/08/31 17:59:32 CET [2025/08/31 11:59:32 ET]
Table 'Arneb' 6-max Seat #1 is the button
Seat 1: orosa (€2.47 in chips) 
Seat 2: NEMOXYX (€2.17 in chips) 
Seat 3: pipinoelbreve9 (€2 in chips) 
Seat 4: 1Drazi (€3.23 in chips) 
Seat 5: Gginer2812 (€1.90 in chips) 
Seat 6: Antoniogf13 (€2.16 in chips) 
NEMOXYX: posts small blind €0.01
pipinoelbreve9: posts big blind €0.02
*** HOLE CARDS ***
Dealt to pipinoelbreve9 [4d Tc]
1Drazi: folds 
Gginer2812: calls €0.02
Antoniogf13: folds 
orosa: raises €0.06 to €0.08
NEMOXYX: folds 
pipinoelbreve9: folds 
Gginer2812: folds 
Uncalled bet (€0.06) returned to orosa
orosa collected €0.07 from pot
orosa: doesn't show hand 
*** SUMMARY ***
Total pot €0.07 | Rake €0 
Seat 1: orosa (button) collected (€0.07)
Seat 2: NEMOXYX (small blind) folded before Flop
Seat 3: pipinoelbreve9 (big blind) folded before Flop
Seat 4: 1Drazi folded before Flop (didn't bet)
Seat 5: Gginer2812 folded before Flop
Seat 6: Antoniogf13 folded before Flop (didn't bet)



PokerStars Zoom Hand #257558036564:  Hold'em No Limit (€0.01/€0.02) - 2025/08/31 17:59:57 CET [2025/08/31 11:59:57 ET]
Table 'Arneb' 6-max Seat #1 is the button
Seat 1: 1Drazi (€3.16 in chips) 
Seat 2: marcooliveira99 (€0.33 in chips) 
Seat 3: orosa (€2.19 in chips) 
Seat 4: 34pluto (€1.91 in chips) 
Seat 5: ehbraga (€0.99 in chips) 
Seat 6: pipinoelbreve9 (€2 in chips) 
marcooliveira99: posts small blind €0.01
orosa: posts big blind €0.02
*** HOLE CARDS ***
Dealt to pipinoelbreve9 [2d 4s]
34pluto: folds 
ehbraga: folds 
pipinoelbreve9: folds 
1Drazi: folds 
marcooliveira99: folds 
Uncalled bet (€0.01) returned to orosa
orosa collected €0.02 from pot
orosa: doesn't show hand 
*** SUMMARY ***
Total pot €0.02 | Rake €0 
Seat 1: 1Drazi (button) folded before Flop (didn't bet)
Seat 2: marcooliveira99 (small blind) folded before Flop
Seat 3: orosa (big blind) collected (€0.02)
Seat 4: 34pluto folded before Flop (didn't bet)
Seat 5: ehbraga folded before Flop (didn't bet)
Seat 6: pipinoelbreve9 folded before Flop (didn't bet)



PokerStars Zoom Hand #257558035178:  Hold'em No Limit (€0.01/€0.02) - 2025/08/31 17:59:47 CET [2025/08/31 11:59:47 ET]
Table 'Arneb' 6-max Seat #1 is the button
Seat 1: marcosbalsaa (€4.54 in chips) 
Seat 2: pipinoelbreve9 (€2 in chips) 
Seat 3: IsmaAthletic (€1.80 in chips) 
Seat 4: poteaarte (€1.94 in chips) 
Seat 5: maximus_powah (€2.57 in chips) 
Seat 6: gin_213 (€2.03 in chips) 
pipinoelbreve9: posts small blind €0.01
IsmaAthletic: posts big blind €0.02
*** HOLE CARDS ***
Dealt to pipinoelbreve9 [9c Qh]
poteaarte: folds 
maximus_powah: raises €0.04 to €0.06
gin_213: calls €0.06
marcosbalsaa: raises €0.12 to €0.18
pipinoelbreve9: folds 
IsmaAthletic: folds 
maximus_powah: folds 
gin_213: folds 
Uncalled bet (€0.12) returned to marcosbalsaa
marcosbalsaa collected €0.21 from pot
marcosbalsaa: doesn't show hand 
*** SUMMARY ***
Total pot €0.21 | Rake €0 
Seat 1: marcosbalsaa (button) collected (€0.21)
Seat 2: pipinoelbreve9 (small blind) folded before Flop
Seat 3: IsmaAthletic (big blind) folded before Flop
Seat 4: poteaarte folded before Flop (didn't bet)
Seat 5: maximus_powah folded before Flop
Seat 6: gin_213 folded before Flop



PokerStars Zoom Hand #257558037604:  Hold'em No Limit (€0.01/€0.02) - 2025/08/31 18:00:04 CET [2025/08/31 12:00:04 ET]
Table 'Arneb' 6-max Seat #1 is the button
Seat 1: masquisiera (€1.19 in chips) 
Seat 2: AnxoGM (€3.49 in chips) 
Seat 3: MagicGitox (€1.70 in chips) 
Seat 4: NotClaudio1 (€3.33 in chips) 
Seat 5: pipinoelbreve9 (€2 in chips) 
Seat 6: juanlu2000china (€1.65 in chips) 
AnxoGM: posts small blind €0.01
MagicGitox: posts big blind €0.02
*** HOLE CARDS ***
Dealt to pipinoelbreve9 [Js Td]
NotClaudio1: folds 
pipinoelbreve9: folds 
juanlu2000china: folds 
masquisiera: folds 
AnxoGM: folds 
Uncalled bet (€0.01) returned to MagicGitox
MagicGitox collected €0.02 from pot
MagicGitox: doesn't show hand 
*** SUMMARY ***
Total pot €0.02 | Rake €0 
Seat 1: masquisiera (button) folded before Flop (didn't bet)
Seat 2: AnxoGM (small blind) folded before Flop
Seat 3: MagicGitox (big blind) collected (€0.02)
Seat 4: NotClaudio1 folded before Flop (didn't bet)
Seat 5: pipinoelbreve9 folded before Flop (didn't bet)
Seat 6: juanlu2000china folded before Flop (didn't bet)



PokerStars Zoom Hand #257558034677:  Hold'em No Limit (€0.01/€0.02) - 2025/08/31 17:59:43 CET [2025/08/31 11:59:43 ET]
Table 'Arneb' 6-max Seat #1 is the button
Seat 1: pipinoelbreve9 (€2 in chips) 
Seat 2: thenry03 (€1.72 in chips) 
Seat 3: cuenca10 (€2.12 in chips) 
Seat 4: 77samuel33 (€2.89 in chips) 
Seat 5: DeividBox980 (€1.10 in chips) 
Seat 6: NEMOXYX (€2.16 in chips) 
thenry03: posts small blind €0.01
cuenca10: posts big blind €0.02
*** HOLE CARDS ***
Dealt to pipinoelbreve9 [Th 9c]
77samuel33: folds 
DeividBox980: raises €0.04 to €0.06
NEMOXYX: folds 
pipinoelbreve9: folds 
thenry03: raises €0.14 to €0.20
cuenca10: folds 
DeividBox980: folds 
Uncalled bet (€0.14) returned to thenry03
thenry03 collected €0.14 from pot
thenry03: doesn't show hand 
*** SUMMARY ***
Total pot €0.14 | Rake €0 
Seat 1: pipinoelbreve9 (button) folded before Flop (didn't bet)
Seat 2: thenry03 (small blind) collected (€0.14)
Seat 3: cuenca10 (big blind) folded before Flop
Seat 4: 77samuel33 folded before Flop (didn't bet)
Seat 5: DeividBox980 folded before Flop
Seat 6: NEMOXYX folded before Flop (didn't bet)



PokerStars Zoom Hand #257558038199:  Hold'em No Limit (€0.01/€0.02) - 2025/08/31 18:00:08 CET [2025/08/31 12:00:08 ET]
Table 'Arneb' 6-max Seat #1 is the button
Seat 1: marcosbalsaa (€3.27 in chips) 
Seat 2: masquisiera (€1.19 in chips) 
Seat 3: 1Drazi (€3.43 in chips) 
Seat 4: pipinoelbreve9 (€2 in chips) 
Seat 5: morganlee66 (€3.01 in chips) 
Seat 6: IsmaAthletic (€1.78 in chips) 
masquisiera: posts small blind €0.01
1Drazi: posts big blind €0.02
*** HOLE CARDS ***
Dealt to pipinoelbreve9 [5c 3s]
pipinoelbreve9: folds 
morganlee66: folds 
IsmaAthletic: folds 
marcosbalsaa: raises €0.04 to €0.06
masquisiera: folds 
1Drazi: folds 
Uncalled bet (€0.04) returned to marcosbalsaa
marcosbalsaa collected €0.05 from pot
marcosbalsaa: doesn't show hand 
*** SUMMARY ***
Total pot €0.05 | Rake €0 
Seat 1: marcosbalsaa (button) collected (€0.05)
Seat 2: masquisiera (small blind) folded before Flop
Seat 3: 1Drazi (big blind) folded before Flop
Seat 4: pipinoelbreve9 folded before Flop (didn't bet)
Seat 5: morganlee66 folded before Flop (didn't bet)
Seat 6: IsmaAthletic folded before Flop (didn't bet)



PokerStars Zoom Hand #257558038691:  Hold'em No Limit (€0.01/€0.02) - 2025/08/31 18:00:12 CET [2025/08/31 12:00:12 ET]
Table 'Arneb' 6-max Seat #1 is the button
Seat 1: AnxoGM (€3.48 in chips) 
Seat 2: pablosua (€0.99 in chips) 
Seat 3: pipinoelbreve9 (€2 in chips) 
Seat 4: gin_213 (€1.97 in chips) 
Seat 5: 34pluto (€1.02 in chips) 
Seat 6: davidelgnomo747 (€0.74 in chips) 
pablosua: posts small blind €0.01
pipinoelbreve9: posts big blind €0.02
*** HOLE CARDS ***
Dealt to pipinoelbreve9 [8h 5h]
gin_213: folds 
34pluto: folds 
davidelgnomo747: raises €0.02 to €0.04
AnxoGM: folds 
pablosua: calls €0.03
pipinoelbreve9: calls €0.02
*** FLOP *** [4s 3s 6h]
pablosua: checks 
pipinoelbreve9: bets €0.07
davidelgnomo747: folds 
pablosua: folds 
Uncalled bet (€0.07) returned to pipinoelbreve9
pipinoelbreve9 collected €0.11 from pot
pipinoelbreve9: doesn't show hand 
*** SUMMARY ***
Total pot €0.12 | Rake €0.01 
Board [4s 3s 6h]
Seat 1: AnxoGM (button) folded before Flop (didn't bet)
Seat 2: pablosua (small blind) folded on the Flop
Seat 3: pipinoelbreve9 (big blind) collected (€0.11)
Seat 4: gin_213 folded before Flop (didn't bet)
Seat 5: 34pluto folded before Flop (didn't bet)
Seat 6: davidelgnomo747 folded on the Flop



PokerStars Zoom Hand #257558044715:  Hold'em No Limit (€0.01/€0.02) - 2025/08/31 18:00:52 CET [2025/08/31 12:00:52 ET]
Table 'Arneb' 6-max Seat #1 is the button
Seat 1: pipinoelbreve9 (€2.07 in chips) 
Seat 2: masquisiera (€1.04 in chips) 
Seat 3: monsieur881 (€1.56 in chips) 
Seat 4: 1Drazi (€3.38 in chips) 
Seat 5: 34pluto (€1.07 in chips) 
Seat 6: NEMOXYX (€2.24 in chips) 
masquisiera: posts small blind €0.01
monsieur881: posts big blind €0.02
*** HOLE CARDS ***
Dealt to pipinoelbreve9 [5h 8c]
1Drazi: folds 
34pluto has timed out
34pluto: folds 
NEMOXYX: folds 
pipinoelbreve9: folds 
masquisiera: folds 
Uncalled bet (€0.01) returned to monsieur881
monsieur881 collected €0.02 from pot
monsieur881: doesn't show hand 
*** SUMMARY ***
Total pot €0.02 | Rake €0 
Seat 1: pipinoelbreve9 (button) folded before Flop (didn't bet)
Seat 2: masquisiera (small blind) folded before Flop
Seat 3: monsieur881 (big blind) collected (€0.02)
Seat 4: 1Drazi folded before Flop (didn't bet)
Seat 5: 34pluto folded before Flop (didn't bet)
Seat 6: NEMOXYX folded before Flop (didn't bet)



PokerStars Zoom Hand #257558045718:  Hold'em No Limit (€0.01/€0.02) - 2025/08/31 18:00:58 CET [2025/08/31 12:00:58 ET]
Table 'Arneb' 6-max Seat #1 is the button
Seat 1: vayewis (€2.36 in chips) 
Seat 2: pipinoelbreve9 (€2.07 in chips) 
Seat 3: maximus_powah (€5.17 in chips) 
Seat 4: NEMOXYX (€2.24 in chips) 
Seat 5: masquisiera (€1.16 in chips) 
Seat 6: jcm83640 (€0.73 in chips) 
pipinoelbreve9: posts small blind €0.01
maximus_powah: posts big blind €0.02
*** HOLE CARDS ***
Dealt to pipinoelbreve9 [Js 5s]
NEMOXYX: folds 
masquisiera: folds 
jcm83640: folds 
vayewis: folds 
pipinoelbreve9: raises €0.04 to €0.06
maximus_powah: raises €0.12 to €0.18
pipinoelbreve9: calls €0.12
*** FLOP *** [Jc Ad 9h]
pipinoelbreve9: checks 
maximus_powah: bets €0.09
pipinoelbreve9: calls €0.09
*** TURN *** [Jc Ad 9h] [4h]
pipinoelbreve9: checks 
maximus_powah: bets €0.38
pipinoelbreve9: folds 
Uncalled bet (€0.38) returned to maximus_powah
maximus_powah collected €0.51 from pot
maximus_powah: doesn't show hand 
*** SUMMARY ***
Total pot €0.54 | Rake €0.03 
Board [Jc Ad 9h 4h]
Seat 1: vayewis (button) folded before Flop (didn't bet)
Seat 2: pipinoelbreve9 (small blind) folded on the Turn
Seat 3: maximus_powah (big blind) collected (€0.51)
Seat 4: NEMOXYX folded before Flop (didn't bet)
Seat 5: masquisiera folded before Flop (didn't bet)
Seat 6: jcm83640 folded before Flop (didn't bet)



PokerStars Zoom Hand #257558053338:  Hold'em No Limit (€0.01/€0.02) - 2025/08/31 18:01:41 CET [2025/08/31 12:01:41 ET]
Table 'Arneb' 6-max Seat #1 is the button
Seat 1: AnxoGM (€3.16 in chips) 
Seat 2: masquisiera (€1.13 in chips) 
Seat 3: NotClaudio1 (€3.21 in chips) 
Seat 4: pipinoelbreve9 (€2 in chips) 
Seat 5: RamsDios (€3.47 in chips) 
Seat 6: Gginer2812 (€1.83 in chips) 
masquisiera: posts small blind €0.01
NotClaudio1: posts big blind €0.02
*** HOLE CARDS ***
Dealt to pipinoelbreve9 [Kc 7c]
pipinoelbreve9: folds 
RamsDios: folds 
Gginer2812: folds 
AnxoGM: raises €0.03 to €0.05
masquisiera: folds 
NotClaudio1: calls €0.03
*** FLOP *** [3c 6c 3s]
NotClaudio1: bets €0.05
AnxoGM: folds 
Uncalled bet (€0.05) returned to NotClaudio1
NotClaudio1 collected €0.10 from pot
NotClaudio1: doesn't show hand 
*** SUMMARY ***
Total pot €0.11 | Rake €0.01 
Board [3c 6c 3s]
Seat 1: AnxoGM (button) folded on the Flop
Seat 2: masquisiera (small blind) folded before Flop
Seat 3: NotClaudio1 (big blind) collected (€0.10)
Seat 4: pipinoelbreve9 folded before Flop (didn't bet)
Seat 5: RamsDios folded before Flop (didn't bet)
Seat 6: Gginer2812 folded before Flop (didn't bet)



PokerStars Zoom Hand #257558055048:  Hold'em No Limit (€0.01/€0.02) - 2025/08/31 18:01:51 CET [2025/08/31 12:01:51 ET]
Table 'Arneb' 6-max Seat #1 is the button
Seat 1: pipinoelbreve9 (€2 in chips) 
Seat 2: iam_xCidx (€2.89 in chips) 
Seat 3: dragonfly2467 (€2.22 in chips) 
Seat 4: kingarmor (€4.72 in chips) 
Seat 5: orosa (€3.41 in chips) 
Seat 6: IsmaAthletic (€1.65 in chips) 
iam_xCidx: posts small blind €0.01
dragonfly2467: posts big blind €0.02
*** HOLE CARDS ***
Dealt to pipinoelbreve9 [2h 9s]
kingarmor: folds 
orosa: folds 
IsmaAthletic: raises €0.04 to €0.06
pipinoelbreve9: folds 
iam_xCidx: folds 
dragonfly2467: calls €0.04
*** FLOP *** [Kc Th 4d]
dragonfly2467: checks 
IsmaAthletic: bets €0.06
dragonfly2467: folds 
Uncalled bet (€0.06) returned to IsmaAthletic
IsmaAthletic collected €0.12 from pot
IsmaAthletic: doesn't show hand 
*** SUMMARY ***
Total pot €0.13 | Rake €0.01 
Board [Kc Th 4d]
Seat 1: pipinoelbreve9 (button) folded before Flop (didn't bet)
Seat 2: iam_xCidx (small blind) folded before Flop
Seat 3: dragonfly2467 (big blind) folded on the Flop
Seat 4: kingarmor folded before Flop (didn't bet)
Seat 5: orosa folded before Flop (didn't bet)
Seat 6: IsmaAthletic collected (€0.12)



PokerStars Zoom Hand #257558056101:  Hold'em No Limit (€0.01/€0.02) - 2025/08/31 18:01:55 CET [2025/08/31 12:01:55 ET]
Table 'Arneb' 6-max Seat #1 is the button
Seat 1: josepoker195 (€2.49 in chips) 
Seat 2: orosa (€2 in chips) 
Seat 3: kingarmor (€4.72 in chips) 
Seat 4: pauma1123 (€1.35 in chips) 
Seat 5: marcooliveira99 (€0.41 in chips) 
Seat 6: pipinoelbreve9 (€2 in chips) 
orosa: posts small blind €0.01
kingarmor: posts big blind €0.02
*** HOLE CARDS ***
Dealt to pipinoelbreve9 [Js 4s]
pauma1123: raises €0.02 to €0.04
marcooliveira99: folds 
pipinoelbreve9: folds 
josepoker195: calls €0.04
orosa: folds 
kingarmor: folds 
*** FLOP *** [Jh 4c 5s]
pauma1123: checks 
josepoker195: bets €0.14
pauma1123: folds 
Uncalled bet (€0.14) returned to josepoker195
josepoker195 collected €0.10 from pot
josepoker195: doesn't show hand 
*** SUMMARY ***
Total pot €0.11 | Rake €0.01 
Board [Jh 4c 5s]
Seat 1: josepoker195 (button) collected (€0.10)
Seat 2: orosa (small blind) folded before Flop
Seat 3: kingarmor (big blind) folded before Flop
Seat 4: pauma1123 folded on the Flop
Seat 5: marcooliveira99 folded before Flop (didn't bet)
Seat 6: pipinoelbreve9 folded before Flop (didn't bet)



PokerStars Zoom Hand #257558052701:  Hold'em No Limit (€0.01/€0.02) - 2025/08/31 18:01:38 CET [2025/08/31 12:01:38 ET]
Table 'Arneb' 6-max Seat #1 is the button
Seat 1: combinius1 (€2.25 in chips) 
Seat 2: NEMOXYX (€2.21 in chips) 
Seat 3: davidelgnomo747 (€0.96 in chips) 
Seat 4: 1Drazi (€3.17 in chips) 
Seat 5: maximus_powah (€2.28 in chips) 
Seat 6: pipinoelbreve9 (€2 in chips) 
NEMOXYX: posts small blind €0.01
davidelgnomo747: posts big blind €0.02
*** HOLE CARDS ***
Dealt to pipinoelbreve9 [9h 7c]
1Drazi: raises €0.04 to €0.06
maximus_powah: folds 
pipinoelbreve9: folds 
combinius1: folds 
NEMOXYX: folds 
davidelgnomo747: calls €0.04
*** FLOP *** [Ts 2h 4c]
davidelgnomo747: checks 
1Drazi: bets €0.04
davidelgnomo747: calls €0.04
*** TURN *** [Ts 2h 4c] [6d]
davidelgnomo747: checks 
1Drazi: checks 
*** RIVER *** [Ts 2h 4c 6d] [Ad]
davidelgnomo747: bets €0.10
1Drazi: folds 
Uncalled bet (€0.10) returned to davidelgnomo747
davidelgnomo747 collected €0.20 from pot
davidelgnomo747: doesn't show hand 
*** SUMMARY ***
Total pot €0.21 | Rake €0.01 
Board [Ts 2h 4c 6d Ad]
Seat 1: combinius1 (button) folded before Flop (didn't bet)
Seat 2: NEMOXYX (small blind) folded before Flop
Seat 3: davidelgnomo747 (big blind) collected (€0.20)
Seat 4: 1Drazi folded on the River
Seat 5: maximus_powah folded before Flop (didn't bet)
Seat 6: pipinoelbreve9 folded before Flop (didn't bet)



PokerStars Zoom Hand #257558057220:  Hold'em No Limit (€0.01/€0.02) - 2025/08/31 18:02:00 CET [2025/08/31 12:02:00 ET]
Table 'Arneb' 6-max Seat #1 is the button
Seat 1: 76jusab76 (€0.93 in chips) 
Seat 2: pipinoelbreve9 (€2 in chips) 
Seat 3: NEMOXYX (€2.23 in chips) 
Seat 4: MagicGitox (€1.35 in chips) 
Seat 5: NotClaudio1 (€3.26 in chips) 
Seat 6: eneko83 (€1.73 in chips) 
pipinoelbreve9: posts small blind €0.01
NEMOXYX: posts big blind €0.02
*** HOLE CARDS ***
Dealt to pipinoelbreve9 [Jc Kh]
MagicGitox: folds 
NotClaudio1: folds 
eneko83: folds 
76jusab76: folds 
pipinoelbreve9: raises €0.04 to €0.06
NEMOXYX: raises €0.12 to €0.18
pipinoelbreve9: calls €0.12
*** FLOP *** [5s 9s 2s]
pipinoelbreve9: checks 
NEMOXYX: checks 
*** TURN *** [5s 9s 2s] [Ac]
pipinoelbreve9: checks 
NEMOXYX: bets €0.24
pipinoelbreve9: folds 
Uncalled bet (€0.24) returned to NEMOXYX
NEMOXYX collected €0.34 from pot
NEMOXYX: doesn't show hand 
*** SUMMARY ***
Total pot €0.36 | Rake €0.02 
Board [5s 9s 2s Ac]
Seat 1: 76jusab76 (button) folded before Flop (didn't bet)
Seat 2: pipinoelbreve9 (small blind) folded on the Turn
Seat 3: NEMOXYX (big blind) collected (€0.34)
Seat 4: MagicGitox folded before Flop (didn't bet)
Seat 5: NotClaudio1 folded before Flop (didn't bet)
Seat 6: eneko83 folded before Flop (didn't bet)



PokerStars Zoom Hand #257558054448:  Hold'em No Limit (€0.01/€0.02) - 2025/08/31 18:01:47 CET [2025/08/31 12:01:47 ET]
Table 'Arneb' 6-max Seat #1 is the button
Seat 1: monsieur881 (€1.57 in chips) 
Seat 2: Gginer2812 (€1.83 in chips) 
Seat 3: 34pluto (€1.85 in chips) 
Seat 4: NEMOXYX (€2.23 in chips) 
Seat 5: pipinoelbreve9 (€2 in chips) 
Seat 6: Chendoteam (€2.73 in chips) 
Gginer2812: posts small blind €0.01
34pluto: posts big blind €0.02
*** HOLE CARDS ***
Dealt to pipinoelbreve9 [6d Qh]
NEMOXYX: folds 
pipinoelbreve9: folds 
Chendoteam: calls €0.02
monsieur881: folds 
Gginer2812: folds 
34pluto: checks 
*** FLOP *** [8h 3h 9s]
34pluto: checks 
Chendoteam: checks 
*** TURN *** [8h 3h 9s] [3s]
34pluto: checks 
Chendoteam: checks 
*** RIVER *** [8h 3h 9s 3s] [9d]
34pluto: checks 
Chendoteam: checks 
*** SHOW DOWN ***
34pluto: shows [Qc Jc] (two pair, Nines and Threes)
Chendoteam: shows [Tc Ac] (two pair, Nines and Threes - Ace kicker)
Chendoteam collected €0.05 from pot
*** SUMMARY ***
Total pot €0.05 | Rake €0 
Board [8h 3h 9s 3s 9d]
Seat 1: monsieur881 (button) folded before Flop (didn't bet)
Seat 2: Gginer2812 (small blind) folded before Flop
Seat 3: 34pluto (big blind) showed [Qc Jc] and lost with two pair, Nines and Threes
Seat 4: NEMOXYX folded before Flop (didn't bet)
Seat 5: pipinoelbreve9 folded before Flop (didn't bet)
Seat 6: Chendoteam showed [Tc Ac] and won (€0.05) with two pair, Nines and Threes



PokerStars Zoom Hand #257558065187:  Hold'em No Limit (€0.01/€0.02) - 2025/08/31 18:02:37 CET [2025/08/31 12:02:37 ET]
Table 'Arneb' 6-max Seat #1 is the button
Seat 1: cuenca10 (€2.26 in chips) 
Seat 2: HGrenha (€3.47 in chips) 
Seat 3: pipinoelbreve9 (€2 in chips) 
Seat 4: NotClaudio1 (€3.28 in chips) 
Seat 5: poteaarte (€1.94 in chips) 
Seat 6: NEMOXYX (€2.39 in chips) 
HGrenha: posts small blind €0.01
pipinoelbreve9: posts big blind €0.02
*** HOLE CARDS ***
Dealt to pipinoelbreve9 [7h Ts]
NotClaudio1: folds 
poteaarte: folds 
NEMOXYX: folds 
cuenca10: folds 
HGrenha: folds 
Uncalled bet (€0.01) returned to pipinoelbreve9
pipinoelbreve9 collected €0.02 from pot
pipinoelbreve9: doesn't show hand 
*** SUMMARY ***
Total pot €0.02 | Rake €0 
Seat 1: cuenca10 (button) folded before Flop (didn't bet)
Seat 2: HGrenha (small blind) folded before Flop
Seat 3: pipinoelbreve9 (big blind) collected (€0.02)
Seat 4: NotClaudio1 folded before Flop (didn't bet)
Seat 5: poteaarte folded before Flop (didn't bet)
Seat 6: NEMOXYX folded before Flop (didn't bet)



PokerStars Zoom Hand #257558068842:  Hold'em No Limit (€0.01/€0.02) - 2025/08/31 18:02:55 CET [2025/08/31 12:02:55 ET]
Table 'Arneb' 6-max Seat #1 is the button
Seat 1: cuenca10 (€2.26 in chips) 
Seat 2: maximus_powah (€5.60 in chips) 
Seat 3: monsieur881 (€1.68 in chips) 
Seat 4: orosa (€3.92 in chips) 
Seat 5: pipinoelbreve9 (€2.01 in chips) 
Seat 6: marcosbalsaa (€3.58 in chips) 
maximus_powah: posts small blind €0.01
monsieur881: posts big blind €0.02
*** HOLE CARDS ***
Dealt to pipinoelbreve9 [Jd 6c]
orosa: folds 
pipinoelbreve9: folds 
marcosbalsaa: folds 
cuenca10: folds 
maximus_powah: raises €0.04 to €0.06
monsieur881: folds 
Uncalled bet (€0.04) returned to maximus_powah
maximus_powah collected €0.04 from pot
maximus_powah: doesn't show hand 
*** SUMMARY ***
Total pot €0.04 | Rake €0 
Seat 1: cuenca10 (button) folded before Flop (didn't bet)
Seat 2: maximus_powah (small blind) collected (€0.04)
Seat 3: monsieur881 (big blind) folded before Flop
Seat 4: orosa folded before Flop (didn't bet)
Seat 5: pipinoelbreve9 folded before Flop (didn't bet)
Seat 6: marcosbalsaa folded before Flop (didn't bet)



PokerStars Zoom Hand #257558702914:  Hold'em No Limit (€0.01/€0.02) - 2025/08/31 18:47:37 CET [2025/08/31 12:47:37 ET]
Table 'Arneb' 6-max Seat #1 is the button
Seat 1: BestiaESP12 (€2.10 in chips) 
Seat 2: McMack626 (€1.98 in chips) 
Seat 3: pipinoelbreve9 (€2 in chips) 
Seat 4: masquisiera (€1.02 in chips) 
Seat 5: DeividBox980 (€0.97 in chips) 
Seat 6: bud7413 (€1 in chips) 
McMack626: posts small blind €0.01
pipinoelbreve9: posts big blind €0.02
*** HOLE CARDS ***
Dealt to pipinoelbreve9 [2c 8s]
masquisiera: folds 
DeividBox980: folds 
bud7413: raises €0.02 to €0.04
BestiaESP12: folds 
McMack626: folds 
pipinoelbreve9: folds 
Uncalled bet (€0.02) returned to bud7413
bud7413 collected €0.05 from pot
bud7413: doesn't show hand 
*** SUMMARY ***
Total pot €0.05 | Rake €0 
Seat 1: BestiaESP12 (button) folded before Flop (didn't bet)
Seat 2: McMack626 (small blind) folded before Flop
Seat 3: pipinoelbreve9 (big blind) folded before Flop
Seat 4: masquisiera folded before Flop (didn't bet)
Seat 5: DeividBox980 folded before Flop (didn't bet)
Seat 6: bud7413 collected (€0.05)



PokerStars Zoom Hand #257558706003:  Hold'em No Limit (€0.01/€0.02) - 2025/08/31 18:47:50 CET [2025/08/31 12:47:50 ET]
Table 'Arneb' 6-max Seat #1 is the button
Seat 1: pipinoelbreve9 (€2 in chips) 
Seat 2: joaninha124 (€1.73 in chips) 
Seat 3: DeividBox980 (€0.97 in chips) 
Seat 4: pokerikb (€2.01 in chips) 
Seat 5: losi10 (€0.97 in chips) 
Seat 6: McMack626 (€1.95 in chips) 
joaninha124: posts small blind €0.01
DeividBox980: posts big blind €0.02
*** HOLE CARDS ***
Dealt to pipinoelbreve9 [7c Qc]
pokerikb: folds 
losi10: calls €0.02
McMack626: raises €0.02 to €0.04
pipinoelbreve9: calls €0.04
joaninha124: calls €0.03
DeividBox980: folds 
losi10: calls €0.02
*** FLOP *** [6c Js Qd]
joaninha124: checks 
losi10: bets €0.04
McMack626: calls €0.04
pipinoelbreve9: calls €0.04
joaninha124: calls €0.04
*** TURN *** [6c Js Qd] [6s]
joaninha124 has timed out
joaninha124: checks 
losi10: bets €0.04
McMack626: calls €0.04
pipinoelbreve9: raises €0.22 to €0.26
joaninha124: folds 
losi10: folds 
McMack626: calls €0.22
*** RIVER *** [6c Js Qd 6s] [Ad]
McMack626: checks 
pipinoelbreve9: checks 
*** SHOW DOWN ***
McMack626: shows [4s As] (two pair, Aces and Sixes)
pipinoelbreve9: mucks hand 
McMack626 collected €0.86 from pot
*** SUMMARY ***
Total pot €0.90 | Rake €0.04 
Board [6c Js Qd 6s Ad]
Seat 1: pipinoelbreve9 (button) mucked [7c Qc]
Seat 2: joaninha124 (small blind) folded on the Turn
Seat 3: DeividBox980 (big blind) folded before Flop
Seat 4: pokerikb folded before Flop (didn't bet)
Seat 5: losi10 folded on the Turn
Seat 6: McMack626 showed [4s As] and won (€0.86) with two pair, Aces and Sixes



PokerStars Zoom Hand #257558725280:  Hold'em No Limit (€0.01/€0.02) - 2025/08/31 18:49:11 CET [2025/08/31 12:49:11 ET]
Table 'Arneb' 6-max Seat #1 is the button
Seat 1: AnxoGM (€3.77 in chips) 
Seat 2: pipinoelbreve9 (€2 in chips) 
Seat 3: madn1994 (€1.23 in chips) 
Seat 4: 34pluto (€1.90 in chips) 
Seat 5: lorocontento (€1.22 in chips) 
Seat 6: FELIPE439 (€2.36 in chips) 
pipinoelbreve9: posts small blind €0.01
madn1994: posts big blind €0.02
*** HOLE CARDS ***
Dealt to pipinoelbreve9 [Tc Jh]
34pluto: folds 
lorocontento: folds 
FELIPE439: folds 
AnxoGM: folds 
pipinoelbreve9: raises €0.04 to €0.06
madn1994: calls €0.04
*** FLOP *** [Qs Qd 3h]
pipinoelbreve9: checks 
madn1994: bets €0.10
pipinoelbreve9: calls €0.10
*** TURN *** [Qs Qd 3h] [Ks]
pipinoelbreve9: bets €0.15
madn1994: raises €0.92 to €1.07 and is all-in
pipinoelbreve9: folds 
Uncalled bet (€0.92) returned to madn1994
madn1994 collected €0.59 from pot
madn1994: doesn't show hand 
*** SUMMARY ***
Total pot €0.62 | Rake €0.03 
Board [Qs Qd 3h Ks]
Seat 1: AnxoGM (button) folded before Flop (didn't bet)
Seat 2: pipinoelbreve9 (small blind) folded on the Turn
Seat 3: madn1994 (big blind) collected (€0.59)
Seat 4: 34pluto folded before Flop (didn't bet)
Seat 5: lorocontento folded before Flop (didn't bet)
Seat 6: FELIPE439 folded before Flop (didn't bet)



PokerStars Zoom Hand #257558738328:  Hold'em No Limit (€0.01/€0.02) - 2025/08/31 18:50:05 CET [2025/08/31 12:50:05 ET]
Table 'Arneb' 6-max Seat #1 is the button
Seat 1: makiavel02 (€1.94 in chips) 
Seat 2: kaou35 (€1.98 in chips) 
Seat 3: FELIPE439 (€2.35 in chips) 
Seat 4: marcosbalsaa (€3.93 in chips) 
Seat 5: pipinoelbreve9 (€2 in chips) 
Seat 6: migueldep10 (€2.22 in chips) 
kaou35: posts small blind €0.01
FELIPE439: posts big blind €0.02
*** HOLE CARDS ***
Dealt to pipinoelbreve9 [Kh Jc]
marcosbalsaa: folds 
pipinoelbreve9: raises €0.04 to €0.06
migueldep10: raises €0.14 to €0.20
makiavel02: calls €0.20
kaou35: folds 
FELIPE439: folds 
pipinoelbreve9: calls €0.14
*** FLOP *** [7s Kd 8c]
pipinoelbreve9: checks 
migueldep10: bets €0.45
makiavel02: calls €0.45
pipinoelbreve9: calls €0.45
*** TURN *** [7s Kd 8c] [Ac]
pipinoelbreve9: checks 
migueldep10: checks 
makiavel02: bets €0.76
pipinoelbreve9: folds 
migueldep10: folds 
Uncalled bet (€0.76) returned to makiavel02
makiavel02 collected €1.88 from pot
makiavel02: doesn't show hand 
*** SUMMARY ***
Total pot €1.98 | Rake €0.10 
Board [7s Kd 8c Ac]
Seat 1: makiavel02 (button) collected (€1.88)
Seat 2: kaou35 (small blind) folded before Flop
Seat 3: FELIPE439 (big blind) folded before Flop
Seat 4: marcosbalsaa folded before Flop (didn't bet)
Seat 5: pipinoelbreve9 folded on the Turn
Seat 6: migueldep10 folded on the Turn



PokerStars Zoom Hand #257558736611:  Hold'em No Limit (€0.01/€0.02) - 2025/08/31 18:49:58 CET [2025/08/31 12:49:58 ET]
Table 'Arneb' 6-max Seat #1 is the button
Seat 1: Korver K (€3.68 in chips) 
Seat 2: fernan_282t (€0.90 in chips) 
Seat 3: 34pluto (€1.96 in chips) 
Seat 4: vayewis (€2.38 in chips) 
Seat 5: McMack626 (€0.66 in chips) 
Seat 6: pipinoelbreve9 (€2 in chips) 
fernan_282t: posts small blind €0.01
34pluto: posts big blind €0.02
*** HOLE CARDS ***
Dealt to pipinoelbreve9 [Ts 4c]
vayewis has timed out
vayewis: folds 
McMack626: raises €0.02 to €0.04
pipinoelbreve9: folds 
Korver K: folds 
McMack626 is disconnected 
fernan_282t: calls €0.03
34pluto: calls €0.02
*** FLOP *** [Ah 9d 6s]
fernan_282t: checks 
34pluto: bets €0.06
McMack626 has timed out while disconnected
McMack626: folds 
fernan_282t: folds 
Uncalled bet (€0.06) returned to 34pluto
34pluto collected €0.11 from pot
34pluto: doesn't show hand 
*** SUMMARY ***
Total pot €0.12 | Rake €0.01 
Board [Ah 9d 6s]
Seat 1: Korver K (button) folded before Flop (didn't bet)
Seat 2: fernan_282t (small blind) folded on the Flop
Seat 3: 34pluto (big blind) collected (€0.11)
Seat 4: vayewis folded before Flop (didn't bet)
Seat 5: McMack626 folded on the Flop
Seat 6: pipinoelbreve9 folded before Flop (didn't bet)



PokerStars Zoom Hand #257558751674:  Hold'em No Limit (€0.01/€0.02) - 2025/08/31 18:51:01 CET [2025/08/31 12:51:01 ET]
Table 'Arneb' 6-max Seat #1 is the button
Seat 1: Korver K (€3.59 in chips) 
Seat 2: candarias (€1.20 in chips) 
Seat 3: VEGAMAR (€2.28 in chips) 
Seat 4: FELIPE439 (€2.32 in chips) 
Seat 5: pipinoelbreve9 (€2 in chips) 
Seat 6: Apdwins (€2 in chips) 
candarias: posts small blind €0.01
VEGAMAR: posts big blind €0.02
*** HOLE CARDS ***
Dealt to pipinoelbreve9 [5c Td]
FELIPE439: folds 
pipinoelbreve9: folds 
Apdwins: folds 
Korver K: folds 
candarias: folds 
Uncalled bet (€0.01) returned to VEGAMAR
VEGAMAR collected €0.02 from pot
VEGAMAR: doesn't show hand 
*** SUMMARY ***
Total pot €0.02 | Rake €0 
Seat 1: Korver K (button) folded before Flop (didn't bet)
Seat 2: candarias (small blind) folded before Flop
Seat 3: VEGAMAR (big blind) collected (€0.02)
Seat 4: FELIPE439 folded before Flop (didn't bet)
Seat 5: pipinoelbreve9 folded before Flop (didn't bet)
Seat 6: Apdwins folded before Flop (didn't bet)



PokerStars Zoom Hand #257558753068:  Hold'em No Limit (€0.01/€0.02) - 2025/08/31 18:51:07 CET [2025/08/31 12:51:07 ET]
Table 'Arneb' 6-max Seat #1 is the button
Seat 1: fernan_282t (€0.86 in chips) 
Seat 2: odace15 (€2.26 in chips) 
Seat 3: pipinoelbreve9 (€2 in chips) 
Seat 4: FELIPE439 (€2.32 in chips) 
Seat 5: 34pluto (€1.96 in chips) 
Seat 6: greggs63 (€3.93 in chips) 
odace15: posts small blind €0.01
pipinoelbreve9: posts big blind €0.02
*** HOLE CARDS ***
Dealt to pipinoelbreve9 [Kd 9h]
FELIPE439: folds 
34pluto: folds 
greggs63: raises €0.02 to €0.04
fernan_282t: folds 
odace15: folds 
pipinoelbreve9: calls €0.02
*** FLOP *** [Ah 3s Qs]
pipinoelbreve9: checks 
greggs63: checks 
*** TURN *** [Ah 3s Qs] [3c]
pipinoelbreve9: checks 
greggs63: checks 
*** RIVER *** [Ah 3s Qs 3c] [6d]
pipinoelbreve9: checks 
greggs63: checks 
*** SHOW DOWN ***
pipinoelbreve9: shows [Kd 9h] (a pair of Threes)
greggs63: shows [Kh 7s] (a pair of Threes)
pipinoelbreve9 collected €0.05 from pot
greggs63 collected €0.04 from pot
*** SUMMARY ***
Total pot €0.09 | Rake €0 
Board [Ah 3s Qs 3c 6d]
Seat 1: fernan_282t (button) folded before Flop (didn't bet)
Seat 2: odace15 (small blind) folded before Flop
Seat 3: pipinoelbreve9 (big blind) showed [Kd 9h] and won (€0.05) with a pair of Threes
Seat 4: FELIPE439 folded before Flop (didn't bet)
Seat 5: 34pluto folded before Flop (didn't bet)
Seat 6: greggs63 showed [Kh 7s] and won (€0.04) with a pair of Threes



PokerStars Zoom Hand #257558763446:  Hold'em No Limit (€0.01/€0.02) - 2025/08/31 18:51:51 CET [2025/08/31 12:51:51 ET]
Table 'Arneb' 6-max Seat #1 is the button
Seat 1: Älejo (€2.06 in chips) 
Seat 2: Bad_Tripss (€2 in chips) 
Seat 3: RamsDios (€3.66 in chips) 
Seat 4: pipinoelbreve9 (€2.01 in chips) 
Seat 5: LAROSA74 (€2.54 in chips) 
Seat 6: AnxoGM (€4.03 in chips) 
Bad_Tripss: posts small blind €0.01
RamsDios: posts big blind €0.02
*** HOLE CARDS ***
Dealt to pipinoelbreve9 [Kh 2s]
pipinoelbreve9: folds 
LAROSA74: folds 
AnxoGM: folds 
Älejo: folds 
Bad_Tripss: folds 
Uncalled bet (€0.01) returned to RamsDios
RamsDios collected €0.02 from pot
RamsDios: doesn't show hand 
*** SUMMARY ***
Total pot €0.02 | Rake €0 
Seat 1: Älejo (button) folded before Flop (didn't bet)
Seat 2: Bad_Tripss (small blind) folded before Flop
Seat 3: RamsDios (big blind) collected (€0.02)
Seat 4: pipinoelbreve9 folded before Flop (didn't bet)
Seat 5: LAROSA74 folded before Flop (didn't bet)
Seat 6: AnxoGM folded before Flop (didn't bet)



PokerStars Zoom Hand #257558765035:  Hold'em No Limit (€0.01/€0.02) - 2025/08/31 18:51:58 CET [2025/08/31 12:51:58 ET]
Table 'Arneb' 6-max Seat #1 is the button
Seat 1: pipinoelbreve9 (€2.01 in chips) 
Seat 2: AnxoGM (€4.03 in chips) 
Seat 3: cruass (€2 in chips) 
Seat 4: lorocontento (€1.11 in chips) 
Seat 5: anflo13 (€3.38 in chips) 
Seat 6: Desmd72 (€1.52 in chips) 
AnxoGM: posts small blind €0.01
cruass: posts big blind €0.02
*** HOLE CARDS ***
Dealt to pipinoelbreve9 [Kh 7h]
lorocontento: folds 
anflo13: folds 
Desmd72: folds 
pipinoelbreve9: raises €0.04 to €0.06
AnxoGM: folds 
cruass: calls €0.04
*** FLOP *** [Ah Ac 5h]
cruass: checks 
pipinoelbreve9: checks 
*** TURN *** [Ah Ac 5h] [Td]
cruass: checks 
pipinoelbreve9: bets €0.06
cruass: folds 
Uncalled bet (€0.06) returned to pipinoelbreve9
pipinoelbreve9 collected €0.12 from pot
pipinoelbreve9: doesn't show hand 
*** SUMMARY ***
Total pot €0.13 | Rake €0.01 
Board [Ah Ac 5h Td]
Seat 1: pipinoelbreve9 (button) collected (€0.12)
Seat 2: AnxoGM (small blind) folded before Flop
Seat 3: cruass (big blind) folded on the Turn
Seat 4: lorocontento folded before Flop (didn't bet)
Seat 5: anflo13 folded before Flop (didn't bet)
Seat 6: Desmd72 folded before Flop (didn't bet)



PokerStars Zoom Hand #257558772578:  Hold'em No Limit (€0.01/€0.02) - 2025/08/31 18:52:29 CET [2025/08/31 12:52:29 ET]
Table 'Arneb' 6-max Seat #1 is the button
Seat 1: Fulcrumm (€1.18 in chips) 
Seat 2: pipinoelbreve9 (€2.07 in chips) 
Seat 3: andresrodr8 (€2.28 in chips) 
Seat 4: AnxoGM (€5.30 in chips) 
Seat 5: cuenca10 (€2.25 in chips) 
Seat 6: 34pluto (€1.73 in chips) 
pipinoelbreve9: posts small blind €0.01
andresrodr8: posts big blind €0.02
*** HOLE CARDS ***
Dealt to pipinoelbreve9 [Qh 8s]
AnxoGM: raises €0.03 to €0.05
cuenca10: folds 
34pluto: folds 
Fulcrumm: folds 
pipinoelbreve9: calls €0.04
andresrodr8: folds 
*** FLOP *** [5s Js Ah]
pipinoelbreve9: checks 
AnxoGM: checks 
*** TURN *** [5s Js Ah] [As]
pipinoelbreve9: checks 
AnxoGM: checks 
*** RIVER *** [5s Js Ah As] [Ks]
pipinoelbreve9: bets €0.06
AnxoGM: calls €0.06
*** SHOW DOWN ***
pipinoelbreve9: shows [Qh 8s] (a flush, Ace high)
AnxoGM: mucks hand 
pipinoelbreve9 collected €0.23 from pot
*** SUMMARY ***
Total pot €0.24 | Rake €0.01 
Board [5s Js Ah As Ks]
Seat 1: Fulcrumm (button) folded before Flop (didn't bet)
Seat 2: pipinoelbreve9 (small blind) showed [Qh 8s] and won (€0.23) with a flush, Ace high
Seat 3: andresrodr8 (big blind) folded before Flop
Seat 4: AnxoGM mucked [Jc Kh]
Seat 5: cuenca10 folded before Flop (didn't bet)
Seat 6: 34pluto folded before Flop (didn't bet)



PokerStars Zoom Hand #257558781749:  Hold'em No Limit (€0.01/€0.02) - 2025/08/31 18:53:08 CET [2025/08/31 12:53:08 ET]
Table 'Arneb' 6-max Seat #1 is the button
Seat 1: migueldep10 (€2.08 in chips) 
Seat 2: AnxoGM (€5.19 in chips) 
Seat 3: janjos69 (€2.37 in chips) 
Seat 4: VEGAMAR (€2.03 in chips) 
Seat 5: stag999 (€1.36 in chips) 
Seat 6: pipinoelbreve9 (€2.19 in chips) 
AnxoGM: posts small blind €0.01
janjos69: posts big blind €0.02
*** HOLE CARDS ***
Dealt to pipinoelbreve9 [Jd Qc]
VEGAMAR: folds 
stag999: folds 
pipinoelbreve9: raises €0.04 to €0.06
migueldep10: raises €0.14 to €0.20
AnxoGM: folds 
janjos69: folds 
pipinoelbreve9: calls €0.14
*** FLOP *** [Jc 8d 2d]
pipinoelbreve9: bets €0.21
migueldep10: folds 
Uncalled bet (€0.21) returned to pipinoelbreve9
pipinoelbreve9 collected €0.41 from pot
pipinoelbreve9: doesn't show hand 
*** SUMMARY ***
Total pot €0.43 | Rake €0.02 
Board [Jc 8d 2d]
Seat 1: migueldep10 (button) folded on the Flop
Seat 2: AnxoGM (small blind) folded before Flop
Seat 3: janjos69 (big blind) folded before Flop
Seat 4: VEGAMAR folded before Flop (didn't bet)
Seat 5: stag999 folded before Flop (didn't bet)
Seat 6: pipinoelbreve9 collected (€0.41)



PokerStars Zoom Hand #257558789520:  Hold'em No Limit (€0.01/€0.02) - 2025/08/31 18:53:40 CET [2025/08/31 12:53:40 ET]
Table 'Arneb' 6-max Seat #1 is the button
Seat 1: VEGAMAR (€2.10 in chips) 
Seat 2: MagicGitox (€2.44 in chips) 
Seat 3: TIOGUY7 (€1 in chips) 
Seat 4: 34pluto (€1.70 in chips) 
Seat 5: pipinoelbreve9 (€2.40 in chips) 
Seat 6: PrendsCa (€2 in chips) 
MagicGitox: posts small blind €0.01
TIOGUY7: posts big blind €0.02
*** HOLE CARDS ***
Dealt to pipinoelbreve9 [2d Kd]
34pluto: folds 
pipinoelbreve9: folds 
PrendsCa: folds 
VEGAMAR: folds 
MagicGitox: raises €0.04 to €0.06
TIOGUY7: folds 
Uncalled bet (€0.04) returned to MagicGitox
MagicGitox collected €0.04 from pot
MagicGitox: doesn't show hand 
*** SUMMARY ***
Total pot €0.04 | Rake €0 
Seat 1: VEGAMAR (button) folded before Flop (didn't bet)
Seat 2: MagicGitox (small blind) collected (€0.04)
Seat 3: TIOGUY7 (big blind) folded before Flop
Seat 4: 34pluto folded before Flop (didn't bet)
Seat 5: pipinoelbreve9 folded before Flop (didn't bet)
Seat 6: PrendsCa folded before Flop (didn't bet)



PokerStars Zoom Hand #257558791245:  Hold'em No Limit (€0.01/€0.02) - 2025/08/31 18:53:47 CET [2025/08/31 12:53:47 ET]
Table 'Arneb' 6-max Seat #1 is the button
Seat 1: odace15 (€2 in chips) 
Seat 2: FELIPE439 (€2.38 in chips) 
Seat 3: migueldep10 (€1.41 in chips) 
Seat 4: PrendsCa (€2 in chips) 
Seat 5: XxVallesxX (€2.34 in chips) 
Seat 6: pipinoelbreve9 (€2.40 in chips) 
FELIPE439: posts small blind €0.01
migueldep10: posts big blind €0.02
*** HOLE CARDS ***
Dealt to pipinoelbreve9 [3h 4h]
PrendsCa: folds 
XxVallesxX: folds 
pipinoelbreve9: raises €0.08 to €0.10
odace15: folds 
FELIPE439: folds 
migueldep10: folds 
Uncalled bet (€0.08) returned to pipinoelbreve9
pipinoelbreve9 collected €0.05 from pot
pipinoelbreve9: doesn't show hand 
*** SUMMARY ***
Total pot €0.05 | Rake €0 
Seat 1: odace15 (button) folded before Flop (didn't bet)
Seat 2: FELIPE439 (small blind) folded before Flop
Seat 3: migueldep10 (big blind) folded before Flop
Seat 4: PrendsCa folded before Flop (didn't bet)
Seat 5: XxVallesxX folded before Flop (didn't bet)
Seat 6: pipinoelbreve9 collected (€0.05)



PokerStars Zoom Hand #257558795860:  Hold'em No Limit (€0.01/€0.02) - 2025/08/31 18:54:07 CET [2025/08/31 12:54:07 ET]
Table 'Arneb' 6-max Seat #1 is the button
Seat 1: stag999 (€1.41 in chips) 
Seat 2: andresrodr8 (€2.22 in chips) 
Seat 3: pipinoelbreve9 (€2.43 in chips) 
Seat 4: Älejo (€2.12 in chips) 
Seat 5: Bad_Tripss (€2.03 in chips) 
Seat 6: marcosbalsaa (€2.94 in chips) 
andresrodr8: posts small blind €0.01
pipinoelbreve9: posts big blind €0.02
*** HOLE CARDS ***
Dealt to pipinoelbreve9 [6c Qc]
Älejo: folds 
Bad_Tripss: folds 
marcosbalsaa: folds 
stag999: raises €0.04 to €0.06
andresrodr8: folds 
pipinoelbreve9: calls €0.04
*** FLOP *** [9c Jh 3s]
pipinoelbreve9: checks 
stag999: bets €0.06
pipinoelbreve9: folds 
Uncalled bet (€0.06) returned to stag999
stag999 collected €0.12 from pot
stag999: doesn't show hand 
*** SUMMARY ***
Total pot €0.13 | Rake €0.01 
Board [9c Jh 3s]
Seat 1: stag999 (button) collected (€0.12)
Seat 2: andresrodr8 (small blind) folded before Flop
Seat 3: pipinoelbreve9 (big blind) folded on the Flop
Seat 4: Älejo folded before Flop (didn't bet)
Seat 5: Bad_Tripss folded before Flop (didn't bet)
Seat 6: marcosbalsaa folded before Flop (didn't bet)



PokerStars Zoom Hand #257558802886:  Hold'em No Limit (€0.01/€0.02) - 2025/08/31 18:54:36 CET [2025/08/31 12:54:36 ET]
Table 'Arneb' 6-max Seat #1 is the button
Seat 1: marcosbalsaa (€4.32 in chips) 
Seat 2: Apdwins (€1.51 in chips) 
Seat 3: VEGAMAR (€2.31 in chips) 
Seat 4: pipinoelbreve9 (€2.37 in chips) 
Seat 5: McMack626 (€3.97 in chips) 
Seat 6: XxVallesxX (€2.31 in chips) 
Apdwins: posts small blind €0.01
VEGAMAR: posts big blind €0.02
*** HOLE CARDS ***
Dealt to pipinoelbreve9 [4s 2h]
pipinoelbreve9: folds 
McMack626: raises €0.02 to €0.04
XxVallesxX: folds 
marcosbalsaa: folds 
Apdwins: folds 
VEGAMAR: calls €0.02
*** FLOP *** [Ac 4c 8d]
VEGAMAR: checks 
McMack626: bets €0.02
VEGAMAR: folds 
Uncalled bet (€0.02) returned to McMack626
McMack626 collected €0.09 from pot
McMack626: doesn't show hand 
*** SUMMARY ***
Total pot €0.09 | Rake €0 
Board [Ac 4c 8d]
Seat 1: marcosbalsaa (button) folded before Flop (didn't bet)
Seat 2: Apdwins (small blind) folded before Flop
Seat 3: VEGAMAR (big blind) folded on the Flop
Seat 4: pipinoelbreve9 folded before Flop (didn't bet)
Seat 5: McMack626 collected (€0.09)
Seat 6: XxVallesxX folded before Flop (didn't bet)



PokerStars Zoom Hand #257558804812:  Hold'em No Limit (€0.01/€0.02) - 2025/08/31 18:54:44 CET [2025/08/31 12:54:44 ET]
Table 'Arneb' 6-max Seat #1 is the button
Seat 1: Bilintx703 (€2.64 in chips) 
Seat 2: pipinoelbreve9 (€2.37 in chips) 
Seat 3: vayewis (€2.55 in chips) 
Seat 4: laprimera65 (€2.06 in chips) 
Seat 5: julsau81 (€1.86 in chips) 
Seat 6: Bad_Tripss (€2.13 in chips) 
pipinoelbreve9: posts small blind €0.01
vayewis: posts big blind €0.02
*** HOLE CARDS ***
Dealt to pipinoelbreve9 [Qd 9d]
laprimera65: folds 
julsau81: folds 
Bad_Tripss: raises €0.03 to €0.05
Bilintx703: folds 
pipinoelbreve9: calls €0.04
vayewis: folds 
*** FLOP *** [3c Tc 7c]
pipinoelbreve9: checks 
Bad_Tripss: bets €0.06
pipinoelbreve9: folds 
Uncalled bet (€0.06) returned to Bad_Tripss
Bad_Tripss collected €0.11 from pot
Bad_Tripss: doesn't show hand 
*** SUMMARY ***
Total pot €0.12 | Rake €0.01 
Board [3c Tc 7c]
Seat 1: Bilintx703 (button) folded before Flop (didn't bet)
Seat 2: pipinoelbreve9 (small blind) folded on the Flop
Seat 3: vayewis (big blind) folded before Flop
Seat 4: laprimera65 folded before Flop (didn't bet)
Seat 5: julsau81 folded before Flop (didn't bet)
Seat 6: Bad_Tripss collected (€0.11)



PokerStars Zoom Hand #257558811658:  Hold'em No Limit (€0.01/€0.02) - 2025/08/31 18:55:17 CET [2025/08/31 12:55:17 ET]
Table 'Arneb' 6-max Seat #1 is the button
Seat 1: pipinoelbreve9 (€2.32 in chips) 
Seat 2: Uvildo (€0.73 in chips) 
Seat 3: andresrodr8 (€2 in chips) 
Seat 4: Gginer2812 (€3.20 in chips) 
Seat 5: VEGAMAR (€2.26 in chips) 
Seat 6: ppequess (€0.54 in chips) 
Uvildo: posts small blind €0.01
andresrodr8: posts big blind €0.02
*** HOLE CARDS ***
Dealt to pipinoelbreve9 [6s Jh]
Gginer2812: folds 
VEGAMAR: folds 
ppequess: folds 
pipinoelbreve9: folds 
Uvildo: raises €0.71 to €0.73 and is all-in
andresrodr8: calls €0.71
*** FLOP *** [3c 4h Jd]
*** TURN *** [3c 4h Jd] [Td]
*** RIVER *** [3c 4h Jd Td] [4s]
*** SHOW DOWN ***
Uvildo: shows [Kc Kd] (two pair, Kings and Fours)
andresrodr8: shows [Ah As] (two pair, Aces and Fours)
andresrodr8 collected €1.39 from pot
*** SUMMARY ***
Total pot €1.46 | Rake €0.07 
Board [3c 4h Jd Td 4s]
Seat 1: pipinoelbreve9 (button) folded before Flop (didn't bet)
Seat 2: Uvildo (small blind) showed [Kc Kd] and lost with two pair, Kings and Fours
Seat 3: andresrodr8 (big blind) showed [Ah As] and won (€1.39) with two pair, Aces and Fours
Seat 4: Gginer2812 folded before Flop (didn't bet)
Seat 5: VEGAMAR folded before Flop (didn't bet)
Seat 6: ppequess folded before Flop (didn't bet)



PokerStars Zoom Hand #257558812160:  Hold'em No Limit (€0.01/€0.02) - 2025/08/31 18:55:20 CET [2025/08/31 12:55:20 ET]
Table 'Arneb' 6-max Seat #1 is the button
Seat 1: McMack626 (€2.27 in chips) 
Seat 2: PrendsCa (€2 in chips) 
Seat 3: laprimera65 (€2 in chips) 
Seat 4: pipinoelbreve9 (€2.32 in chips) 
Seat 5: DeividBox980 (€0.89 in chips) 
Seat 6: VEGAMAR (€2 in chips) 
PrendsCa: posts small blind €0.01
laprimera65: posts big blind €0.02
*** HOLE CARDS ***
Dealt to pipinoelbreve9 [9h Kd]
pipinoelbreve9: folds 
DeividBox980: folds 
VEGAMAR: folds 
McMack626: folds 
PrendsCa: folds 
Uncalled bet (€0.01) returned to laprimera65
laprimera65 collected €0.02 from pot
laprimera65: doesn't show hand 
*** SUMMARY ***
Total pot €0.02 | Rake €0 
Seat 1: McMack626 (button) folded before Flop (didn't bet)
Seat 2: PrendsCa (small blind) folded before Flop
Seat 3: laprimera65 (big blind) collected (€0.02)
Seat 4: pipinoelbreve9 folded before Flop (didn't bet)
Seat 5: DeividBox980 folded before Flop (didn't bet)
Seat 6: VEGAMAR folded before Flop (didn't bet)



PokerStars Zoom Hand #257558814032:  Hold'em No Limit (€0.01/€0.02) - 2025/08/31 18:55:34 CET [2025/08/31 12:55:34 ET]
Table 'Arneb' 6-max Seat #1 is the button
Seat 1: Choonchas (€1.28 in chips) 
Seat 2: tonid00kie (€2.79 in chips) 
Seat 3: candarias (€2.31 in chips) 
Seat 4: cruass (€1.82 in chips) 
Seat 5: pipinoelbreve9 (€2.32 in chips) 
Seat 6: madn1994 (€1.72 in chips) 
tonid00kie: posts small blind €0.01
candarias: posts big blind €0.02
*** HOLE CARDS ***
Dealt to pipinoelbreve9 [2d Jh]
cruass: folds 
pipinoelbreve9: folds 
madn1994: folds 
Choonchas: folds 
tonid00kie: folds 
Uncalled bet (€0.01) returned to candarias
candarias collected €0.02 from pot
candarias: doesn't show hand 
*** SUMMARY ***
Total pot €0.02 | Rake €0 
Seat 1: Choonchas (button) folded before Flop (didn't bet)
Seat 2: tonid00kie (small blind) folded before Flop
Seat 3: candarias (big blind) collected (€0.02)
Seat 4: cruass folded before Flop (didn't bet)
Seat 5: pipinoelbreve9 folded before Flop (didn't bet)
Seat 6: madn1994 folded before Flop (didn't bet)



PokerStars Zoom Hand #257558812894:  Hold'em No Limit (€0.01/€0.02) - 2025/08/31 18:55:26 CET [2025/08/31 12:55:26 ET]
Table 'Arneb' 6-max Seat #1 is the button
Seat 1: JacobSinger01 (€1.91 in chips) 
Seat 2: TIOGUY7 (€0.92 in chips) 
Seat 3: VEGAMAR (€2 in chips) 
Seat 4: kaou35 (€1.77 in chips) 
Seat 5: migueldep10 (€1.67 in chips) 
Seat 6: pipinoelbreve9 (€2.32 in chips) 
TIOGUY7: posts small blind €0.01
VEGAMAR: posts big blind €0.02
*** HOLE CARDS ***
Dealt to pipinoelbreve9 [8s Ad]
kaou35: raises €0.05 to €0.07
migueldep10: folds 
pipinoelbreve9: folds 
JacobSinger01: folds 
TIOGUY7: folds 
VEGAMAR: folds 
Uncalled bet (€0.05) returned to kaou35
kaou35 collected €0.05 from pot
kaou35: doesn't show hand 
*** SUMMARY ***
Total pot €0.05 | Rake €0 
Seat 1: JacobSinger01 (button) folded before Flop (didn't bet)
Seat 2: TIOGUY7 (small blind) folded before Flop
Seat 3: VEGAMAR (big blind) folded before Flop
Seat 4: kaou35 collected (€0.05)
Seat 5: migueldep10 folded before Flop (didn't bet)
Seat 6: pipinoelbreve9 folded before Flop (didn't bet)



PokerStars Zoom Hand #257558814665:  Hold'em No Limit (€0.01/€0.02) - 2025/08/31 18:55:38 CET [2025/08/31 12:55:38 ET]
Table 'Arneb' 6-max Seat #1 is the button
Seat 1: tonid00kie (€2.78 in chips) 
Seat 2: VEGAMAR (€2 in chips) 
Seat 3: pipinoelbreve9 (€2.32 in chips) 
Seat 4: madn1994 (€1.72 in chips) 
Seat 5: 34pluto (€1.43 in chips) 
Seat 6: cruass (€1.82 in chips) 
VEGAMAR: posts small blind €0.01
pipinoelbreve9: posts big blind €0.02
*** HOLE CARDS ***
Dealt to pipinoelbreve9 [9c Js]
madn1994: calls €0.02
34pluto: folds 
cruass: folds 
tonid00kie: raises €0.02 to €0.04
VEGAMAR: folds 
pipinoelbreve9: calls €0.02
madn1994: calls €0.02
*** FLOP *** [Kd 9h 9d]
pipinoelbreve9: checks 
madn1994: checks 
tonid00kie: bets €0.06
pipinoelbreve9: calls €0.06
madn1994: folds 
*** TURN *** [Kd 9h 9d] [2s]
pipinoelbreve9: checks 
tonid00kie: bets €0.08
pipinoelbreve9: calls €0.08
*** RIVER *** [Kd 9h 9d 2s] [2h]
pipinoelbreve9: bets €0.39
tonid00kie: folds 
Uncalled bet (€0.39) returned to pipinoelbreve9
pipinoelbreve9 collected €0.39 from pot
pipinoelbreve9: doesn't show hand 
*** SUMMARY ***
Total pot €0.41 | Rake €0.02 
Board [Kd 9h 9d 2s 2h]
Seat 1: tonid00kie (button) folded on the River
Seat 2: VEGAMAR (small blind) folded before Flop
Seat 3: pipinoelbreve9 (big blind) collected (€0.39)
Seat 4: madn1994 folded on the Flop
Seat 5: 34pluto folded before Flop (didn't bet)
Seat 6: cruass folded before Flop (didn't bet)



PokerStars Zoom Hand #257558823328:  Hold'em No Limit (€0.01/€0.02) - 2025/08/31 18:56:40 CET [2025/08/31 12:56:40 ET]
Table 'Arneb' 6-max Seat #1 is the button
Seat 1: pakk84o (€1.44 in chips) 
Seat 2: pipinoelbreve9 (€2.53 in chips) 
Seat 3: andresrodr8 (€2.15 in chips) 
Seat 4: kaou35 (€1.65 in chips) 
Seat 5: tonid00kie (€2.60 in chips) 
Seat 6: vayewis (€2.03 in chips) 
pipinoelbreve9: posts small blind €0.01
andresrodr8: posts big blind €0.02
*** HOLE CARDS ***
Dealt to pipinoelbreve9 [8c 9d]
pakk84o is disconnected 
kaou35: folds 
tonid00kie: raises €0.02 to €0.04
vayewis: folds 
pakk84o has timed out while disconnected
pakk84o: folds 
pipinoelbreve9: folds 
andresrodr8: folds 
Uncalled bet (€0.02) returned to tonid00kie
tonid00kie collected €0.05 from pot
tonid00kie: doesn't show hand 
*** SUMMARY ***
Total pot €0.05 | Rake €0 
Seat 1: pakk84o (button) folded before Flop (didn't bet)
Seat 2: pipinoelbreve9 (small blind) folded before Flop
Seat 3: andresrodr8 (big blind) folded before Flop
Seat 4: kaou35 folded before Flop (didn't bet)
Seat 5: tonid00kie collected (€0.05)
Seat 6: vayewis folded before Flop (didn't bet)



PokerStars Zoom Hand #257558824818:  Hold'em No Limit (€0.01/€0.02) - 2025/08/31 18:56:51 CET [2025/08/31 12:56:51 ET]
Table 'Arneb' 6-max Seat #1 is the button
Seat 1: pipinoelbreve9 (€2.52 in chips) 
Seat 2: AnxoGM (€4.66 in chips) 
Seat 3: DeividBox980 (€0.89 in chips) 
Seat 4: VEGAMAR (€2.23 in chips) 
Seat 5: 34pluto (€1.40 in chips) 
Seat 6: McMack626 (€2.42 in chips) 
AnxoGM: posts small blind €0.01
DeividBox980: posts big blind €0.02
*** HOLE CARDS ***
Dealt to pipinoelbreve9 [Qs Th]
VEGAMAR: raises €0.04 to €0.06
34pluto: folds 
McMack626: folds 
pipinoelbreve9: calls €0.06
AnxoGM: folds 
DeividBox980: folds 
*** FLOP *** [8c 5c 4h]
VEGAMAR: checks 
pipinoelbreve9: checks 
*** TURN *** [8c 5c 4h] [9s]
VEGAMAR: checks 
pipinoelbreve9: bets €0.04
VEGAMAR: raises €0.13 to €0.17
pipinoelbreve9: folds 
Uncalled bet (€0.13) returned to VEGAMAR
VEGAMAR collected €0.22 from pot
VEGAMAR: doesn't show hand 
*** SUMMARY ***
Total pot €0.23 | Rake €0.01 
Board [8c 5c 4h 9s]
Seat 1: pipinoelbreve9 (button) folded on the Turn
Seat 2: AnxoGM (small blind) folded before Flop
Seat 3: DeividBox980 (big blind) folded before Flop
Seat 4: VEGAMAR collected (€0.22)
Seat 5: 34pluto folded before Flop (didn't bet)
Seat 6: McMack626 folded before Flop (didn't bet)



PokerStars Zoom Hand #257558830226:  Hold'em No Limit (€0.01/€0.02) - 2025/08/31 18:57:29 CET [2025/08/31 12:57:29 ET]
Table 'Arneb' 6-max Seat #1 is the button
Seat 1: pipinoelbreve9 (€2.42 in chips) 
Seat 2: elfi450 (€1.96 in chips) 
Seat 3: PetroniloPT (€1.52 in chips) 
Seat 4: 34pluto (€1.41 in chips) 
Seat 5: Uvildo (€0.36 in chips) 
Seat 6: spain229 (€0.98 in chips) 
elfi450: posts small blind €0.01
PetroniloPT: posts big blind €0.02
*** HOLE CARDS ***
Dealt to pipinoelbreve9 [2h 6s]
34pluto: folds 
Uvildo: folds 
spain229: folds 
pipinoelbreve9: folds 
elfi450: raises €0.04 to €0.06
PetroniloPT: folds 
Uncalled bet (€0.04) returned to elfi450
elfi450 collected €0.04 from pot
elfi450: doesn't show hand 
*** SUMMARY ***
Total pot €0.04 | Rake €0 
Seat 1: pipinoelbreve9 (button) folded before Flop (didn't bet)
Seat 2: elfi450 (small blind) collected (€0.04)
Seat 3: PetroniloPT (big blind) folded before Flop
Seat 4: 34pluto folded before Flop (didn't bet)
Seat 5: Uvildo folded before Flop (didn't bet)
Seat 6: spain229 folded before Flop (didn't bet)



PokerStars Zoom Hand #257558830985:  Hold'em No Limit (€0.01/€0.02) - 2025/08/31 18:57:34 CET [2025/08/31 12:57:34 ET]
Table 'Arneb' 6-max Seat #1 is the button
Seat 1: BestiaESP12 (€2 in chips) 
Seat 2: TIOGUY7 (€0.87 in chips) 
Seat 3: andresrodr8 (€3.83 in chips) 
Seat 4: anflo13 (€1.39 in chips) 
Seat 5: HGrenha (€0.32 in chips) 
Seat 6: pipinoelbreve9 (€2.42 in chips) 
TIOGUY7: posts small blind €0.01
andresrodr8: posts big blind €0.02
*** HOLE CARDS ***
Dealt to pipinoelbreve9 [5d Kd]
anflo13: folds 
HGrenha: raises €0.30 to €0.32 and is all-in
pipinoelbreve9: folds 
BestiaESP12: folds 
TIOGUY7: folds 
andresrodr8: calls €0.30
*** FLOP *** [Jc Ad 6d]
*** TURN *** [Jc Ad 6d] [8d]
*** RIVER *** [Jc Ad 6d 8d] [Qc]
*** SHOW DOWN ***
andresrodr8: shows [Kh As] (a pair of Aces)
HGrenha: shows [7h 4c] (high card Ace)
andresrodr8 collected €0.62 from pot
*** SUMMARY ***
Total pot €0.65 | Rake €0.03 
Board [Jc Ad 6d 8d Qc]
Seat 1: BestiaESP12 (button) folded before Flop (didn't bet)
Seat 2: TIOGUY7 (small blind) folded before Flop
Seat 3: andresrodr8 (big blind) showed [Kh As] and won (€0.62) with a pair of Aces
Seat 4: anflo13 folded before Flop (didn't bet)
Seat 5: HGrenha showed [7h 4c] and lost with high card Ace
Seat 6: pipinoelbreve9 folded before Flop (didn't bet)



PokerStars Zoom Hand #257558834621:  Hold'em No Limit (€0.01/€0.02) - 2025/08/31 18:58:00 CET [2025/08/31 12:58:00 ET]
Table 'Arneb' 6-max Seat #1 is the button
Seat 1: julsau81 (€1.18 in chips) 
Seat 2: BestiaESP12 (€2.13 in chips) 
Seat 3: pipinoelbreve9 (€2.42 in chips) 
Seat 4: FELIPE439 (€4.43 in chips) 
Seat 5: marcdevil (€2.03 in chips) 
Seat 6: losi10 (€0.84 in chips) 
BestiaESP12: posts small blind €0.01
pipinoelbreve9: posts big blind €0.02
*** HOLE CARDS ***
Dealt to pipinoelbreve9 [3c Jd]
FELIPE439: folds 
marcdevil: folds 
losi10: folds 
julsau81: raises €0.03 to €0.05
BestiaESP12: folds 
pipinoelbreve9: folds 
Uncalled bet (€0.03) returned to julsau81
julsau81 collected €0.05 from pot
julsau81: doesn't show hand 
*** SUMMARY ***
Total pot €0.05 | Rake €0 
Seat 1: julsau81 (button) collected (€0.05)
Seat 2: BestiaESP12 (small blind) folded before Flop
Seat 3: pipinoelbreve9 (big blind) folded before Flop
Seat 4: FELIPE439 folded before Flop (didn't bet)
Seat 5: marcdevil folded before Flop (didn't bet)
Seat 6: losi10 folded before Flop (didn't bet)



PokerStars Zoom Hand #257558833234:  Hold'em No Limit (€0.01/€0.02) - 2025/08/31 18:57:50 CET [2025/08/31 12:57:50 ET]
Table 'Arneb' 6-max Seat #1 is the button
Seat 1: TIOGUY7 (€0.85 in chips) 
Seat 2: bud7413 (€1.63 in chips) 
Seat 3: masquisiera (€1.07 in chips) 
Seat 4: candarias (€0.98 in chips) 
Seat 5: pipinoelbreve9 (€2.42 in chips) 
Seat 6: JacobSinger01 (€1.76 in chips) 
bud7413: posts small blind €0.01
masquisiera: posts big blind €0.02
*** HOLE CARDS ***
Dealt to pipinoelbreve9 [2h Ks]
candarias: folds 
pipinoelbreve9: folds 
JacobSinger01: raises €0.04 to €0.06
TIOGUY7: folds 
bud7413: calls €0.05
masquisiera: folds 
*** FLOP *** [7h 3s 3h]
bud7413: checks 
JacobSinger01: checks 
*** TURN *** [7h 3s 3h] [Qc]
bud7413: bets €0.07
JacobSinger01: calls €0.07
*** RIVER *** [7h 3s 3h Qc] [7d]
bud7413: bets €0.14
JacobSinger01: calls €0.14
*** SHOW DOWN ***
bud7413: shows [Qh 8d] (two pair, Queens and Sevens)
JacobSinger01: shows [Qd Ad] (two pair, Queens and Sevens - Ace kicker)
JacobSinger01 collected €0.53 from pot
*** SUMMARY ***
Total pot €0.56 | Rake €0.03 
Board [7h 3s 3h Qc 7d]
Seat 1: TIOGUY7 (button) folded before Flop (didn't bet)
Seat 2: bud7413 (small blind) showed [Qh 8d] and lost with two pair, Queens and Sevens
Seat 3: masquisiera (big blind) folded before Flop
Seat 4: candarias folded before Flop (didn't bet)
Seat 5: pipinoelbreve9 folded before Flop (didn't bet)
Seat 6: JacobSinger01 showed [Qd Ad] and won (€0.53) with two pair, Queens and Sevens



PokerStars Zoom Hand #257558836307:  Hold'em No Limit (€0.01/€0.02) - 2025/08/31 18:58:12 CET [2025/08/31 12:58:12 ET]
Table 'Arneb' 6-max Seat #1 is the button
Seat 1: TIOGUY7 (€0.86 in chips) 
Seat 2: pipinoelbreve9 (€2.40 in chips) 
Seat 3: candarias (€0.98 in chips) 
Seat 4: RamsDios (€3.84 in chips) 
Seat 5: cruass (€1.88 in chips) 
Seat 6: laprimera65 (€2.01 in chips) 
pipinoelbreve9: posts small blind €0.01
candarias: posts big blind €0.02
*** HOLE CARDS ***
Dealt to pipinoelbreve9 [8h 9c]
RamsDios: folds 
cruass: raises €0.02 to €0.04
laprimera65: folds 
TIOGUY7: folds 
pipinoelbreve9: folds 
candarias: folds 
Uncalled bet (€0.02) returned to cruass
cruass collected €0.05 from pot
cruass: doesn't show hand 
*** SUMMARY ***
Total pot €0.05 | Rake €0 
Seat 1: TIOGUY7 (button) folded before Flop (didn't bet)
Seat 2: pipinoelbreve9 (small blind) folded before Flop
Seat 3: candarias (big blind) folded before Flop
Seat 4: RamsDios folded before Flop (didn't bet)
Seat 5: cruass collected (€0.05)
Seat 6: laprimera65 folded before Flop (didn't bet)



PokerStars Zoom Hand #257558837022:  Hold'em No Limit (€0.01/€0.02) - 2025/08/31 18:58:17 CET [2025/08/31 12:58:17 ET]
Table 'Arneb' 6-max Seat #1 is the button
Seat 1: BestiaESP12 (€2 in chips) 
Seat 2: ZixZ596 (€0.93 in chips) 
Seat 3: HGrenha (€2.03 in chips) 
Seat 4: laprimera65 (€2.01 in chips) 
Seat 5: pipinoelbreve9 (€2.39 in chips) 
Seat 6: TIOGUY7 (€0.86 in chips) 
ZixZ596: posts small blind €0.01
HGrenha: posts big blind €0.02
*** HOLE CARDS ***
Dealt to pipinoelbreve9 [5c 5h]
laprimera65: folds 
pipinoelbreve9: raises €0.04 to €0.06
TIOGUY7: folds 
BestiaESP12: raises €0.12 to €0.18
ZixZ596: folds 
HGrenha: raises €1.52 to €1.70
pipinoelbreve9: folds 
BestiaESP12: folds 
Uncalled bet (€1.52) returned to HGrenha
HGrenha collected €0.43 from pot
HGrenha: doesn't show hand 
*** SUMMARY ***
Total pot €0.43 | Rake €0 
Seat 1: BestiaESP12 (button) folded before Flop
Seat 2: ZixZ596 (small blind) folded before Flop
Seat 3: HGrenha (big blind) collected (€0.43)
Seat 4: laprimera65 folded before Flop (didn't bet)
Seat 5: pipinoelbreve9 folded before Flop
Seat 6: TIOGUY7 folded before Flop (didn't bet)



PokerStars Zoom Hand #257558840309:  Hold'em No Limit (€0.01/€0.02) - 2025/08/31 18:58:40 CET [2025/08/31 12:58:40 ET]
Table 'Arneb' 6-max Seat #1 is the button
Seat 1: kaou35 (€2.39 in chips) 
Seat 2: andresrodr8 (€4.08 in chips) 
Seat 3: MagicGitox (€2.94 in chips) 
Seat 4: pipinoelbreve9 (€2.33 in chips) 
Seat 5: Fulcrumm (€2.75 in chips) 
Seat 6: 34pluto (€1.65 in chips) 
andresrodr8: posts small blind €0.01
MagicGitox: posts big blind €0.02
*** HOLE CARDS ***
Dealt to pipinoelbreve9 [Jc As]
pipinoelbreve9: raises €0.04 to €0.06
Fulcrumm: folds 
34pluto: folds 
kaou35: folds 
andresrodr8: folds 
MagicGitox: calls €0.04
*** FLOP *** [6d 6h Ks]
MagicGitox: checks 
pipinoelbreve9: checks 
*** TURN *** [6d 6h Ks] [7d]
MagicGitox: bets €0.06
pipinoelbreve9: calls €0.06
*** RIVER *** [6d 6h Ks 7d] [9s]
MagicGitox: checks 
pipinoelbreve9: checks 
*** SHOW DOWN ***
MagicGitox: shows [Ad 4d] (a pair of Sixes)
pipinoelbreve9: shows [Jc As] (a pair of Sixes - Ace+King+Jack kicker)
pipinoelbreve9 collected €0.24 from pot
*** SUMMARY ***
Total pot €0.25 | Rake €0.01 
Board [6d 6h Ks 7d 9s]
Seat 1: kaou35 (button) folded before Flop (didn't bet)
Seat 2: andresrodr8 (small blind) folded before Flop
Seat 3: MagicGitox (big blind) showed [Ad 4d] and lost with a pair of Sixes
Seat 4: pipinoelbreve9 showed [Jc As] and won (€0.24) with a pair of Sixes
Seat 5: Fulcrumm folded before Flop (didn't bet)
Seat 6: 34pluto folded before Flop (didn't bet)



PokerStars Zoom Hand #257558839738:  Hold'em No Limit (€0.01/€0.02) - 2025/08/31 18:58:36 CET [2025/08/31 12:58:36 ET]
Table 'Arneb' 6-max Seat #1 is the button
Seat 1: marcosbalsaa (€4.64 in chips) 
Seat 2: fernan_282t (€1.10 in chips) 
Seat 3: candarias (€2.06 in chips) 
Seat 4: pipinoelbreve9 (€2.33 in chips) 
Seat 5: andresrodr8 (€4.08 in chips) 
Seat 6: FELIPE439 (€4.40 in chips) 
fernan_282t: posts small blind €0.01
candarias: posts big blind €0.02
*** HOLE CARDS ***
Dealt to pipinoelbreve9 [Ks 4s]
pipinoelbreve9: folds 
andresrodr8: folds 
FELIPE439: raises €0.04 to €0.06
marcosbalsaa: folds 
fernan_282t: folds 
candarias: raises €0.13 to €0.19
FELIPE439: calls €0.13
*** FLOP *** [2d 9s 8s]
candarias: checks 
FELIPE439: bets €0.37
candarias: folds 
Uncalled bet (€0.37) returned to FELIPE439
FELIPE439 collected €0.37 from pot
FELIPE439: doesn't show hand 
*** SUMMARY ***
Total pot €0.39 | Rake €0.02 
Board [2d 9s 8s]
Seat 1: marcosbalsaa (button) folded before Flop (didn't bet)
Seat 2: fernan_282t (small blind) folded before Flop
Seat 3: candarias (big blind) folded on the Flop
Seat 4: pipinoelbreve9 folded before Flop (didn't bet)
Seat 5: andresrodr8 folded before Flop (didn't bet)
Seat 6: FELIPE439 collected (€0.37)



PokerStars Zoom Hand #257558845272:  Hold'em No Limit (€0.01/€0.02) - 2025/08/31 18:59:15 CET [2025/08/31 12:59:15 ET]
Table 'Arneb' 6-max Seat #1 is the button
Seat 1: pipinoelbreve9 (€2.45 in chips) 
Seat 2: odace15 (€2.01 in chips) 
Seat 3: andresrodr8 (€2.69 in chips) 
Seat 4: VEGAMAR (€2 in chips) 
Seat 5: marcdevil (€2 in chips) 
Seat 6: candarias (€1.87 in chips) 
odace15: posts small blind €0.01
andresrodr8: posts big blind €0.02
*** HOLE CARDS ***
Dealt to pipinoelbreve9 [Jc 4h]
VEGAMAR: folds 
marcdevil: folds 
candarias: folds 
pipinoelbreve9: folds 
odace15: folds 
Uncalled bet (€0.01) returned to andresrodr8
andresrodr8 collected €0.02 from pot
andresrodr8: doesn't show hand 
*** SUMMARY ***
Total pot €0.02 | Rake €0 
Seat 1: pipinoelbreve9 (button) folded before Flop (didn't bet)
Seat 2: odace15 (small blind) folded before Flop
Seat 3: andresrodr8 (big blind) collected (€0.02)
Seat 4: VEGAMAR folded before Flop (didn't bet)
Seat 5: marcdevil folded before Flop (didn't bet)
Seat 6: candarias folded before Flop (didn't bet)



PokerStars Zoom Hand #257558846764:  Hold'em No Limit (€0.01/€0.02) - 2025/08/31 18:59:25 CET [2025/08/31 12:59:25 ET]
Table 'Arneb' 6-max Seat #1 is the button
Seat 1: Choonchas (€1.94 in chips) 
Seat 2: booster74 (€2 in chips) 
Seat 3: pipinoelbreve9 (€2.45 in chips) 
Seat 4: candarias (€1.87 in chips) 
Seat 5: FELIPE439 (€4.58 in chips) 
Seat 6: andresrodr8 (€4.01 in chips) 
booster74: posts small blind €0.01
pipinoelbreve9: posts big blind €0.02
*** HOLE CARDS ***
Dealt to pipinoelbreve9 [8c Jd]
candarias: folds 
FELIPE439: folds 
andresrodr8: raises €0.02 to €0.04
Choonchas: raises €0.14 to €0.18
booster74: folds 
pipinoelbreve9: folds 
andresrodr8: calls €0.14
*** FLOP *** [Kc 5c 4d]
andresrodr8: checks 
Choonchas: checks 
*** TURN *** [Kc 5c 4d] [4s]
andresrodr8: bets €0.12
Choonchas: folds 
Uncalled bet (€0.12) returned to andresrodr8
andresrodr8 collected €0.37 from pot
andresrodr8: doesn't show hand 
*** SUMMARY ***
Total pot €0.39 | Rake €0.02 
Board [Kc 5c 4d 4s]
Seat 1: Choonchas (button) folded on the Turn
Seat 2: booster74 (small blind) folded before Flop
Seat 3: pipinoelbreve9 (big blind) folded before Flop
Seat 4: candarias folded before Flop (didn't bet)
Seat 5: FELIPE439 folded before Flop (didn't bet)
Seat 6: andresrodr8 collected (€0.37)



PokerStars Zoom Hand #257558849374:  Hold'em No Limit (€0.01/€0.02) - 2025/08/31 18:59:43 CET [2025/08/31 12:59:43 ET]
Table 'Arneb' 6-max Seat #1 is the button
Seat 1: marcdevil (€2 in chips) 
Seat 2: pipinoelbreve9 (€2.43 in chips) 
Seat 3: janjos69 (€1.19 in chips) 
Seat 4: odace15 (€2 in chips) 
Seat 5: madn1994 (€1.58 in chips) 
Seat 6: FELIPE439 (€6.11 in chips) 
pipinoelbreve9: posts small blind €0.01
janjos69: posts big blind €0.02
*** HOLE CARDS ***
Dealt to pipinoelbreve9 [Ac 2d]
odace15: folds 
madn1994: folds 
FELIPE439: folds 
marcdevil: folds 
pipinoelbreve9: raises €0.04 to €0.06
janjos69: calls €0.04
*** FLOP *** [3h 6c Js]
pipinoelbreve9: checks 
janjos69: checks 
*** TURN *** [3h 6c Js] [8h]
pipinoelbreve9: checks 
janjos69: checks 
*** RIVER *** [3h 6c Js 8h] [2h]
pipinoelbreve9: bets €0.06
janjos69: folds 
Uncalled bet (€0.06) returned to pipinoelbreve9
pipinoelbreve9 collected €0.11 from pot
pipinoelbreve9: doesn't show hand 
*** SUMMARY ***
Total pot €0.12 | Rake €0.01 
Board [3h 6c Js 8h 2h]
Seat 1: marcdevil (button) folded before Flop (didn't bet)
Seat 2: pipinoelbreve9 (small blind) collected (€0.11)
Seat 3: janjos69 (big blind) folded on the River
Seat 4: odace15 folded before Flop (didn't bet)
Seat 5: madn1994 folded before Flop (didn't bet)
Seat 6: FELIPE439 folded before Flop (didn't bet)



PokerStars Zoom Hand #257558846219:  Hold'em No Limit (€0.01/€0.02) - 2025/08/31 18:59:21 CET [2025/08/31 12:59:21 ET]
Table 'Arneb' 6-max Seat #1 is the button
Seat 1: psr47770102 (€0.98 in chips) 
Seat 2: McMack626 (€1.76 in chips) 
Seat 3: AIexiito (€0.49 in chips) 
Seat 4: RamsDios (€4 in chips) 
Seat 5: stag999 (€0.89 in chips) 
Seat 6: pipinoelbreve9 (€2.45 in chips) 
McMack626: posts small blind €0.01
AIexiito: posts big blind €0.02
*** HOLE CARDS ***
Dealt to pipinoelbreve9 [5c 8d]
RamsDios has timed out
RamsDios: folds 
stag999: folds 
pipinoelbreve9: folds 
psr47770102: calls €0.02
McMack626: calls €0.01
AIexiito: checks 
*** FLOP *** [Js 2c Qd]
McMack626: checks 
AIexiito: checks 
psr47770102: checks 
*** TURN *** [Js 2c Qd] [As]
McMack626: bets €0.02
AIexiito: calls €0.02
psr47770102: calls €0.02
*** RIVER *** [Js 2c Qd As] [3h]
McMack626: checks 
AIexiito: checks 
psr47770102: checks 
*** SHOW DOWN ***
McMack626: shows [4c 4s] (a pair of Fours)
AIexiito: shows [6h Jd] (a pair of Jacks)
psr47770102: mucks hand 
AIexiito collected €0.11 from pot
*** SUMMARY ***
Total pot €0.12 | Rake €0.01 
Board [Js 2c Qd As 3h]
Seat 1: psr47770102 (button) mucked [9c Tc]
Seat 2: McMack626 (small blind) showed [4c 4s] and lost with a pair of Fours
Seat 3: AIexiito (big blind) showed [6h Jd] and won (€0.11) with a pair of Jacks
Seat 4: RamsDios folded before Flop (didn't bet)
Seat 5: stag999 folded before Flop (didn't bet)
Seat 6: pipinoelbreve9 folded before Flop (didn't bet)



PokerStars Zoom Hand #257558854787:  Hold'em No Limit (€0.01/€0.02) - 2025/08/31 19:00:21 CET [2025/08/31 13:00:21 ET]
Table 'Arneb' 6-max Seat #1 is the button
Seat 1: 34pluto (€1.97 in chips) 
Seat 2: andresrodr8 (€2.70 in chips) 
Seat 3: candarias (€0.92 in chips) 
Seat 4: pipinoelbreve9 (€2.48 in chips) 
Seat 5: SLUSMYMXPT (€1.72 in chips) 
Seat 6: kaou35 (€3.05 in chips) 
andresrodr8: posts small blind €0.01
candarias: posts big blind €0.02
*** HOLE CARDS ***
Dealt to pipinoelbreve9 [2c 8c]
pipinoelbreve9: folds 
SLUSMYMXPT: folds 
kaou35: folds 
34pluto has timed out
34pluto: folds 
andresrodr8: folds 
Uncalled bet (€0.01) returned to candarias
candarias collected €0.02 from pot
candarias: doesn't show hand 
*** SUMMARY ***
Total pot €0.02 | Rake €0 
Seat 1: 34pluto (button) folded before Flop (didn't bet)
Seat 2: andresrodr8 (small blind) folded before Flop
Seat 3: candarias (big blind) collected (€0.02)
Seat 4: pipinoelbreve9 folded before Flop (didn't bet)
Seat 5: SLUSMYMXPT folded before Flop (didn't bet)
Seat 6: kaou35 folded before Flop (didn't bet)



PokerStars Zoom Hand #257558855431:  Hold'em No Limit (€0.01/€0.02) - 2025/08/31 19:00:26 CET [2025/08/31 13:00:26 ET]
Table 'Arneb' 6-max Seat #1 is the button
Seat 1: pipinoelbreve9 (€2.48 in chips) 
Seat 2: kaou35 (€2.58 in chips) 
Seat 3: masquisiera (€1.15 in chips) 
Seat 4: Bad_Tripss (€2.65 in chips) 
Seat 5: janjos69 (€1.12 in chips) 
Seat 6: vayewis (€2.17 in chips) 
kaou35: posts small blind €0.01
masquisiera: posts big blind €0.02
*** HOLE CARDS ***
Dealt to pipinoelbreve9 [3h 6c]
Bad_Tripss: folds 
janjos69: folds 
vayewis: folds 
pipinoelbreve9: folds 
kaou35: folds 
Uncalled bet (€0.01) returned to masquisiera
masquisiera collected €0.02 from pot
masquisiera: doesn't show hand 
*** SUMMARY ***
Total pot €0.02 | Rake €0 
Seat 1: pipinoelbreve9 (button) folded before Flop (didn't bet)
Seat 2: kaou35 (small blind) folded before Flop
Seat 3: masquisiera (big blind) collected (€0.02)
Seat 4: Bad_Tripss folded before Flop (didn't bet)
Seat 5: janjos69 folded before Flop (didn't bet)
Seat 6: vayewis folded before Flop (didn't bet)



PokerStars Zoom Hand #257558856494:  Hold'em No Limit (€0.01/€0.02) - 2025/08/31 19:00:32 CET [2025/08/31 13:00:32 ET]
Table 'Arneb' 6-max Seat #1 is the button
Seat 1: SLUSMYMXPT (€1.72 in chips) 
Seat 2: Fulcrumm (€2.79 in chips) 
Seat 3: marcosbalsaa (€2.74 in chips) 
Seat 4: Uvildo (€0.79 in chips) 
Seat 5: McMack626 (€1.72 in chips) 
Seat 6: pipinoelbreve9 (€2.48 in chips) 
Fulcrumm: posts small blind €0.01
marcosbalsaa: posts big blind €0.02
*** HOLE CARDS ***
Dealt to pipinoelbreve9 [3d 4d]
Uvildo: folds 
McMack626: raises €0.02 to €0.04
pipinoelbreve9: raises €0.10 to €0.14
SLUSMYMXPT has timed out
SLUSMYMXPT: folds 
Fulcrumm: folds 
marcosbalsaa: folds 
McMack626: folds 
Uncalled bet (€0.10) returned to pipinoelbreve9
pipinoelbreve9 collected €0.11 from pot
pipinoelbreve9: doesn't show hand 
*** SUMMARY ***
Total pot €0.11 | Rake €0 
Seat 1: SLUSMYMXPT (button) folded before Flop (didn't bet)
Seat 2: Fulcrumm (small blind) folded before Flop
Seat 3: marcosbalsaa (big blind) folded before Flop
Seat 4: Uvildo folded before Flop (didn't bet)
Seat 5: McMack626 folded before Flop
Seat 6: pipinoelbreve9 collected (€0.11)



PokerStars Zoom Hand #257558863588:  Hold'em No Limit (€0.01/€0.02) - 2025/08/31 19:01:14 CET [2025/08/31 13:01:14 ET]
Table 'Arneb' 6-max Seat #1 is the button
Seat 1: andresrodr8 (€4.16 in chips) 
Seat 2: Älejo (€2.24 in chips) 
Seat 3: YordyMcD (€2 in chips) 
Seat 4: FELIPE439 (€4.53 in chips) 
Seat 5: pipinoelbreve9 (€2.55 in chips) 
Seat 6: critsio (€0.69 in chips) 
Älejo: posts small blind €0.01
YordyMcD: posts big blind €0.02
*** HOLE CARDS ***
Dealt to pipinoelbreve9 [5c Ac]
FELIPE439: folds 
pipinoelbreve9: raises €0.04 to €0.06
critsio: calls €0.06
andresrodr8: folds 
Älejo: folds 
YordyMcD: folds 
*** FLOP *** [9h 6s 6h]
pipinoelbreve9: checks 
critsio: checks 
*** TURN *** [9h 6s 6h] [7h]
pipinoelbreve9: checks 
critsio: checks 
*** RIVER *** [9h 6s 6h 7h] [Jh]
pipinoelbreve9: checks 
critsio: checks 
*** SHOW DOWN ***
pipinoelbreve9: shows [5c Ac] (a pair of Sixes)
critsio: mucks hand 
pipinoelbreve9 collected €0.14 from pot
*** SUMMARY ***
Total pot €0.15 | Rake €0.01 
Board [9h 6s 6h 7h Jh]
Seat 1: andresrodr8 (button) folded before Flop (didn't bet)
Seat 2: Älejo (small blind) folded before Flop
Seat 3: YordyMcD (big blind) folded before Flop
Seat 4: FELIPE439 folded before Flop (didn't bet)
Seat 5: pipinoelbreve9 showed [5c Ac] and won (€0.14) with a pair of Sixes
Seat 6: critsio mucked [Qd Ts]



PokerStars Zoom Hand #257558870946:  Hold'em No Limit (€0.01/€0.02) - 2025/08/31 19:01:51 CET [2025/08/31 13:01:51 ET]
Table 'Arneb' 6-max Seat #1 is the button
Seat 1: ZoasHein (€2.96 in chips) 
Seat 2: Apdwins (€1.70 in chips) 
Seat 3: pipinoelbreve9 (€2.63 in chips) 
Seat 4: ZixZ596 (€0.38 in chips) 
Seat 5: critsio (€0.63 in chips) 
Seat 6: AIexiito (€0.59 in chips) 
Apdwins: posts small blind €0.01
pipinoelbreve9: posts big blind €0.02
*** HOLE CARDS ***
Dealt to pipinoelbreve9 [Jh 5c]
ZixZ596 has timed out
ZixZ596: folds 
critsio: folds 
AIexiito has timed out
AIexiito: folds 
ZoasHein: folds 
Apdwins: raises €0.02 to €0.04
pipinoelbreve9: folds 
Uncalled bet (€0.02) returned to Apdwins
Apdwins collected €0.04 from pot
Apdwins: doesn't show hand 
*** SUMMARY ***
Total pot €0.04 | Rake €0 
Seat 1: ZoasHein (button) folded before Flop (didn't bet)
Seat 2: Apdwins (small blind) collected (€0.04)
Seat 3: pipinoelbreve9 (big blind) folded before Flop
Seat 4: ZixZ596 folded before Flop (didn't bet)
Seat 5: critsio folded before Flop (didn't bet)
Seat 6: AIexiito folded before Flop (didn't bet)



PokerStars Zoom Hand #257558877426:  Hold'em No Limit (€0.01/€0.02) - 2025/08/31 19:02:23 CET [2025/08/31 13:02:23 ET]
Table 'Arneb' 6-max Seat #1 is the button
Seat 1: bud7413 (€1.47 in chips) 
Seat 2: andresrodr8 (€2.49 in chips) 
Seat 3: Bad_Tripss (€2.62 in chips) 
Seat 4: ppequess (€0.34 in chips) 
Seat 5: pipinoelbreve9 (€2.61 in chips) 
Seat 6: YordyMcD (€2.14 in chips) 
andresrodr8: posts small blind €0.01
Bad_Tripss: posts big blind €0.02
*** HOLE CARDS ***
Dealt to pipinoelbreve9 [2c 6s]
ppequess: raises €0.04 to €0.06
pipinoelbreve9: folds 
YordyMcD: folds 
bud7413: folds 
andresrodr8: folds 
Bad_Tripss: calls €0.04
*** FLOP *** [2s 5s Kd]
Bad_Tripss: checks 
ppequess: checks 
*** TURN *** [2s 5s Kd] [9h]
Bad_Tripss: checks 
ppequess: checks 
*** RIVER *** [2s 5s Kd 9h] [Ks]
Bad_Tripss: checks 
ppequess: checks 
*** SHOW DOWN ***
Bad_Tripss: shows [Jh Ts] (a pair of Kings)
ppequess: shows [Th Js] (a pair of Kings)
Bad_Tripss collected €0.06 from pot
ppequess collected €0.06 from pot
*** SUMMARY ***
Total pot €0.13 | Rake €0.01 
Board [2s 5s Kd 9h Ks]
Seat 1: bud7413 (button) folded before Flop (didn't bet)
Seat 2: andresrodr8 (small blind) folded before Flop
Seat 3: Bad_Tripss (big blind) showed [Jh Ts] and won (€0.06) with a pair of Kings
Seat 4: ppequess showed [Th Js] and won (€0.06) with a pair of Kings
Seat 5: pipinoelbreve9 folded before Flop (didn't bet)
Seat 6: YordyMcD folded before Flop (didn't bet)



PokerStars Zoom Hand #257558878864:  Hold'em No Limit (€0.01/€0.02) - 2025/08/31 19:02:30 CET [2025/08/31 13:02:30 ET]
Table 'Arneb' 6-max Seat #1 is the button
Seat 1: Fulcrumm (€2.69 in chips) 
Seat 2: pipinoelbreve9 (€2.61 in chips) 
Seat 3: VEGAMAR (€2.08 in chips) 
Seat 4: AIexiito (€0.59 in chips) 
Seat 5: Choonchas (€1.42 in chips) 
Seat 6: 34pluto (€1.90 in chips) 
pipinoelbreve9: posts small blind €0.01
VEGAMAR: posts big blind €0.02
*** HOLE CARDS ***
Dealt to pipinoelbreve9 [Ah Kc]
AIexiito: folds 
Choonchas: raises €0.03 to €0.05
34pluto: folds 
Fulcrumm: calls €0.05
pipinoelbreve9: raises €0.25 to €0.30
VEGAMAR: folds 
Choonchas: raises €0.25 to €0.55
Fulcrumm: folds 
pipinoelbreve9: raises €2.06 to €2.61 and is all-in
Choonchas: calls €0.87 and is all-in
Uncalled bet (€1.19) returned to pipinoelbreve9
*** FLOP *** [7c 9c 7h]
*** TURN *** [7c 9c 7h] [Kd]
*** RIVER *** [7c 9c 7h Kd] [Ad]
*** SHOW DOWN ***
pipinoelbreve9: shows [Ah Kc] (two pair, Aces and Kings)
Choonchas: shows [As Qs] (two pair, Aces and Sevens)
pipinoelbreve9 collected €2.76 from pot
*** SUMMARY ***
Total pot €2.91 | Rake €0.15 
Board [7c 9c 7h Kd Ad]
Seat 1: Fulcrumm (button) folded before Flop
Seat 2: pipinoelbreve9 (small blind) showed [Ah Kc] and won (€2.76) with two pair, Aces and Kings
Seat 3: VEGAMAR (big blind) folded before Flop
Seat 4: AIexiito folded before Flop (didn't bet)
Seat 5: Choonchas showed [As Qs] and lost with two pair, Aces and Sevens
Seat 6: 34pluto folded before Flop (didn't bet)



PokerStars Zoom Hand #257558889553:  Hold'em No Limit (€0.01/€0.02) - 2025/08/31 19:03:15 CET [2025/08/31 13:03:15 ET]
Table 'Arneb' 6-max Seat #1 is the button
Seat 1: AIexiito (€0.59 in chips) 
Seat 2: kratitos10 (€2.01 in chips) 
Seat 3: cheminot83 (€0.93 in chips) 
Seat 4: pipinoelbreve9 (€3.95 in chips) 
Seat 5: fernan_282t (€0.96 in chips) 
Seat 6: 34pluto (€1.39 in chips) 
kratitos10: posts small blind €0.01
cheminot83: posts big blind €0.02
*** HOLE CARDS ***
Dealt to pipinoelbreve9 [4d Tc]
pipinoelbreve9: folds 
fernan_282t: folds 
34pluto: raises €0.02 to €0.04
AIexiito: folds 
kratitos10: folds 
cheminot83: calls €0.02
*** FLOP *** [Qd Ac 5s]
cheminot83: checks 
34pluto: checks 
*** TURN *** [Qd Ac 5s] [2c]
cheminot83: checks 
34pluto: checks 
*** RIVER *** [Qd Ac 5s 2c] [9h]
cheminot83: checks 
34pluto: checks 
*** SHOW DOWN ***
cheminot83: shows [Ts 4h] (high card Ace)
34pluto: shows [Jh Js] (a pair of Jacks)
34pluto collected €0.09 from pot
*** SUMMARY ***
Total pot €0.09 | Rake €0 
Board [Qd Ac 5s 2c 9h]
Seat 1: AIexiito (button) folded before Flop (didn't bet)
Seat 2: kratitos10 (small blind) folded before Flop
Seat 3: cheminot83 (big blind) showed [Ts 4h] and lost with high card Ace
Seat 4: pipinoelbreve9 folded before Flop (didn't bet)
Seat 5: fernan_282t folded before Flop (didn't bet)
Seat 6: 34pluto showed [Jh Js] and won (€0.09) with a pair of Jacks



PokerStars Zoom Hand #257558891747:  Hold'em No Limit (€0.01/€0.02) - 2025/08/31 19:03:25 CET [2025/08/31 13:03:25 ET]
Table 'Arneb' 6-max Seat #1 is the button
Seat 1: Manuxanxe78 (€2 in chips) 
Seat 2: XxVallesxX (€2.04 in chips) 
Seat 3: McMack626 (€1.88 in chips) 
Seat 4: pipinoelbreve9 (€3.95 in chips) 
Seat 5: maximus_powah (€5.26 in chips) 
Seat 6: kratitos10 (€2 in chips) 
XxVallesxX: posts small blind €0.01
McMack626: posts big blind €0.02
*** HOLE CARDS ***
Dealt to pipinoelbreve9 [Qs 3s]
pipinoelbreve9: folds 
maximus_powah: folds 
kratitos10: folds 
Manuxanxe78: folds 
XxVallesxX: folds 
Uncalled bet (€0.01) returned to McMack626
McMack626 collected €0.02 from pot
McMack626: doesn't show hand 
*** SUMMARY ***
Total pot €0.02 | Rake €0 
Seat 1: Manuxanxe78 (button) folded before Flop (didn't bet)
Seat 2: XxVallesxX (small blind) folded before Flop
Seat 3: McMack626 (big blind) collected (€0.02)
Seat 4: pipinoelbreve9 folded before Flop (didn't bet)
Seat 5: maximus_powah folded before Flop (didn't bet)
Seat 6: kratitos10 folded before Flop (didn't bet)



PokerStars Zoom Hand #257558890325:  Hold'em No Limit (€0.01/€0.02) - 2025/08/31 19:03:18 CET [2025/08/31 13:03:18 ET]
Table 'Arneb' 6-max Seat #1 is the button
Seat 1: Desmd72 (€2.13 in chips) 
Seat 2: Manuxanxe78 (€2 in chips) 
Seat 3: vayewis (€3.23 in chips) 
Seat 4: fernan_282t (€0.96 in chips) 
Seat 5: masquisiera (€1.02 in chips) 
Seat 6: pipinoelbreve9 (€3.95 in chips) 
Manuxanxe78: posts small blind €0.01
vayewis: posts big blind €0.02
*** HOLE CARDS ***
Dealt to pipinoelbreve9 [7s 3d]
fernan_282t: raises €0.02 to €0.04
masquisiera: raises €0.02 to €0.06
pipinoelbreve9: folds 
Desmd72: folds 
Manuxanxe78: folds 
vayewis: folds 
fernan_282t: calls €0.02
*** FLOP *** [6s 7h Jh]
fernan_282t: bets €0.06
masquisiera: calls €0.06
*** TURN *** [6s 7h Jh] [7c]
fernan_282t: bets €0.02
masquisiera: folds 
Uncalled bet (€0.02) returned to fernan_282t
fernan_282t collected €0.26 from pot
fernan_282t: doesn't show hand 
*** SUMMARY ***
Total pot €0.27 | Rake €0.01 
Board [6s 7h Jh 7c]
Seat 1: Desmd72 (button) folded before Flop (didn't bet)
Seat 2: Manuxanxe78 (small blind) folded before Flop
Seat 3: vayewis (big blind) folded before Flop
Seat 4: fernan_282t collected (€0.26)
Seat 5: masquisiera folded on the Turn
Seat 6: pipinoelbreve9 folded before Flop (didn't bet)



PokerStars Zoom Hand #257558893053:  Hold'em No Limit (€0.01/€0.02) - 2025/08/31 19:03:31 CET [2025/08/31 13:03:31 ET]
Table 'Arneb' 6-max Seat #1 is the button
Seat 1: odace15 (€2 in chips) 
Seat 2: laprimera65 (€2.14 in chips) 
Seat 3: pipinoelbreve9 (€3.95 in chips) 
Seat 4: Choonchas (€1.98 in chips) 
Seat 5: PrendsCa (€2 in chips) 
Seat 6: AIexiito (€0.59 in chips) 
laprimera65: posts small blind €0.01
pipinoelbreve9: posts big blind €0.02
*** HOLE CARDS ***
Dealt to pipinoelbreve9 [Ts Ac]
Choonchas: folds 
PrendsCa: folds 
AIexiito: folds 
odace15: raises €0.04 to €0.06
laprimera65: folds 
pipinoelbreve9: calls €0.04
*** FLOP *** [8d Qh 7s]
pipinoelbreve9: checks 
odace15: bets €0.04
pipinoelbreve9: calls €0.04
*** TURN *** [8d Qh 7s] [Tc]
pipinoelbreve9: checks 
odace15: bets €0.07
pipinoelbreve9: calls €0.07
*** RIVER *** [8d Qh 7s Tc] [5s]
pipinoelbreve9: checks 
odace15: checks 
*** SHOW DOWN ***
pipinoelbreve9: shows [Ts Ac] (a pair of Tens)
odace15: mucks hand 
pipinoelbreve9 collected €0.33 from pot
*** SUMMARY ***
Total pot €0.35 | Rake €0.02 
Board [8d Qh 7s Tc 5s]
Seat 1: odace15 (button) mucked [Ad 7d]
Seat 2: laprimera65 (small blind) folded before Flop
Seat 3: pipinoelbreve9 (big blind) showed [Ts Ac] and won (€0.33) with a pair of Tens
Seat 4: Choonchas folded before Flop (didn't bet)
Seat 5: PrendsCa folded before Flop (didn't bet)
Seat 6: AIexiito folded before Flop (didn't bet)



PokerStars Zoom Hand #257558904338:  Hold'em No Limit (€0.01/€0.02) - 2025/08/31 19:04:20 CET [2025/08/31 13:04:20 ET]
Table 'Arneb' 6-max Seat #1 is the button
Seat 1: Choonchas (€1.54 in chips) 
Seat 2: pipinoelbreve9 (€4.11 in chips) 
Seat 3: maximus_powah (€5.20 in chips) 
Seat 4: Desmd72 (€2.04 in chips) 
Seat 5: vayewis (€3.14 in chips) 
Seat 6: kaou35 (€1.67 in chips) 
pipinoelbreve9: posts small blind €0.01
maximus_powah: posts big blind €0.02
*** HOLE CARDS ***
Dealt to pipinoelbreve9 [6d Kh]
Desmd72: folds 
vayewis: folds 
kaou35: folds 
Choonchas: raises €0.03 to €0.05
pipinoelbreve9: calls €0.04
maximus_powah: folds 
*** FLOP *** [3s 7s 2s]
pipinoelbreve9: checks 
Choonchas: checks 
*** TURN *** [3s 7s 2s] [Qd]
pipinoelbreve9: checks 
Choonchas: bets €0.08
pipinoelbreve9: folds 
Uncalled bet (€0.08) returned to Choonchas
Choonchas collected €0.11 from pot
Choonchas: doesn't show hand 
*** SUMMARY ***
Total pot €0.12 | Rake €0.01 
Board [3s 7s 2s Qd]
Seat 1: Choonchas (button) collected (€0.11)
Seat 2: pipinoelbreve9 (small blind) folded on the Turn
Seat 3: maximus_powah (big blind) folded before Flop
Seat 4: Desmd72 folded before Flop (didn't bet)
Seat 5: vayewis folded before Flop (didn't bet)
Seat 6: kaou35 folded before Flop (didn't bet)



PokerStars Zoom Hand #257558915999:  Hold'em No Limit (€0.01/€0.02) - 2025/08/31 19:05:07 CET [2025/08/31 13:05:07 ET]
Table 'Arneb' 6-max Seat #1 is the button
Seat 1: 34pluto (€1.63 in chips) 
Seat 2: masquisiera (€1.09 in chips) 
Seat 3: lorocontento (€1.12 in chips) 
Seat 4: HGrenha (€2.76 in chips) 
Seat 5: pipinoelbreve9 (€4.06 in chips) 
Seat 6: GRAKETIN (€2.01 in chips) 
masquisiera: posts small blind €0.01
lorocontento: posts big blind €0.02
*** HOLE CARDS ***
Dealt to pipinoelbreve9 [5h 8d]
HGrenha: folds 
pipinoelbreve9: folds 
GRAKETIN: folds 
34pluto: folds 
masquisiera: raises €0.04 to €0.06
lorocontento: folds 
Uncalled bet (€0.04) returned to masquisiera
masquisiera collected €0.04 from pot
masquisiera: doesn't show hand 
*** SUMMARY ***
Total pot €0.04 | Rake €0 
Seat 1: 34pluto (button) folded before Flop (didn't bet)
Seat 2: masquisiera (small blind) collected (€0.04)
Seat 3: lorocontento (big blind) folded before Flop
Seat 4: HGrenha folded before Flop (didn't bet)
Seat 5: pipinoelbreve9 folded before Flop (didn't bet)
Seat 6: GRAKETIN folded before Flop (didn't bet)



PokerStars Zoom Hand #257558912518:  Hold'em No Limit (€0.01/€0.02) - 2025/08/31 19:04:54 CET [2025/08/31 13:04:54 ET]
Table 'Arneb' 6-max Seat #1 is the button
Seat 1: pipinoelbreve9 (€4.06 in chips) 
Seat 2: kaou35 (€1.71 in chips) 
Seat 3: candarias (€0.85 in chips) 
Seat 4: kratitos10 (€2 in chips) 
Seat 5: Korver K (€2.41 in chips) 
Seat 6: BestiaESP12 (€2.01 in chips) 
kaou35: posts small blind €0.01
candarias: posts big blind €0.02
*** HOLE CARDS ***
Dealt to pipinoelbreve9 [6d 4s]
kratitos10: folds 
Korver K: folds 
BestiaESP12: folds 
pipinoelbreve9: folds 
kaou35: raises €0.04 to €0.06
candarias: calls €0.04
*** FLOP *** [Qs 8h As]
kaou35: checks 
candarias: checks 
*** TURN *** [Qs 8h As] [2h]
kaou35: checks 
candarias: checks 
*** RIVER *** [Qs 8h As 2h] [9s]
kaou35: bets €0.04
candarias: calls €0.04
*** SHOW DOWN ***
kaou35: shows [Kh Qc] (a pair of Queens)
candarias: mucks hand 
kaou35 collected €0.19 from pot
*** SUMMARY ***
Total pot €0.20 | Rake €0.01 
Board [Qs 8h As 2h 9s]
Seat 1: pipinoelbreve9 (button) folded before Flop (didn't bet)
Seat 2: kaou35 (small blind) showed [Kh Qc] and won (€0.19) with a pair of Queens
Seat 3: candarias (big blind) mucked [Tc Td]
Seat 4: kratitos10 folded before Flop (didn't bet)
Seat 5: Korver K folded before Flop (didn't bet)
Seat 6: BestiaESP12 folded before Flop (didn't bet)



PokerStars Zoom Hand #257558916853:  Hold'em No Limit (€0.01/€0.02) - 2025/08/31 19:05:11 CET [2025/08/31 13:05:11 ET]
Table 'Arneb' 6-max Seat #1 is the button
Seat 1: cheminot83 (€0.57 in chips) 
Seat 2: andresrodr8 (€4.05 in chips) 
Seat 3: fernan_282t (€1.12 in chips) 
Seat 4: pipinoelbreve9 (€4.06 in chips) 
Seat 5: Bad_Tripss (€2.82 in chips) 
Seat 6: Mai SA135 (€2.04 in chips) 
andresrodr8: posts small blind €0.01
fernan_282t: posts big blind €0.02
*** HOLE CARDS ***
Dealt to pipinoelbreve9 [Tc Jh]
pipinoelbreve9: raises €0.04 to €0.06
Bad_Tripss: folds 
Mai SA135: raises €0.04 to €0.10
cheminot83: folds 
andresrodr8: folds 
fernan_282t: folds 
pipinoelbreve9: calls €0.04
*** FLOP *** [Ts Ah 7d]
pipinoelbreve9: bets €0.11
Mai SA135: calls €0.11
*** TURN *** [Ts Ah 7d] [8c]
pipinoelbreve9: checks 
Mai SA135: bets €0.22
pipinoelbreve9: folds 
Uncalled bet (€0.22) returned to Mai SA135
Mai SA135 collected €0.43 from pot
Mai SA135: doesn't show hand 
*** SUMMARY ***
Total pot €0.45 | Rake €0.02 
Board [Ts Ah 7d 8c]
Seat 1: cheminot83 (button) folded before Flop (didn't bet)
Seat 2: andresrodr8 (small blind) folded before Flop
Seat 3: fernan_282t (big blind) folded before Flop
Seat 4: pipinoelbreve9 folded on the Turn
Seat 5: Bad_Tripss folded before Flop (didn't bet)
Seat 6: Mai SA135 collected (€0.43)



PokerStars Zoom Hand #257558926319:  Hold'em No Limit (€0.01/€0.02) - 2025/08/31 19:05:49 CET [2025/08/31 13:05:49 ET]
Table 'Arneb' 6-max Seat #1 is the button
Seat 1: FELIPE439 (€1.89 in chips) 
Seat 2: pipinoelbreve9 (€3.85 in chips) 
Seat 3: SLUSMYMXPT (€2 in chips) 
Seat 4: kaou35 (€3.75 in chips) 
Seat 5: julsau81 (€0.92 in chips) 
Seat 6: fiku1 (€1.97 in chips) 
pipinoelbreve9: posts small blind €0.01
SLUSMYMXPT: posts big blind €0.02
*** HOLE CARDS ***
Dealt to pipinoelbreve9 [Js 2c]
kaou35: folds 
julsau81: folds 
fiku1: folds 
FELIPE439: folds 
pipinoelbreve9: folds 
Uncalled bet (€0.01) returned to SLUSMYMXPT
SLUSMYMXPT collected €0.02 from pot
SLUSMYMXPT: doesn't show hand 
*** SUMMARY ***
Total pot €0.02 | Rake €0 
Seat 1: FELIPE439 (button) folded before Flop (didn't bet)
Seat 2: pipinoelbreve9 (small blind) folded before Flop
Seat 3: SLUSMYMXPT (big blind) collected (€0.02)
Seat 4: kaou35 folded before Flop (didn't bet)
Seat 5: julsau81 folded before Flop (didn't bet)
Seat 6: fiku1 folded before Flop (didn't bet)



PokerStars Zoom Hand #257558932236:  Hold'em No Limit (€0.01/€0.02) - 2025/08/31 19:06:11 CET [2025/08/31 13:06:11 ET]
Table 'Arneb' 6-max Seat #1 is the button
Seat 1: kaou35 (€2.89 in chips) 
Seat 2: BestiaESP12 (€2.04 in chips) 
Seat 3: pipinoelbreve9 (€3.84 in chips) 
Seat 4: lorocontento (€1.54 in chips) 
Seat 5: madn1994 (€1.46 in chips) 
Seat 6: andresrodr8 (€2.66 in chips) 
BestiaESP12: posts small blind €0.01
pipinoelbreve9: posts big blind €0.02
*** HOLE CARDS ***
Dealt to pipinoelbreve9 [5c Ac]
lorocontento: folds 
madn1994: folds 
andresrodr8: folds 
kaou35: folds 
BestiaESP12: folds 
Uncalled bet (€0.01) returned to pipinoelbreve9
pipinoelbreve9 collected €0.02 from pot
pipinoelbreve9: doesn't show hand 
*** SUMMARY ***
Total pot €0.02 | Rake €0 
Seat 1: kaou35 (button) folded before Flop (didn't bet)
Seat 2: BestiaESP12 (small blind) folded before Flop
Seat 3: pipinoelbreve9 (big blind) collected (€0.02)
Seat 4: lorocontento folded before Flop (didn't bet)
Seat 5: madn1994 folded before Flop (didn't bet)
Seat 6: andresrodr8 folded before Flop (didn't bet)



PokerStars Zoom Hand #257558930489:  Hold'em No Limit (€0.01/€0.02) - 2025/08/31 19:06:03 CET [2025/08/31 13:06:03 ET]
Table 'Arneb' 6-max Seat #1 is the button
Seat 1: pipinoelbreve9 (€3.84 in chips) 
Seat 2: masquisiera (€1 in chips) 
Seat 3: xKelbi. (€2.36 in chips) 
Seat 4: janjos69 (€1.33 in chips) 
Seat 5: laprimera65 (€2 in chips) 
Seat 6: Minyens33 (€2.26 in chips) 
masquisiera: posts small blind €0.01
xKelbi.: posts big blind €0.02
*** HOLE CARDS ***
Dealt to pipinoelbreve9 [2h 5c]
janjos69: raises €0.04 to €0.06
laprimera65: raises €0.12 to €0.18
Minyens33: folds 
pipinoelbreve9: folds 
masquisiera: folds 
xKelbi.: folds 
janjos69: calls €0.12
*** FLOP *** [Ks 6d 2c]
janjos69: checks 
laprimera65: bets €0.13
janjos69: calls €0.13
*** TURN *** [Ks 6d 2c] [9c]
janjos69: checks 
laprimera65: checks 
*** RIVER *** [Ks 6d 2c 9c] [Ad]
janjos69: bets €0.58
laprimera65: folds 
Uncalled bet (€0.58) returned to janjos69
janjos69 collected €0.62 from pot
janjos69: doesn't show hand 
*** SUMMARY ***
Total pot €0.65 | Rake €0.03 
Board [Ks 6d 2c 9c Ad]
Seat 1: pipinoelbreve9 (button) folded before Flop (didn't bet)
Seat 2: masquisiera (small blind) folded before Flop
Seat 3: xKelbi. (big blind) folded before Flop
Seat 4: janjos69 collected (€0.62)
Seat 5: laprimera65 folded on the River
Seat 6: Minyens33 folded before Flop (didn't bet)



PokerStars Zoom Hand #257558934714:  Hold'em No Limit (€0.01/€0.02) - 2025/08/31 19:06:21 CET [2025/08/31 13:06:21 ET]
Table 'Arneb' 6-max Seat #1 is the button
Seat 1: Bad_Tripss (€3.02 in chips) 
Seat 2: kaou35 (€1.90 in chips) 
Seat 3: FELIPE439 (€1.89 in chips) 
Seat 4: Minyens33 (€2.26 in chips) 
Seat 5: odace15 (€2.56 in chips) 
Seat 6: pipinoelbreve9 (€3.85 in chips) 
kaou35: posts small blind €0.01
FELIPE439: posts big blind €0.02
*** HOLE CARDS ***
Dealt to pipinoelbreve9 [Jc 8c]
Minyens33: folds 
odace15: folds 
pipinoelbreve9 has timed out
pipinoelbreve9: folds 
Bad_Tripss: folds 
kaou35: folds 
Uncalled bet (€0.01) returned to FELIPE439
FELIPE439 collected €0.02 from pot
FELIPE439: doesn't show hand 
*** SUMMARY ***
Total pot €0.02 | Rake €0 
Seat 1: Bad_Tripss (button) folded before Flop (didn't bet)
Seat 2: kaou35 (small blind) folded before Flop
Seat 3: FELIPE439 (big blind) collected (€0.02)
Seat 4: Minyens33 folded before Flop (didn't bet)
Seat 5: odace15 folded before Flop (didn't bet)
Seat 6: pipinoelbreve9 folded before Flop (didn't bet)



PokerStars Zoom Hand #257558943157:  Hold'em No Limit (€0.01/€0.02) - 2025/08/31 19:06:56 CET [2025/08/31 13:06:56 ET]
Table 'Arneb' 6-max Seat #1 is the button
Seat 1: DriztDUrden (€1.01 in chips) 
Seat 2: VEGAMAR (€2.01 in chips) 
Seat 3: Älejo (€2.15 in chips) 
Seat 4: masquisiera (€1.19 in chips) 
Seat 5: pipinoelbreve9 (€3.85 in chips) 
Seat 6: hope201319 (€2.52 in chips) 
VEGAMAR: posts small blind €0.01
Älejo: posts big blind €0.02
*** HOLE CARDS ***
Dealt to pipinoelbreve9 [7h Ks]
masquisiera: folds 
pipinoelbreve9: folds 
hope201319: folds 
DriztDUrden: folds 
VEGAMAR: folds 
Uncalled bet (€0.01) returned to Älejo
Älejo collected €0.02 from pot
Älejo: doesn't show hand 
*** SUMMARY ***
Total pot €0.02 | Rake €0 
Seat 1: DriztDUrden (button) folded before Flop (didn't bet)
Seat 2: VEGAMAR (small blind) folded before Flop
Seat 3: Älejo (big blind) collected (€0.02)
Seat 4: masquisiera folded before Flop (didn't bet)
Seat 5: pipinoelbreve9 folded before Flop (didn't bet)
Seat 6: hope201319 folded before Flop (didn't bet)



PokerStars Zoom Hand #257558939688:  Hold'em No Limit (€0.01/€0.02) - 2025/08/31 19:06:42 CET [2025/08/31 13:06:42 ET]
Table 'Arneb' 6-max Seat #1 is the button
Seat 1: marcosbalsaa (€5.48 in chips) 
Seat 2: psr47770102 (€0.94 in chips) 
Seat 3: McMack626 (€1.54 in chips) 
Seat 4: cruass (€2 in chips) 
Seat 5: fiku1 (€1.94 in chips) 
Seat 6: pipinoelbreve9 (€3.85 in chips) 
psr47770102: posts small blind €0.01
McMack626: posts big blind €0.02
*** HOLE CARDS ***
Dealt to pipinoelbreve9 [5d 4h]
cruass: folds 
fiku1: folds 
pipinoelbreve9: folds 
marcosbalsaa: raises €0.04 to €0.06
psr47770102: calls €0.05
McMack626: calls €0.04
*** FLOP *** [Qd Qc Jd]
psr47770102: checks 
McMack626: checks 
marcosbalsaa: bets €0.11
psr47770102: folds 
McMack626: folds 
Uncalled bet (€0.11) returned to marcosbalsaa
marcosbalsaa collected €0.17 from pot
marcosbalsaa: doesn't show hand 
*** SUMMARY ***
Total pot €0.18 | Rake €0.01 
Board [Qd Qc Jd]
Seat 1: marcosbalsaa (button) collected (€0.17)
Seat 2: psr47770102 (small blind) folded on the Flop
Seat 3: McMack626 (big blind) folded on the Flop
Seat 4: cruass folded before Flop (didn't bet)
Seat 5: fiku1 folded before Flop (didn't bet)
Seat 6: pipinoelbreve9 folded before Flop (didn't bet)



PokerStars Zoom Hand #257558940723:  Hold'em No Limit (€0.01/€0.02) - 2025/08/31 19:06:46 CET [2025/08/31 13:06:46 ET]
Table 'Arneb' 6-max Seat #1 is the button
Seat 1: spain229 (€1.33 in chips) 
Seat 2: janjos69 (€1.62 in chips) 
Seat 3: Desmd72 (€2.04 in chips) 
Seat 4: masquisiera (€1.19 in chips) 
Seat 5: pipinoelbreve9 (€3.85 in chips) 
Seat 6: Manuxanxe78 (€2 in chips) 
janjos69: posts small blind €0.01
Desmd72: posts big blind €0.02
*** HOLE CARDS ***
Dealt to pipinoelbreve9 [6d 5s]
masquisiera: folds 
pipinoelbreve9: folds 
Manuxanxe78: folds 
spain229: raises €0.04 to €0.06
janjos69: calls €0.05
Desmd72: folds 
*** FLOP *** [Ah 9d Qs]
janjos69: checks 
spain229: bets €0.07
janjos69: calls €0.07
*** TURN *** [Ah 9d Qs] [Js]
janjos69: checks 
spain229: bets €0.14
janjos69: folds 
Uncalled bet (€0.14) returned to spain229
spain229 collected €0.27 from pot
spain229: doesn't show hand 
*** SUMMARY ***
Total pot €0.28 | Rake €0.01 
Board [Ah 9d Qs Js]
Seat 1: spain229 (button) collected (€0.27)
Seat 2: janjos69 (small blind) folded on the Turn
Seat 3: Desmd72 (big blind) folded before Flop
Seat 4: masquisiera folded before Flop (didn't bet)
Seat 5: pipinoelbreve9 folded before Flop (didn't bet)
Seat 6: Manuxanxe78 folded before Flop (didn't bet)



PokerStars Zoom Hand #257558941968:  Hold'em No Limit (€0.01/€0.02) - 2025/08/31 19:06:51 CET [2025/08/31 13:06:51 ET]
Table 'Arneb' 6-max Seat #1 is the button
Seat 1: BestiaESP12 (€2.05 in chips) 
Seat 2: fernan_282t (€1.26 in chips) 
Seat 3: ZoasHein (€3.61 in chips) 
Seat 4: pipinoelbreve9 (€3.85 in chips) 
Seat 5: vayewis (€3.51 in chips) 
Seat 6: Choonchas (€1.95 in chips) 
fernan_282t: posts small blind €0.01
ZoasHein: posts big blind €0.02
*** HOLE CARDS ***
Dealt to pipinoelbreve9 [2h 6h]
pipinoelbreve9: folds 
vayewis: folds 
Choonchas: raises €0.03 to €0.05
BestiaESP12: calls €0.05
fernan_282t: raises €0.25 to €0.30
ZoasHein: folds 
Choonchas: calls €0.25
BestiaESP12: folds 
*** FLOP *** [5d 8d As]
fernan_282t: bets €0.96 and is all-in
Choonchas: folds 
Uncalled bet (€0.96) returned to fernan_282t
fernan_282t collected €0.64 from pot
fernan_282t: doesn't show hand 
*** SUMMARY ***
Total pot €0.67 | Rake €0.03 
Board [5d 8d As]
Seat 1: BestiaESP12 (button) folded before Flop
Seat 2: fernan_282t (small blind) collected (€0.64)
Seat 3: ZoasHein (big blind) folded before Flop
Seat 4: pipinoelbreve9 folded before Flop (didn't bet)
Seat 5: vayewis folded before Flop (didn't bet)
Seat 6: Choonchas folded on the Flop



PokerStars Zoom Hand #257558945874:  Hold'em No Limit (€0.01/€0.02) - 2025/08/31 19:07:06 CET [2025/08/31 13:07:06 ET]
Table 'Arneb' 6-max Seat #1 is the button
Seat 1: BestiaESP12 (€2.04 in chips) 
Seat 2: FELIPE439 (€5.33 in chips) 
Seat 3: pipinoelbreve9 (€3.85 in chips) 
Seat 4: DeividBox980 (€0.88 in chips) 
Seat 5: Bad_Tripss (€3.02 in chips) 
Seat 6: SoulfulHearts (€2 in chips) 
FELIPE439: posts small blind €0.01
pipinoelbreve9: posts big blind €0.02
*** HOLE CARDS ***
Dealt to pipinoelbreve9 [Ts Tc]
DeividBox980: folds 
Bad_Tripss: raises €0.03 to €0.05
SoulfulHearts: folds 
BestiaESP12: folds 
FELIPE439: folds 
pipinoelbreve9: raises €0.13 to €0.18
Bad_Tripss: calls €0.13
*** FLOP *** [8h Qc 7s]
pipinoelbreve9: bets €0.18
Bad_Tripss: folds 
Uncalled bet (€0.18) returned to pipinoelbreve9
pipinoelbreve9 collected €0.35 from pot
pipinoelbreve9: doesn't show hand 
*** SUMMARY ***
Total pot €0.37 | Rake €0.02 
Board [8h Qc 7s]
Seat 1: BestiaESP12 (button) folded before Flop (didn't bet)
Seat 2: FELIPE439 (small blind) folded before Flop
Seat 3: pipinoelbreve9 (big blind) collected (€0.35)
Seat 4: DeividBox980 folded before Flop (didn't bet)
Seat 5: Bad_Tripss folded on the Flop
Seat 6: SoulfulHearts folded before Flop (didn't bet)



PokerStars Zoom Hand #257558954295:  Hold'em No Limit (€0.01/€0.02) - 2025/08/31 19:07:40 CET [2025/08/31 13:07:40 ET]
Table 'Arneb' 6-max Seat #1 is the button
Seat 1: Bad_Tripss (€2.84 in chips) 
Seat 2: pipinoelbreve9 (€4.02 in chips) 
Seat 3: spain229 (€1.46 in chips) 
Seat 4: cruass (€2 in chips) 
Seat 5: VEGAMAR (€2.42 in chips) 
Seat 6: candarias (€0.69 in chips) 
pipinoelbreve9: posts small blind €0.01
spain229: posts big blind €0.02
*** HOLE CARDS ***
Dealt to pipinoelbreve9 [4h Qh]
cruass: folds 
VEGAMAR: raises €0.04 to €0.06
candarias: folds 
Bad_Tripss: folds 
pipinoelbreve9: calls €0.05
spain229: folds 
*** FLOP *** [2d 4s 8h]
pipinoelbreve9: bets €0.07
VEGAMAR: calls €0.07
*** TURN *** [2d 4s 8h] [3c]
pipinoelbreve9: checks 
VEGAMAR: bets €0.18
pipinoelbreve9: folds 
Uncalled bet (€0.18) returned to VEGAMAR
VEGAMAR collected €0.27 from pot
VEGAMAR: doesn't show hand 
*** SUMMARY ***
Total pot €0.28 | Rake €0.01 
Board [2d 4s 8h 3c]
Seat 1: Bad_Tripss (button) folded before Flop (didn't bet)
Seat 2: pipinoelbreve9 (small blind) folded on the Turn
Seat 3: spain229 (big blind) folded before Flop
Seat 4: cruass folded before Flop (didn't bet)
Seat 5: VEGAMAR collected (€0.27)
Seat 6: candarias folded before Flop (didn't bet)



PokerStars Zoom Hand #257558963755:  Hold'em No Limit (€0.01/€0.02) - 2025/08/31 19:08:18 CET [2025/08/31 13:08:18 ET]
Table 'Arneb' 6-max Seat #1 is the button
Seat 1: pipinoelbreve9 (€3.89 in chips) 
Seat 2: VEGAMAR (€2.56 in chips) 
Seat 3: Rood Gun (€1.98 in chips) 
Seat 4: anflo13 (€1.58 in chips) 
Seat 5: candarias (€0.68 in chips) 
Seat 6: vayewis (€2.58 in chips) 
VEGAMAR: posts small blind €0.01
Rood Gun: posts big blind €0.02
*** HOLE CARDS ***
Dealt to pipinoelbreve9 [Jh Th]
anflo13: folds 
candarias: calls €0.02
vayewis: folds 
pipinoelbreve9: raises €0.08 to €0.10
VEGAMAR: folds 
Rood Gun: folds 
candarias: calls €0.08
*** FLOP *** [As 9h 5s]
candarias: checks 
pipinoelbreve9: checks 
*** TURN *** [As 9h 5s] [Ks]
candarias: checks 
pipinoelbreve9: bets €0.11
candarias: raises €0.47 to €0.58 and is all-in
pipinoelbreve9: folds 
Uncalled bet (€0.47) returned to candarias
candarias collected €0.43 from pot
candarias: doesn't show hand 
*** SUMMARY ***
Total pot €0.45 | Rake €0.02 
Board [As 9h 5s Ks]
Seat 1: pipinoelbreve9 (button) folded on the Turn
Seat 2: VEGAMAR (small blind) folded before Flop
Seat 3: Rood Gun (big blind) folded before Flop
Seat 4: anflo13 folded before Flop (didn't bet)
Seat 5: candarias collected (€0.43)
Seat 6: vayewis folded before Flop (didn't bet)



PokerStars Zoom Hand #257558975513:  Hold'em No Limit (€0.01/€0.02) - 2025/08/31 19:09:06 CET [2025/08/31 13:09:06 ET]
Table 'Arneb' 6-max Seat #1 is the button
Seat 1: anflo13 (€1.58 in chips) 
Seat 2: cruass (€2.36 in chips) 
Seat 3: Bad_Tripss (€2.90 in chips) 
Seat 4: pipinoelbreve9 (€3.68 in chips) 
Seat 5: hope201319 (€1.66 in chips) 
Seat 6: Gginer2812 (€0.92 in chips) 
cruass: posts small blind €0.01
Bad_Tripss: posts big blind €0.02
*** HOLE CARDS ***
Dealt to pipinoelbreve9 [Jd 5d]
pipinoelbreve9: folds 
hope201319: folds 
Gginer2812: calls €0.02
anflo13: folds 
cruass: folds 
Bad_Tripss: checks 
*** FLOP *** [5h 3s Qs]
Bad_Tripss: checks 
Gginer2812: checks 
*** TURN *** [5h 3s Qs] [5s]
Bad_Tripss: checks 
Gginer2812: checks 
*** RIVER *** [5h 3s Qs 5s] [8s]
Bad_Tripss: checks 
Gginer2812: checks 
*** SHOW DOWN ***
Bad_Tripss: shows [3h Ac] (two pair, Fives and Threes)
Gginer2812: shows [6s 6h] (a flush, Queen high)
Gginer2812 collected €0.05 from pot
*** SUMMARY ***
Total pot €0.05 | Rake €0 
Board [5h 3s Qs 5s 8s]
Seat 1: anflo13 (button) folded before Flop (didn't bet)
Seat 2: cruass (small blind) folded before Flop
Seat 3: Bad_Tripss (big blind) showed [3h Ac] and lost with two pair, Fives and Threes
Seat 4: pipinoelbreve9 folded before Flop (didn't bet)
Seat 5: hope201319 folded before Flop (didn't bet)
Seat 6: Gginer2812 showed [6s 6h] and won (€0.05) with a flush, Queen high



PokerStars Zoom Hand #257558980888:  Hold'em No Limit (€0.01/€0.02) - 2025/08/31 19:09:27 CET [2025/08/31 13:09:27 ET]
Table 'Arneb' 6-max Seat #1 is the button
Seat 1: candarias (€1.84 in chips) 
Seat 2: janjos69 (€1.48 in chips) 
Seat 3: pipinoelbreve9 (€3.67 in chips) 
Seat 4: madn1994 (€1.45 in chips) 
Seat 5: Desmd72 (€2.21 in chips) 
Seat 6: thenry03 (€2.01 in chips) 
janjos69: posts small blind €0.01
pipinoelbreve9: posts big blind €0.02
*** HOLE CARDS ***
Dealt to pipinoelbreve9 [6s 4h]
madn1994: folds 
Desmd72: folds 
thenry03: folds 
candarias: folds 
janjos69: raises €0.04 to €0.06
pipinoelbreve9: folds 
Uncalled bet (€0.04) returned to janjos69
janjos69 collected €0.04 from pot
janjos69: doesn't show hand 
*** SUMMARY ***
Total pot €0.04 | Rake €0 
Seat 1: candarias (button) folded before Flop (didn't bet)
Seat 2: janjos69 (small blind) collected (€0.04)
Seat 3: pipinoelbreve9 (big blind) folded before Flop
Seat 4: madn1994 folded before Flop (didn't bet)
Seat 5: Desmd72 folded before Flop (didn't bet)
Seat 6: thenry03 folded before Flop (didn't bet)



PokerStars Zoom Hand #257558978421:  Hold'em No Limit (€0.01/€0.02) - 2025/08/31 19:09:17 CET [2025/08/31 13:09:17 ET]
Table 'Arneb' 6-max Seat #1 is the button
Seat 1: pipinoelbreve9 (€3.67 in chips) 
Seat 2: chriscoco08 (€2.19 in chips) 
Seat 3: pucelazo (€2 in chips) 
Seat 4: anflo13 (€1.57 in chips) 
Seat 5: losi10 (€1.08 in chips) 
Seat 6: kaou35 (€2.37 in chips) 
chriscoco08: posts small blind €0.01
pucelazo: posts big blind €0.02
*** HOLE CARDS ***
Dealt to pipinoelbreve9 [3h 4c]
anflo13: folds 
losi10: calls €0.02
kaou35: raises €0.07 to €0.09
pipinoelbreve9: folds 
chriscoco08: calls €0.08
pucelazo: folds 
losi10: calls €0.07
*** FLOP *** [8d 9d 8h]
chriscoco08: checks 
losi10: checks 
kaou35: checks 
*** TURN *** [8d 9d 8h] [Ad]
chriscoco08: checks 
losi10: checks 
kaou35: checks 
*** RIVER *** [8d 9d 8h Ad] [Kh]
chriscoco08: checks 
losi10: checks 
kaou35: checks 
*** SHOW DOWN ***
chriscoco08: shows [9c Tc] (two pair, Nines and Eights)
losi10: mucks hand 
kaou35: shows [Kc Qh] (two pair, Kings and Eights)
kaou35 collected €0.28 from pot
*** SUMMARY ***
Total pot €0.29 | Rake €0.01 
Board [8d 9d 8h Ad Kh]
Seat 1: pipinoelbreve9 (button) folded before Flop (didn't bet)
Seat 2: chriscoco08 (small blind) showed [9c Tc] and lost with two pair, Nines and Eights
Seat 3: pucelazo (big blind) folded before Flop
Seat 4: anflo13 folded before Flop (didn't bet)
Seat 5: losi10 mucked [Jc Qs]
Seat 6: kaou35 showed [Kc Qh] and won (€0.28) with two pair, Kings and Eights



PokerStars Zoom Hand #257558986312:  Hold'em No Limit (€0.01/€0.02) - 2025/08/31 19:09:49 CET [2025/08/31 13:09:49 ET]
Table 'Arneb' 6-max Seat #1 is the button
Seat 1: odace15 (€2.54 in chips) 
Seat 2: spain229 (€1.50 in chips) 
Seat 3: cheminot83 (€0.90 in chips) 
Seat 4: FELIPE439 (€5.41 in chips) 
Seat 5: pipinoelbreve9 (€3.65 in chips) 
Seat 6: laprimera65 (€2.08 in chips) 
spain229: posts small blind €0.01
cheminot83: posts big blind €0.02
*** HOLE CARDS ***
Dealt to pipinoelbreve9 [Th 4s]
FELIPE439: folds 
pipinoelbreve9: folds 
laprimera65: folds 
odace15: folds 
spain229: raises €0.04 to €0.06
cheminot83: folds 
Uncalled bet (€0.04) returned to spain229
spain229 collected €0.04 from pot
spain229: doesn't show hand 
*** SUMMARY ***
Total pot €0.04 | Rake €0 
Seat 1: odace15 (button) folded before Flop (didn't bet)
Seat 2: spain229 (small blind) collected (€0.04)
Seat 3: cheminot83 (big blind) folded before Flop
Seat 4: FELIPE439 folded before Flop (didn't bet)
Seat 5: pipinoelbreve9 folded before Flop (didn't bet)
Seat 6: laprimera65 folded before Flop (didn't bet)



PokerStars Zoom Hand #257558976952:  Hold'em No Limit (€0.01/€0.02) - 2025/08/31 19:09:11 CET [2025/08/31 13:09:11 ET]
Table 'Arneb' 6-max Seat #1 is the button
Seat 1: Bilintx703 (€2 in chips) 
Seat 2: pipinoelbreve9 (€3.68 in chips) 
Seat 3: McMack626 (€2 in chips) 
Seat 4: hope201319 (€1.66 in chips) 
Seat 5: Jota_uVe_1 (€2.16 in chips) 
Seat 6: Älejo (€2.02 in chips) 
pipinoelbreve9: posts small blind €0.01
McMack626: posts big blind €0.02
*** HOLE CARDS ***
Dealt to pipinoelbreve9 [7h 6d]
hope201319: calls €0.02
Jota_uVe_1: folds 
Älejo: folds 
Bilintx703: calls €0.02
pipinoelbreve9: folds 
McMack626: checks 
*** FLOP *** [2s 5d Ks]
McMack626: checks 
hope201319: checks 
Bilintx703: checks 
*** TURN *** [2s 5d Ks] [Jh]
McMack626: bets €0.04
hope201319: calls €0.04
Bilintx703: folds 
*** RIVER *** [2s 5d Ks Jh] [As]
McMack626: bets €0.14
hope201319: folds 
Uncalled bet (€0.14) returned to McMack626
McMack626 collected €0.14 from pot
McMack626: doesn't show hand 
*** SUMMARY ***
Total pot €0.15 | Rake €0.01 
Board [2s 5d Ks Jh As]
Seat 1: Bilintx703 (button) folded on the Turn
Seat 2: pipinoelbreve9 (small blind) folded before Flop
Seat 3: McMack626 (big blind) collected (€0.14)
Seat 4: hope201319 folded on the River
Seat 5: Jota_uVe_1 folded before Flop (didn't bet)
Seat 6: Älejo folded before Flop (didn't bet)



PokerStars Zoom Hand #257558989492:  Hold'em No Limit (€0.01/€0.02) - 2025/08/31 19:10:01 CET [2025/08/31 13:10:01 ET]
Table 'Arneb' 6-max Seat #1 is the button
Seat 1: maximus_powah (€4.51 in chips) 
Seat 2: laprimera65 (€2.15 in chips) 
Seat 3: Jota_uVe_1 (€2.20 in chips) 
Seat 4: pipinoelbreve9 (€3.65 in chips) 
Seat 5: pucelazo (€2 in chips) 
Seat 6: Uvildo (€2.30 in chips) 
laprimera65: posts small blind €0.01
Jota_uVe_1: posts big blind €0.02
*** HOLE CARDS ***
Dealt to pipinoelbreve9 [Td 2s]
pipinoelbreve9: folds 
pucelazo: folds 
Uvildo: folds 
maximus_powah: folds 
laprimera65: folds 
Uncalled bet (€0.01) returned to Jota_uVe_1
Jota_uVe_1 collected €0.02 from pot
Jota_uVe_1: doesn't show hand 
*** SUMMARY ***
Total pot €0.02 | Rake €0 
Seat 1: maximus_powah (button) folded before Flop (didn't bet)
Seat 2: laprimera65 (small blind) folded before Flop
Seat 3: Jota_uVe_1 (big blind) collected (€0.02)
Seat 4: pipinoelbreve9 folded before Flop (didn't bet)
Seat 5: pucelazo folded before Flop (didn't bet)
Seat 6: Uvildo folded before Flop (didn't bet)



PokerStars Zoom Hand #257558985242:  Hold'em No Limit (€0.01/€0.02) - 2025/08/31 19:09:45 CET [2025/08/31 13:09:45 ET]
Table 'Arneb' 6-max Seat #1 is the button
Seat 1: Bad_Tripss (€2.87 in chips) 
Seat 2: Jota_uVe_1 (€2.21 in chips) 
Seat 3: Gginer2812 (€0.94 in chips) 
Seat 4: spain229 (€1.50 in chips) 
Seat 5: OMaisPesado1 (€2 in chips) 
Seat 6: pipinoelbreve9 (€3.65 in chips) 
Jota_uVe_1: posts small blind €0.01
Gginer2812: posts big blind €0.02
*** HOLE CARDS ***
Dealt to pipinoelbreve9 [5c Jh]
spain229: folds 
OMaisPesado1: folds 
pipinoelbreve9: folds 
Bad_Tripss: raises €0.03 to €0.05
Jota_uVe_1: folds 
Gginer2812: calls €0.03
*** FLOP *** [6s 4c 5d]
Gginer2812: checks 
Bad_Tripss: checks 
*** TURN *** [6s 4c 5d] [Ac]
Gginer2812: checks 
Bad_Tripss: bets €0.06
Gginer2812: calls €0.06
*** RIVER *** [6s 4c 5d Ac] [7c]
Gginer2812: checks 
Bad_Tripss: checks 
*** SHOW DOWN ***
Gginer2812: shows [As 9h] (a pair of Aces)
Bad_Tripss: mucks hand 
Gginer2812 collected €0.22 from pot
*** SUMMARY ***
Total pot €0.23 | Rake €0.01 
Board [6s 4c 5d Ac 7c]
Seat 1: Bad_Tripss (button) mucked [Td Qs]
Seat 2: Jota_uVe_1 (small blind) folded before Flop
Seat 3: Gginer2812 (big blind) showed [As 9h] and won (€0.22) with a pair of Aces
Seat 4: spain229 folded before Flop (didn't bet)
Seat 5: OMaisPesado1 folded before Flop (didn't bet)
Seat 6: pipinoelbreve9 folded before Flop (didn't bet)



PokerStars Zoom Hand #257558991467:  Hold'em No Limit (€0.01/€0.02) - 2025/08/31 19:10:10 CET [2025/08/31 13:10:10 ET]
Table 'Arneb' 6-max Seat #1 is the button
Seat 1: DriztDUrden (€0.86 in chips) 
Seat 2: pipinoelbreve9 (€3.65 in chips) 
Seat 3: ZoasHein (€3.76 in chips) 
Seat 4: booster74 (€2.95 in chips) 
Seat 5: GRAKETIN (€2.48 in chips) 
Seat 6: maximus_powah (€4.51 in chips) 
pipinoelbreve9: posts small blind €0.01
ZoasHein: posts big blind €0.02
*** HOLE CARDS ***
Dealt to pipinoelbreve9 [Ts Ks]
booster74: folds 
GRAKETIN: folds 
maximus_powah: folds 
DriztDUrden: folds 
pipinoelbreve9: raises €0.04 to €0.06
ZoasHein: folds 
Uncalled bet (€0.04) returned to pipinoelbreve9
pipinoelbreve9 collected €0.04 from pot
pipinoelbreve9: doesn't show hand 
*** SUMMARY ***
Total pot €0.04 | Rake €0 
Seat 1: DriztDUrden (button) folded before Flop (didn't bet)
Seat 2: pipinoelbreve9 (small blind) collected (€0.04)
Seat 3: ZoasHein (big blind) folded before Flop
Seat 4: booster74 folded before Flop (didn't bet)
Seat 5: GRAKETIN folded before Flop (didn't bet)
Seat 6: maximus_powah folded before Flop (didn't bet)



PokerStars Zoom Hand #257558994747:  Hold'em No Limit (€0.01/€0.02) - 2025/08/31 19:10:23 CET [2025/08/31 13:10:23 ET]
Table 'Arneb' 6-max Seat #1 is the button
Seat 1: Desmd72 (€2.29 in chips) 
Seat 2: candarias (€1.82 in chips) 
Seat 3: pipinoelbreve9 (€3.67 in chips) 
Seat 4: marcosbalsaa (€4.69 in chips) 
Seat 5: DeividBox980 (€0.97 in chips) 
Seat 6: migueld1 (€1.75 in chips) 
candarias: posts small blind €0.01
pipinoelbreve9: posts big blind €0.02
*** HOLE CARDS ***
Dealt to pipinoelbreve9 [Td 2c]
marcosbalsaa: folds 
DeividBox980: folds 
migueld1: folds 
Desmd72: folds 
candarias: raises €0.04 to €0.06
pipinoelbreve9: folds 
Uncalled bet (€0.04) returned to candarias
candarias collected €0.04 from pot
candarias: doesn't show hand 
*** SUMMARY ***
Total pot €0.04 | Rake €0 
Seat 1: Desmd72 (button) folded before Flop (didn't bet)
Seat 2: candarias (small blind) collected (€0.04)
Seat 3: pipinoelbreve9 (big blind) folded before Flop
Seat 4: marcosbalsaa folded before Flop (didn't bet)
Seat 5: DeividBox980 folded before Flop (didn't bet)
Seat 6: migueld1 folded before Flop (didn't bet)



PokerStars Zoom Hand #257558998954:  Hold'em No Limit (€0.01/€0.02) - 2025/08/31 19:10:40 CET [2025/08/31 13:10:40 ET]
Table 'Arneb' 6-max Seat #1 is the button
Seat 1: pipinoelbreve9 (€3.65 in chips) 
Seat 2: hope201319 (€1.60 in chips) 
Seat 3: LGC04 (€2 in chips) 
Seat 4: FELIPE439 (€2.05 in chips) 
Seat 5: odace15 (€2.54 in chips) 
Seat 6: candarias (€1.43 in chips) 
hope201319: posts small blind €0.01
LGC04: posts big blind €0.02
*** HOLE CARDS ***
Dealt to pipinoelbreve9 [As 2h]
FELIPE439: folds 
odace15: folds 
candarias: folds 
pipinoelbreve9: folds 
hope201319: raises €0.02 to €0.04
LGC04: folds 
Uncalled bet (€0.02) returned to hope201319
hope201319 collected €0.04 from pot
hope201319: doesn't show hand 
*** SUMMARY ***
Total pot €0.04 | Rake €0 
Seat 1: pipinoelbreve9 (button) folded before Flop (didn't bet)
Seat 2: hope201319 (small blind) collected (€0.04)
Seat 3: LGC04 (big blind) folded before Flop
Seat 4: FELIPE439 folded before Flop (didn't bet)
Seat 5: odace15 folded before Flop (didn't bet)
Seat 6: candarias folded before Flop (didn't bet)



PokerStars Zoom Hand #257559000333:  Hold'em No Limit (€0.01/€0.02) - 2025/08/31 19:10:45 CET [2025/08/31 13:10:45 ET]
Table 'Arneb' 6-max Seat #1 is the button
Seat 1: marcosbalsaa (€5.56 in chips) 
Seat 2: pucelazo (€2 in chips) 
Seat 3: Jota_uVe_1 (€2.21 in chips) 
Seat 4: FELIPE439 (€5.38 in chips) 
Seat 5: pipinoelbreve9 (€3.65 in chips) 
Seat 6: xKelbi. (€2.04 in chips) 
pucelazo: posts small blind €0.01
Jota_uVe_1: posts big blind €0.02
*** HOLE CARDS ***
Dealt to pipinoelbreve9 [4s 7s]
FELIPE439: folds 
pipinoelbreve9: folds 
xKelbi.: folds 
marcosbalsaa: folds 
pucelazo: folds 
Uncalled bet (€0.01) returned to Jota_uVe_1
Jota_uVe_1 collected €0.02 from pot
Jota_uVe_1: doesn't show hand 
*** SUMMARY ***
Total pot €0.02 | Rake €0 
Seat 1: marcosbalsaa (button) folded before Flop (didn't bet)
Seat 2: pucelazo (small blind) folded before Flop
Seat 3: Jota_uVe_1 (big blind) collected (€0.02)
Seat 4: FELIPE439 folded before Flop (didn't bet)
Seat 5: pipinoelbreve9 folded before Flop (didn't bet)
Seat 6: xKelbi. folded before Flop (didn't bet)



PokerStars Zoom Hand #257558988276:  Hold'em No Limit (€0.01/€0.02) - 2025/08/31 19:09:57 CET [2025/08/31 13:09:57 ET]
Table 'Arneb' 6-max Seat #1 is the button
Seat 1: janjos69 (€1.50 in chips) 
Seat 2: laprimera65 (€2.08 in chips) 
Seat 3: kaou35 (€4.51 in chips) 
Seat 4: 34pluto (€0.65 in chips) 
Seat 5: Uvildo (€2.30 in chips) 
Seat 6: pipinoelbreve9 (€3.65 in chips) 
laprimera65: posts small blind €0.01
kaou35: posts big blind €0.02
*** HOLE CARDS ***
Dealt to pipinoelbreve9 [4d Jd]
34pluto: folds 
Uvildo: folds 
pipinoelbreve9: folds 
janjos69: raises €0.04 to €0.06
laprimera65: calls €0.05
kaou35: raises €0.18 to €0.24
janjos69: calls €0.18
laprimera65: calls €0.18
*** FLOP *** [Qc 2c Ac]
laprimera65: checks 
kaou35: checks 
janjos69: checks 
*** TURN *** [Qc 2c Ac] [5c]
laprimera65: checks 
kaou35: checks 
janjos69: checks 
*** RIVER *** [Qc 2c Ac 5c] [Tc]
laprimera65: bets €0.16
kaou35: folds 
janjos69: folds 
Uncalled bet (€0.16) returned to laprimera65
laprimera65 collected €0.68 from pot
laprimera65: doesn't show hand 
*** SUMMARY ***
Total pot €0.72 | Rake €0.04 
Board [Qc 2c Ac 5c Tc]
Seat 1: janjos69 (button) folded on the River
Seat 2: laprimera65 (small blind) collected (€0.68)
Seat 3: kaou35 (big blind) folded on the River
Seat 4: 34pluto folded before Flop (didn't bet)
Seat 5: Uvildo folded before Flop (didn't bet)
Seat 6: pipinoelbreve9 folded before Flop (didn't bet)



PokerStars Zoom Hand #257559005080:  Hold'em No Limit (€0.01/€0.02) - 2025/08/31 19:11:05 CET [2025/08/31 13:11:05 ET]
Table 'Arneb' 6-max Seat #1 is the button
Seat 1: Älejo (€2 in chips) 
Seat 2: XxVallesxX (€2.16 in chips) 
Seat 3: janjos69 (€1.26 in chips) 
Seat 4: xKelbi. (€2.04 in chips) 
Seat 5: pipinoelbreve9 (€3.65 in chips) 
Seat 6: charlyleon92 (€2 in chips) 
XxVallesxX: posts small blind €0.01
janjos69: posts big blind €0.02
*** HOLE CARDS ***
Dealt to pipinoelbreve9 [5c 4s]
xKelbi.: raises €0.04 to €0.06
pipinoelbreve9: folds 
charlyleon92: calls €0.06
Älejo: folds 
XxVallesxX: folds 
janjos69: folds 
*** FLOP *** [Kh 9h 3s]
xKelbi.: bets €0.08
charlyleon92: calls €0.08
*** TURN *** [Kh 9h 3s] [Qc]
xKelbi.: bets €0.15
charlyleon92: folds 
Uncalled bet (€0.15) returned to xKelbi.
xKelbi. collected €0.29 from pot
xKelbi.: doesn't show hand 
*** SUMMARY ***
Total pot €0.31 | Rake €0.02 
Board [Kh 9h 3s Qc]
Seat 1: Älejo (button) folded before Flop (didn't bet)
Seat 2: XxVallesxX (small blind) folded before Flop
Seat 3: janjos69 (big blind) folded before Flop
Seat 4: xKelbi. collected (€0.29)
Seat 5: pipinoelbreve9 folded before Flop (didn't bet)
Seat 6: charlyleon92 folded on the Turn



PokerStars Zoom Hand #257559003012:  Hold'em No Limit (€0.01/€0.02) - 2025/08/31 19:10:56 CET [2025/08/31 13:10:56 ET]
Table 'Arneb' 6-max Seat #1 is the button
Seat 1: pipinoelbreve9 (€3.65 in chips) 
Seat 2: 34pluto (€1.84 in chips) 
Seat 3: pucelazo (€2.08 in chips) 
Seat 4: masquisiera (€1.96 in chips) 
Seat 5: HGrenha (€0.27 in chips) 
Seat 6: Emmcy (€2 in chips) 
34pluto: posts small blind €0.01
pucelazo: posts big blind €0.02
*** HOLE CARDS ***
Dealt to pipinoelbreve9 [4c 2d]
masquisiera: raises €0.04 to €0.06
HGrenha: raises €0.21 to €0.27 and is all-in
Emmcy: folds 
pipinoelbreve9: folds 
34pluto: folds 
pucelazo: folds 
masquisiera: calls €0.21
*** FLOP *** [Kd Qs 2h]
*** TURN *** [Kd Qs 2h] [9d]
*** RIVER *** [Kd Qs 2h 9d] [Ts]
*** SHOW DOWN ***
masquisiera: shows [5h 7h] (high card King)
HGrenha: shows [6s Td] (a pair of Tens)
HGrenha collected €0.54 from pot
*** SUMMARY ***
Total pot €0.57 | Rake €0.03 
Board [Kd Qs 2h 9d Ts]
Seat 1: pipinoelbreve9 (button) folded before Flop (didn't bet)
Seat 2: 34pluto (small blind) folded before Flop
Seat 3: pucelazo (big blind) folded before Flop
Seat 4: masquisiera showed [5h 7h] and lost with high card King
Seat 5: HGrenha showed [6s Td] and won (€0.54) with a pair of Tens
Seat 6: Emmcy folded before Flop (didn't bet)



PokerStars Zoom Hand #257559006394:  Hold'em No Limit (€0.01/€0.02) - 2025/08/31 19:11:10 CET [2025/08/31 13:11:10 ET]
Table 'Arneb' 6-max Seat #1 is the button
Seat 1: candarias (€1.87 in chips) 
Seat 2: janjos69 (€1.24 in chips) 
Seat 3: Desmd72 (€2.28 in chips) 
Seat 4: pipinoelbreve9 (€3.65 in chips) 
Seat 5: Gginer2812 (€1.15 in chips) 
Seat 6: dday14540 (€2.02 in chips) 
janjos69: posts small blind €0.01
Desmd72: posts big blind €0.02
*** HOLE CARDS ***
Dealt to pipinoelbreve9 [7s 4s]
pipinoelbreve9: folds 
Gginer2812: folds 
dday14540: raises €0.04 to €0.06
candarias: folds 
janjos69: folds 
Desmd72: folds 
Uncalled bet (€0.04) returned to dday14540
dday14540 collected €0.05 from pot
dday14540: doesn't show hand 
*** SUMMARY ***
Total pot €0.05 | Rake €0 
Seat 1: candarias (button) folded before Flop (didn't bet)
Seat 2: janjos69 (small blind) folded before Flop
Seat 3: Desmd72 (big blind) folded before Flop
Seat 4: pipinoelbreve9 folded before Flop (didn't bet)
Seat 5: Gginer2812 folded before Flop (didn't bet)
Seat 6: dday14540 collected (€0.05)



PokerStars Zoom Hand #257559001636:  Hold'em No Limit (€0.01/€0.02) - 2025/08/31 19:10:51 CET [2025/08/31 13:10:51 ET]
Table 'Arneb' 6-max Seat #1 is the button
Seat 1: xKelbi. (€2.41 in chips) 
Seat 2: FELIPE439 (€2.05 in chips) 
Seat 3: Choonchas (€1.39 in chips) 
Seat 4: Bad_Tripss (€2.58 in chips) 
Seat 5: BestiaESP12 (€2.04 in chips) 
Seat 6: pipinoelbreve9 (€3.65 in chips) 
FELIPE439: posts small blind €0.01
Choonchas: posts big blind €0.02
*** HOLE CARDS ***
Dealt to pipinoelbreve9 [5d 9c]
Bad_Tripss: folds 
BestiaESP12: folds 
pipinoelbreve9: folds 
xKelbi.: folds 
FELIPE439: raises €0.04 to €0.06
Choonchas: calls €0.04
*** FLOP *** [2d 9d 5c]
FELIPE439: bets €0.06
Choonchas: calls €0.06
*** TURN *** [2d 9d 5c] [3c]
FELIPE439: bets €0.12
Choonchas: raises €0.14 to €0.26
FELIPE439: calls €0.14
*** RIVER *** [2d 9d 5c 3c] [Qs]
FELIPE439: checks 
Choonchas: bets €0.54
FELIPE439: calls €0.54
*** SHOW DOWN ***
Choonchas: shows [Js Jd] (a pair of Jacks)
FELIPE439: shows [Qc 8c] (a pair of Queens)
FELIPE439 collected €1.75 from pot
*** SUMMARY ***
Total pot €1.84 | Rake €0.09 
Board [2d 9d 5c 3c Qs]
Seat 1: xKelbi. (button) folded before Flop (didn't bet)
Seat 2: FELIPE439 (small blind) showed [Qc 8c] and won (€1.75) with a pair of Queens
Seat 3: Choonchas (big blind) showed [Js Jd] and lost with a pair of Jacks
Seat 4: Bad_Tripss folded before Flop (didn't bet)
Seat 5: BestiaESP12 folded before Flop (didn't bet)
Seat 6: pipinoelbreve9 folded before Flop (didn't bet)



PokerStars Zoom Hand #257559007704:  Hold'em No Limit (€0.01/€0.02) - 2025/08/31 19:11:15 CET [2025/08/31 13:11:15 ET]
Table 'Arneb' 6-max Seat #1 is the button
Seat 1: FELIPE439 (€6.01 in chips) 
Seat 2: julsau81 (€2.34 in chips) 
Seat 3: pipinoelbreve9 (€3.65 in chips) 
Seat 4: pucelazo (€2 in chips) 
Seat 5: LGC04 (€1.97 in chips) 
Seat 6: janjos69 (€1.23 in chips) 
julsau81: posts small blind €0.01
pipinoelbreve9: posts big blind €0.02
*** HOLE CARDS ***
Dealt to pipinoelbreve9 [4h 5s]
pucelazo: folds 
LGC04 has timed out
LGC04: folds 
janjos69: folds 
FELIPE439: folds 
julsau81: folds 
Uncalled bet (€0.01) returned to pipinoelbreve9
pipinoelbreve9 collected €0.02 from pot
pipinoelbreve9: doesn't show hand 
*** SUMMARY ***
Total pot €0.02 | Rake €0 
Seat 1: FELIPE439 (button) folded before Flop (didn't bet)
Seat 2: julsau81 (small blind) folded before Flop
Seat 3: pipinoelbreve9 (big blind) collected (€0.02)
Seat 4: pucelazo folded before Flop (didn't bet)
Seat 5: LGC04 folded before Flop (didn't bet)
Seat 6: janjos69 folded before Flop (didn't bet)



PokerStars Zoom Hand #257559016086:  Hold'em No Limit (€0.01/€0.02) - 2025/08/31 19:11:49 CET [2025/08/31 13:11:49 ET]
Table 'Arneb' 6-max Seat #1 is the button
Seat 1: trinityandme (€1.46 in chips) 
Seat 2: pipinoelbreve9 (€3.66 in chips) 
Seat 3: issatop (€1.21 in chips) 
Seat 4: xKelbi. (€2.16 in chips) 
Seat 5: dday14540 (€2.03 in chips) 
Seat 6: ZoasHein (€3.58 in chips) 
pipinoelbreve9: posts small blind €0.01
issatop: posts big blind €0.02
*** HOLE CARDS ***
Dealt to pipinoelbreve9 [3d Qh]
xKelbi.: raises €0.04 to €0.06
dday14540: folds 
ZoasHein: folds 
trinityandme: folds 
pipinoelbreve9: folds 
issatop: calls €0.04
*** FLOP *** [Qs Ks Qc]
issatop: checks 
xKelbi.: bets €0.08
issatop: folds 
Uncalled bet (€0.08) returned to xKelbi.
xKelbi. collected €0.12 from pot
xKelbi.: doesn't show hand 
*** SUMMARY ***
Total pot €0.13 | Rake €0.01 
Board [Qs Ks Qc]
Seat 1: trinityandme (button) folded before Flop (didn't bet)
Seat 2: pipinoelbreve9 (small blind) folded before Flop
Seat 3: issatop (big blind) folded on the Flop
Seat 4: xKelbi. collected (€0.12)
Seat 5: dday14540 folded before Flop (didn't bet)
Seat 6: ZoasHein folded before Flop (didn't bet)



PokerStars Zoom Hand #257559019911:  Hold'em No Limit (€0.01/€0.02) - 2025/08/31 19:12:05 CET [2025/08/31 13:12:05 ET]
Table 'Arneb' 6-max Seat #1 is the button
Seat 1: odace15 (€2.79 in chips) 
Seat 2: kaou35 (€4.10 in chips) 
Seat 3: Popins0011 (€2.38 in chips) 
Seat 4: pipinoelbreve9 (€3.65 in chips) 
Seat 5: andresrodr8 (€2.78 in chips) 
Seat 6: julsau81 (€2.33 in chips) 
kaou35: posts small blind €0.01
Popins0011: posts big blind €0.02
*** HOLE CARDS ***
Dealt to pipinoelbreve9 [8h Kh]
pipinoelbreve9: raises €0.04 to €0.06
andresrodr8: folds 
julsau81: folds 
odace15: folds 
kaou35: folds 
Popins0011: folds 
Uncalled bet (€0.04) returned to pipinoelbreve9
pipinoelbreve9 collected €0.05 from pot
pipinoelbreve9: doesn't show hand 
*** SUMMARY ***
Total pot €0.05 | Rake €0 
Seat 1: odace15 (button) folded before Flop (didn't bet)
Seat 2: kaou35 (small blind) folded before Flop
Seat 3: Popins0011 (big blind) folded before Flop
Seat 4: pipinoelbreve9 collected (€0.05)
Seat 5: andresrodr8 folded before Flop (didn't bet)
Seat 6: julsau81 folded before Flop (didn't bet)



PokerStars Zoom Hand #257559023907:  Hold'em No Limit (€0.01/€0.02) - 2025/08/31 19:12:21 CET [2025/08/31 13:12:21 ET]
Table 'Arneb' 6-max Seat #1 is the button
Seat 1: LGC04 (€1.90 in chips) 
Seat 2: pipinoelbreve9 (€3.68 in chips) 
Seat 3: TIOGUY7 (€0.98 in chips) 
Seat 4: SLUSMYMXPT (€2 in chips) 
Seat 5: marcosbalsaa (€5.63 in chips) 
Seat 6: juan@luis800 (€2 in chips) 
pipinoelbreve9: posts small blind €0.01
TIOGUY7: posts big blind €0.02
*** HOLE CARDS ***
Dealt to pipinoelbreve9 [7s 8c]
SLUSMYMXPT: raises €0.05 to €0.07
marcosbalsaa: folds 
juan@luis800: folds 
LGC04: folds 
pipinoelbreve9: folds 
TIOGUY7: folds 
Uncalled bet (€0.05) returned to SLUSMYMXPT
SLUSMYMXPT collected €0.05 from pot
SLUSMYMXPT: doesn't show hand 
*** SUMMARY ***
Total pot €0.05 | Rake €0 
Seat 1: LGC04 (button) folded before Flop (didn't bet)
Seat 2: pipinoelbreve9 (small blind) folded before Flop
Seat 3: TIOGUY7 (big blind) folded before Flop
Seat 4: SLUSMYMXPT collected (€0.05)
Seat 5: marcosbalsaa folded before Flop (didn't bet)
Seat 6: juan@luis800 folded before Flop (didn't bet)



PokerStars Zoom Hand #257559025145:  Hold'em No Limit (€0.01/€0.02) - 2025/08/31 19:12:26 CET [2025/08/31 13:12:26 ET]
Table 'Arneb' 6-max Seat #1 is the button
Seat 1: pipinoelbreve9 (€3.67 in chips) 
Seat 2: 34pluto (€1.81 in chips) 
Seat 3: Mai SA135 (€2.19 in chips) 
Seat 4: juan@luis800 (€2 in chips) 
Seat 5: pucelazo (€2.01 in chips) 
Seat 6: GRAKETIN (€2.56 in chips) 
34pluto: posts small blind €0.01
Mai SA135: posts big blind €0.02
*** HOLE CARDS ***
Dealt to pipinoelbreve9 [9h 9c]
juan@luis800: folds 
pucelazo: folds 
GRAKETIN: folds 
pipinoelbreve9: raises €0.04 to €0.06
34pluto: folds 
Mai SA135: folds 
Uncalled bet (€0.04) returned to pipinoelbreve9
pipinoelbreve9 collected €0.05 from pot
pipinoelbreve9: doesn't show hand 
*** SUMMARY ***
Total pot €0.05 | Rake €0 
Seat 1: pipinoelbreve9 (button) collected (€0.05)
Seat 2: 34pluto (small blind) folded before Flop
Seat 3: Mai SA135 (big blind) folded before Flop
Seat 4: juan@luis800 folded before Flop (didn't bet)
Seat 5: pucelazo folded before Flop (didn't bet)
Seat 6: GRAKETIN folded before Flop (didn't bet)



PokerStars Zoom Hand #257559031898:  Hold'em No Limit (€0.01/€0.02) - 2025/08/31 19:12:53 CET [2025/08/31 13:12:53 ET]
Table 'Arneb' 6-max Seat #1 is the button
Seat 1: BestiaESP12 (€2.03 in chips) 
Seat 2: McMack626 (€1.98 in chips) 
Seat 3: OMaisPesado1 (€2.86 in chips) 
Seat 4: 34pluto (€0.71 in chips) 
Seat 5: chriscoco08 (€2.30 in chips) 
Seat 6: pipinoelbreve9 (€3.70 in chips) 
McMack626: posts small blind €0.01
OMaisPesado1: posts big blind €0.02
*** HOLE CARDS ***
Dealt to pipinoelbreve9 [Th 4s]
34pluto: folds 
chriscoco08: raises €0.03 to €0.05
pipinoelbreve9: folds 
BestiaESP12: folds 
McMack626: raises €0.05 to €0.10
OMaisPesado1: folds 
chriscoco08: folds 
Uncalled bet (€0.05) returned to McMack626
McMack626 collected €0.12 from pot
McMack626: doesn't show hand 
*** SUMMARY ***
Total pot €0.12 | Rake €0 
Seat 1: BestiaESP12 (button) folded before Flop (didn't bet)
Seat 2: McMack626 (small blind) collected (€0.12)
Seat 3: OMaisPesado1 (big blind) folded before Flop
Seat 4: 34pluto folded before Flop (didn't bet)
Seat 5: chriscoco08 folded before Flop
Seat 6: pipinoelbreve9 folded before Flop (didn't bet)



PokerStars Zoom Hand #257559033274:  Hold'em No Limit (€0.01/€0.02) - 2025/08/31 19:12:58 CET [2025/08/31 13:12:58 ET]
Table 'Arneb' 6-max Seat #1 is the button
Seat 1: Choonchas (€0.90 in chips) 
Seat 2: marcosbalsaa (€5.64 in chips) 
Seat 3: pipinoelbreve9 (€3.70 in chips) 
Seat 4: Jota_uVe_1 (€2.16 in chips) 
Seat 5: laprimera65 (€2.53 in chips) 
Seat 6: cruass (€1.94 in chips) 
marcosbalsaa: posts small blind €0.01
pipinoelbreve9: posts big blind €0.02
*** HOLE CARDS ***
Dealt to pipinoelbreve9 [5c 9h]
Jota_uVe_1: folds 
laprimera65: folds 
cruass: folds 
Choonchas: raises €0.03 to €0.05
marcosbalsaa: folds 
pipinoelbreve9: folds 
Uncalled bet (€0.03) returned to Choonchas
Choonchas collected €0.05 from pot
Choonchas: doesn't show hand 
*** SUMMARY ***
Total pot €0.05 | Rake €0 
Seat 1: Choonchas (button) collected (€0.05)
Seat 2: marcosbalsaa (small blind) folded before Flop
Seat 3: pipinoelbreve9 (big blind) folded before Flop
Seat 4: Jota_uVe_1 folded before Flop (didn't bet)
Seat 5: laprimera65 folded before Flop (didn't bet)
Seat 6: cruass folded before Flop (didn't bet)



PokerStars Zoom Hand #257559030400:  Hold'em No Limit (€0.01/€0.02) - 2025/08/31 19:12:47 CET [2025/08/31 13:12:47 ET]
Table 'Arneb' 6-max Seat #1 is the button
Seat 1: serviettski(fr) (€3.59 in chips) 
Seat 2: Gginer2812 (€1.12 in chips) 
Seat 3: thenry03 (€1.99 in chips) 
Seat 4: TIOGUY7 (€0.95 in chips) 
Seat 5: madn1994 (€1.62 in chips) 
Seat 6: pipinoelbreve9 (€3.70 in chips) 
Gginer2812: posts small blind €0.01
thenry03: posts big blind €0.02
*** HOLE CARDS ***
Dealt to pipinoelbreve9 [9h Tc]
TIOGUY7: folds 
madn1994: calls €0.02
pipinoelbreve9: folds 
serviettski(fr): folds 
Gginer2812: folds 
thenry03: checks 
*** FLOP *** [Qd Jc Kc]
thenry03: checks 
madn1994: bets €0.06
thenry03: calls €0.06
*** TURN *** [Qd Jc Kc] [3s]
thenry03: checks 
madn1994: bets €0.08
thenry03: calls €0.08
*** RIVER *** [Qd Jc Kc 3s] [5s]
thenry03: checks 
madn1994: bets €0.18
thenry03: calls €0.18
*** SHOW DOWN ***
madn1994: shows [Kd 6d] (a pair of Kings)
thenry03: shows [7d Kh] (a pair of Kings - Queen+Jack+Seven kicker)
thenry03 collected €0.66 from pot
*** SUMMARY ***
Total pot €0.69 | Rake €0.03 
Board [Qd Jc Kc 3s 5s]
Seat 1: serviettski(fr) (button) folded before Flop (didn't bet)
Seat 2: Gginer2812 (small blind) folded before Flop
Seat 3: thenry03 (big blind) showed [7d Kh] and won (€0.66) with a pair of Kings
Seat 4: TIOGUY7 folded before Flop (didn't bet)
Seat 5: madn1994 showed [Kd 6d] and lost with a pair of Kings
Seat 6: pipinoelbreve9 folded before Flop (didn't bet)



PokerStars Zoom Hand #257559040225:  Hold'em No Limit (€0.01/€0.02) - 2025/08/31 19:13:26 CET [2025/08/31 13:13:26 ET]
Table 'Arneb' 6-max Seat #1 is the button
Seat 1: pipinoelbreve9 (€3.68 in chips) 
Seat 2: McMack626 (€1.16 in chips) 
Seat 3: vayewis (€2.56 in chips) 
Seat 4: LGC04 (€1.62 in chips) 
Seat 5: BestiaESP12 (€2.52 in chips) 
Seat 6: Pitfal30 (€1 in chips) 
McMack626: posts small blind €0.01
vayewis: posts big blind €0.02
*** HOLE CARDS ***
Dealt to pipinoelbreve9 [Js Qh]
LGC04: folds 
BestiaESP12: folds 
Pitfal30: raises €0.02 to €0.04
pipinoelbreve9: raises €0.10 to €0.14
McMack626: folds 
vayewis: folds 
Pitfal30: calls €0.10
*** FLOP *** [9h Td 4d]
Pitfal30: bets €0.06
pipinoelbreve9: calls €0.06
*** TURN *** [9h Td 4d] [Ks]
Pitfal30: checks 
pipinoelbreve9: bets €0.21
Pitfal30: folds 
Uncalled bet (€0.21) returned to pipinoelbreve9
pipinoelbreve9 collected €0.41 from pot
pipinoelbreve9: doesn't show hand 
*** SUMMARY ***
Total pot €0.43 | Rake €0.02 
Board [9h Td 4d Ks]
Seat 1: pipinoelbreve9 (button) collected (€0.41)
Seat 2: McMack626 (small blind) folded before Flop
Seat 3: vayewis (big blind) folded before Flop
Seat 4: LGC04 folded before Flop (didn't bet)
Seat 5: BestiaESP12 folded before Flop (didn't bet)
Seat 6: Pitfal30 folded on the Turn



PokerStars Zoom Hand #257559049918:  Hold'em No Limit (€0.01/€0.02) - 2025/08/31 19:14:06 CET [2025/08/31 13:14:06 ET]
Table 'Arneb' 6-max Seat #1 is the button
Seat 1: spain229 (€0.92 in chips) 
Seat 2: candarias (€1.98 in chips) 
Seat 3: Manuxanxe78 (€3.87 in chips) 
Seat 4: andresrodr8 (€3.97 in chips) 
Seat 5: pipinoelbreve9 (€3.89 in chips) 
Seat 6: DriztDUrden (€0.67 in chips) 
candarias: posts small blind €0.01
Manuxanxe78: posts big blind €0.02
*** HOLE CARDS ***
Dealt to pipinoelbreve9 [3h Qd]
andresrodr8: folds 
pipinoelbreve9: folds 
DriztDUrden: folds 
spain229: raises €0.04 to €0.06
candarias: folds 
Manuxanxe78: folds 
Uncalled bet (€0.04) returned to spain229
spain229 collected €0.05 from pot
spain229: doesn't show hand 
*** SUMMARY ***
Total pot €0.05 | Rake €0 
Seat 1: spain229 (button) collected (€0.05)
Seat 2: candarias (small blind) folded before Flop
Seat 3: Manuxanxe78 (big blind) folded before Flop
Seat 4: andresrodr8 folded before Flop (didn't bet)
Seat 5: pipinoelbreve9 folded before Flop (didn't bet)
Seat 6: DriztDUrden folded before Flop (didn't bet)



PokerStars Zoom Hand #257559051235:  Hold'em No Limit (€0.01/€0.02) - 2025/08/31 19:14:11 CET [2025/08/31 13:14:11 ET]
Table 'Arneb' 6-max Seat #1 is the button
Seat 1: marcosbalsaa (€4.62 in chips) 
Seat 2: candarias (€0.95 in chips) 
Seat 3: DriztDUrden (€0.67 in chips) 
Seat 4: Emmcy (€2 in chips) 
Seat 5: pipinoelbreve9 (€3.89 in chips) 
Seat 6: Pitfal30 (€0.80 in chips) 
candarias: posts small blind €0.01
DriztDUrden: posts big blind €0.02
*** HOLE CARDS ***
Dealt to pipinoelbreve9 [Qs 7h]
Emmcy: folds 
pipinoelbreve9: folds 
Pitfal30: folds 
marcosbalsaa: folds 
candarias: folds 
Uncalled bet (€0.01) returned to DriztDUrden
DriztDUrden collected €0.02 from pot
DriztDUrden: doesn't show hand 
*** SUMMARY ***
Total pot €0.02 | Rake €0 
Seat 1: marcosbalsaa (button) folded before Flop (didn't bet)
Seat 2: candarias (small blind) folded before Flop
Seat 3: DriztDUrden (big blind) collected (€0.02)
Seat 4: Emmcy folded before Flop (didn't bet)
Seat 5: pipinoelbreve9 folded before Flop (didn't bet)
Seat 6: Pitfal30 folded before Flop (didn't bet)



PokerStars Zoom Hand #257559052969:  Hold'em No Limit (€0.01/€0.02) - 2025/08/31 19:14:18 CET [2025/08/31 13:14:18 ET]
Table 'Arneb' 6-max Seat #1 is the button
Seat 1: QQpkrQQ (€2.10 in chips) 
Seat 2: pipinoelbreve9 (€3.89 in chips) 
Seat 3: julsau81 (€2.33 in chips) 
Seat 4: SoulfulHearts (€2.65 in chips) 
Seat 5: Manuxanxe78 (€2.65 in chips) 
Seat 6: XxVallesxX (€2 in chips) 
pipinoelbreve9: posts small blind €0.01
julsau81: posts big blind €0.02
*** HOLE CARDS ***
Dealt to pipinoelbreve9 [Jd 7d]
SoulfulHearts: folds 
Manuxanxe78: raises €0.04 to €0.06
XxVallesxX: folds 
QQpkrQQ: folds 
pipinoelbreve9: calls €0.05
julsau81: folds 
*** FLOP *** [7s Kd 2c]
pipinoelbreve9: bets €0.07
Manuxanxe78: folds 
Uncalled bet (€0.07) returned to pipinoelbreve9
pipinoelbreve9 collected €0.13 from pot
pipinoelbreve9: doesn't show hand 
*** SUMMARY ***
Total pot €0.14 | Rake €0.01 
Board [7s Kd 2c]
Seat 1: QQpkrQQ (button) folded before Flop (didn't bet)
Seat 2: pipinoelbreve9 (small blind) collected (€0.13)
Seat 3: julsau81 (big blind) folded before Flop
Seat 4: SoulfulHearts folded before Flop (didn't bet)
Seat 5: Manuxanxe78 folded on the Flop
Seat 6: XxVallesxX folded before Flop (didn't bet)



PokerStars Zoom Hand #257559061207:  Hold'em No Limit (€0.01/€0.02) - 2025/08/31 19:14:51 CET [2025/08/31 13:14:51 ET]
Table 'Arneb' 6-max Seat #1 is the button
Seat 1: laprimera65 (€2.01 in chips) 
Seat 2: andresrodr8 (€2.69 in chips) 
Seat 3: pipinoelbreve9 (€3.96 in chips) 
Seat 4: spain229 (€0.94 in chips) 
Seat 5: Emmcy (€2.07 in chips) 
Seat 6: Gginer2812 (€1.02 in chips) 
andresrodr8: posts small blind €0.01
pipinoelbreve9: posts big blind €0.02
*** HOLE CARDS ***
Dealt to pipinoelbreve9 [7s 3h]
spain229: folds 
Emmcy: folds 
Gginer2812: folds 
laprimera65: folds 
andresrodr8: folds 
Uncalled bet (€0.01) returned to pipinoelbreve9
pipinoelbreve9 collected €0.02 from pot
pipinoelbreve9: doesn't show hand 
*** SUMMARY ***
Total pot €0.02 | Rake €0 
Seat 1: laprimera65 (button) folded before Flop (didn't bet)
Seat 2: andresrodr8 (small blind) folded before Flop
Seat 3: pipinoelbreve9 (big blind) collected (€0.02)
Seat 4: spain229 folded before Flop (didn't bet)
Seat 5: Emmcy folded before Flop (didn't bet)
Seat 6: Gginer2812 folded before Flop (didn't bet)



PokerStars Zoom Hand #257559065167:  Hold'em No Limit (€0.01/€0.02) - 2025/08/31 19:15:06 CET [2025/08/31 13:15:06 ET]
Table 'Arneb' 6-max Seat #1 is the button
Seat 1: pucelazo (€2.21 in chips) 
Seat 2: xKelbi. (€2.12 in chips) 
Seat 3: Manuxanxe78 (€3.85 in chips) 
Seat 4: pipinoelbreve9 (€3.97 in chips) 
Seat 5: Älejo (€2.24 in chips) 
Seat 6: Emmcy (€2.08 in chips) 
xKelbi.: posts small blind €0.01
Manuxanxe78: posts big blind €0.02
*** HOLE CARDS ***
Dealt to pipinoelbreve9 [3c Jd]
pipinoelbreve9: folds 
Älejo: folds 
Emmcy: folds 
pucelazo: folds 
xKelbi.: folds 
Uncalled bet (€0.01) returned to Manuxanxe78
Manuxanxe78 collected €0.02 from pot
Manuxanxe78: doesn't show hand 
*** SUMMARY ***
Total pot €0.02 | Rake €0 
Seat 1: pucelazo (button) folded before Flop (didn't bet)
Seat 2: xKelbi. (small blind) folded before Flop
Seat 3: Manuxanxe78 (big blind) collected (€0.02)
Seat 4: pipinoelbreve9 folded before Flop (didn't bet)
Seat 5: Älejo folded before Flop (didn't bet)
Seat 6: Emmcy folded before Flop (didn't bet)



PokerStars Zoom Hand #257559066691:  Hold'em No Limit (€0.01/€0.02) - 2025/08/31 19:15:13 CET [2025/08/31 13:15:13 ET]
Table 'Arneb' 6-max Seat #1 is the button
Seat 1: odace15 (€2.98 in chips) 
Seat 2: pucelazo (€2.21 in chips) 
Seat 3: Bad_Tripss (€4.53 in chips) 
Seat 4: thenry03 (€2.29 in chips) 
Seat 5: pipinoelbreve9 (€3.97 in chips) 
Seat 6: charlyleon92 (€1.11 in chips) 
pucelazo: posts small blind €0.01
Bad_Tripss: posts big blind €0.02
*** HOLE CARDS ***
Dealt to pipinoelbreve9 [Ad 6h]
thenry03: folds 
pipinoelbreve9: folds 
charlyleon92: raises €0.04 to €0.06
odace15: folds 
pucelazo: folds 
Bad_Tripss: calls €0.04
*** FLOP *** [3c 4s 9c]
Bad_Tripss: checks 
charlyleon92: bets €0.10
Bad_Tripss: calls €0.10
*** TURN *** [3c 4s 9c] [6c]
Bad_Tripss: checks 
charlyleon92: checks 
*** RIVER *** [3c 4s 9c 6c] [3s]
Bad_Tripss: bets €0.10
charlyleon92: folds 
Uncalled bet (€0.10) returned to Bad_Tripss
Bad_Tripss collected €0.31 from pot
Bad_Tripss: doesn't show hand 
*** SUMMARY ***
Total pot €0.33 | Rake €0.02 
Board [3c 4s 9c 6c 3s]
Seat 1: odace15 (button) folded before Flop (didn't bet)
Seat 2: pucelazo (small blind) folded before Flop
Seat 3: Bad_Tripss (big blind) collected (€0.31)
Seat 4: thenry03 folded before Flop (didn't bet)
Seat 5: pipinoelbreve9 folded before Flop (didn't bet)
Seat 6: charlyleon92 folded on the River



PokerStars Zoom Hand #257559068823:  Hold'em No Limit (€0.01/€0.02) - 2025/08/31 19:15:21 CET [2025/08/31 13:15:21 ET]
Table 'Arneb' 6-max Seat #1 is the button
Seat 1: xKelbi. (€2.11 in chips) 
Seat 2: Manuxanxe78 (€3.86 in chips) 
Seat 3: cruass (€1.91 in chips) 
Seat 4: MagicGitox (€2.41 in chips) 
Seat 5: Uvildo (€1.99 in chips) 
Seat 6: pipinoelbreve9 (€3.97 in chips) 
Manuxanxe78: posts small blind €0.01
cruass: posts big blind €0.02
*** HOLE CARDS ***
Dealt to pipinoelbreve9 [3d Tc]
MagicGitox: folds 
Uvildo: calls €0.02
pipinoelbreve9: folds 
xKelbi.: folds 
Manuxanxe78: folds 
cruass: checks 
*** FLOP *** [Kd 2s 3c]
cruass: checks 
Uvildo: bets €0.02
cruass: folds 
Uncalled bet (€0.02) returned to Uvildo
Uvildo collected €0.05 from pot
Uvildo: doesn't show hand 
*** SUMMARY ***
Total pot €0.05 | Rake €0 
Board [Kd 2s 3c]
Seat 1: xKelbi. (button) folded before Flop (didn't bet)
Seat 2: Manuxanxe78 (small blind) folded before Flop
Seat 3: cruass (big blind) folded on the Flop
Seat 4: MagicGitox folded before Flop (didn't bet)
Seat 5: Uvildo collected (€0.05)
Seat 6: pipinoelbreve9 folded before Flop (didn't bet)



PokerStars Zoom Hand #257559074030:  Hold'em No Limit (€0.01/€0.02) - 2025/08/31 19:15:42 CET [2025/08/31 13:15:42 ET]
Table 'Arneb' 6-max Seat #1 is the button
Seat 1: marcosbalsaa (€5.71 in chips) 
Seat 2: pipinoelbreve9 (€3.97 in chips) 
Seat 3: LGC04 (€1.85 in chips) 
Seat 4: 34pluto (€0.97 in chips) 
Seat 5: odace15 (€2 in chips) 
Seat 6: Apdwins (€1.87 in chips) 
pipinoelbreve9: posts small blind €0.01
LGC04: posts big blind €0.02
*** HOLE CARDS ***
Dealt to pipinoelbreve9 [8h 3h]
34pluto: raises €0.02 to €0.04
odace15: folds 
Apdwins: folds 
marcosbalsaa: folds 
pipinoelbreve9: folds 
LGC04: folds 
Uncalled bet (€0.02) returned to 34pluto
34pluto collected €0.05 from pot
34pluto: doesn't show hand 
*** SUMMARY ***
Total pot €0.05 | Rake €0 
Seat 1: marcosbalsaa (button) folded before Flop (didn't bet)
Seat 2: pipinoelbreve9 (small blind) folded before Flop
Seat 3: LGC04 (big blind) folded before Flop
Seat 4: 34pluto collected (€0.05)
Seat 5: odace15 folded before Flop (didn't bet)
Seat 6: Apdwins folded before Flop (didn't bet)



PokerStars Zoom Hand #257559072792:  Hold'em No Limit (€0.01/€0.02) - 2025/08/31 19:15:38 CET [2025/08/31 13:15:38 ET]
Table 'Arneb' 6-max Seat #1 is the button
Seat 1: pipinoelbreve9 (€3.97 in chips) 
Seat 2: serviettski(fr) (€3.65 in chips) 
Seat 3: laprimera65 (€2.01 in chips) 
Seat 4: 34pluto (€0.97 in chips) 
Seat 5: LGC04 (€1.85 in chips) 
Seat 6: McMack626 (€1.47 in chips) 
serviettski(fr): posts small blind €0.01
laprimera65: posts big blind €0.02
*** HOLE CARDS ***
Dealt to pipinoelbreve9 [8d 4h]
34pluto: folds 
LGC04: folds 
McMack626: raises €0.02 to €0.04
pipinoelbreve9: folds 
serviettski(fr): folds 
laprimera65: calls €0.02
*** FLOP *** [8c As 2h]
laprimera65: checks 
McMack626: bets €0.06
laprimera65: folds 
Uncalled bet (€0.06) returned to McMack626
McMack626 collected €0.09 from pot
McMack626: doesn't show hand 
*** SUMMARY ***
Total pot €0.09 | Rake €0 
Board [8c As 2h]
Seat 1: pipinoelbreve9 (button) folded before Flop (didn't bet)
Seat 2: serviettski(fr) (small blind) folded before Flop
Seat 3: laprimera65 (big blind) folded on the Flop
Seat 4: 34pluto folded before Flop (didn't bet)
Seat 5: LGC04 folded before Flop (didn't bet)
Seat 6: McMack626 collected (€0.09)



PokerStars Zoom Hand #257559070924:  Hold'em No Limit (€0.01/€0.02) - 2025/08/31 19:15:30 CET [2025/08/31 13:15:30 ET]
Table 'Arneb' 6-max Seat #1 is the button
Seat 1: Manuxanxe78 (€2 in chips) 
Seat 2: cuenca10 (€3.14 in chips) 
Seat 3: vayewis (€3.71 in chips) 
Seat 4: pipinoelbreve9 (€3.97 in chips) 
Seat 5: candarias (€0.97 in chips) 
Seat 6: issatop (€2.05 in chips) 
cuenca10: posts small blind €0.01
vayewis: posts big blind €0.02
*** HOLE CARDS ***
Dealt to pipinoelbreve9 [7s 2h]
pipinoelbreve9: folds 
candarias: calls €0.02
issatop: raises €0.02 to €0.04
Manuxanxe78: folds 
cuenca10: calls €0.03
vayewis: folds 
candarias: raises €0.14 to €0.18
issatop: folds 
cuenca10: folds 
Uncalled bet (€0.14) returned to candarias
candarias collected €0.14 from pot
candarias: doesn't show hand 
*** SUMMARY ***
Total pot €0.14 | Rake €0 
Seat 1: Manuxanxe78 (button) folded before Flop (didn't bet)
Seat 2: cuenca10 (small blind) folded before Flop
Seat 3: vayewis (big blind) folded before Flop
Seat 4: pipinoelbreve9 folded before Flop (didn't bet)
Seat 5: candarias collected (€0.14)
Seat 6: issatop folded before Flop



PokerStars Zoom Hand #257559075486:  Hold'em No Limit (€0.01/€0.02) - 2025/08/31 19:15:48 CET [2025/08/31 13:15:48 ET]
Table 'Arneb' 6-max Seat #1 is the button
Seat 1: LGC04 (€1.83 in chips) 
Seat 2: Gginer2812 (€1.05 in chips) 
Seat 3: pipinoelbreve9 (€3.96 in chips) 
Seat 4: xKelbi. (€2.11 in chips) 
Seat 5: pucelazo (€2.25 in chips) 
Seat 6: marcosbalsaa (€5.71 in chips) 
Gginer2812: posts small blind €0.01
pipinoelbreve9: posts big blind €0.02
*** HOLE CARDS ***
Dealt to pipinoelbreve9 [3c Ac]
xKelbi.: folds 
pucelazo: folds 
marcosbalsaa: raises €0.04 to €0.06
LGC04: folds 
Gginer2812: folds 
pipinoelbreve9: raises €0.13 to €0.19
marcosbalsaa: raises €5.52 to €5.71 and is all-in
pipinoelbreve9: folds 
Uncalled bet (€5.52) returned to marcosbalsaa
marcosbalsaa collected €0.39 from pot
marcosbalsaa: doesn't show hand 
*** SUMMARY ***
Total pot €0.39 | Rake €0 
Seat 1: LGC04 (button) folded before Flop (didn't bet)
Seat 2: Gginer2812 (small blind) folded before Flop
Seat 3: pipinoelbreve9 (big blind) folded before Flop
Seat 4: xKelbi. folded before Flop (didn't bet)
Seat 5: pucelazo folded before Flop (didn't bet)
Seat 6: marcosbalsaa collected (€0.39)



PokerStars Zoom Hand #257559082034:  Hold'em No Limit (€0.01/€0.02) - 2025/08/31 19:16:14 CET [2025/08/31 13:16:14 ET]
Table 'Arneb' 6-max Seat #1 is the button
Seat 1: Bad_Tripss (€2.95 in chips) 
Seat 2: hope201319 (€1.68 in chips) 
Seat 3: BestiaESP12 (€2.92 in chips) 
Seat 4: Manuxanxe78 (€2.56 in chips) 
Seat 5: pipinoelbreve9 (€3.77 in chips) 
Seat 6: 34pluto (€1.31 in chips) 
hope201319: posts small blind €0.01
BestiaESP12: posts big blind €0.02
*** HOLE CARDS ***
Dealt to pipinoelbreve9 [Qh Kh]
Manuxanxe78: folds 
pipinoelbreve9: raises €0.04 to €0.06
34pluto: folds 
Bad_Tripss: folds 
hope201319: folds 
BestiaESP12: folds 
Uncalled bet (€0.04) returned to pipinoelbreve9
pipinoelbreve9 collected €0.05 from pot
pipinoelbreve9: doesn't show hand 
*** SUMMARY ***
Total pot €0.05 | Rake €0 
Seat 1: Bad_Tripss (button) folded before Flop (didn't bet)
Seat 2: hope201319 (small blind) folded before Flop
Seat 3: BestiaESP12 (big blind) folded before Flop
Seat 4: Manuxanxe78 folded before Flop (didn't bet)
Seat 5: pipinoelbreve9 collected (€0.05)
Seat 6: 34pluto folded before Flop (didn't bet)



PokerStars Zoom Hand #257559086378:  Hold'em No Limit (€0.01/€0.02) - 2025/08/31 19:16:32 CET [2025/08/31 13:16:32 ET]
Table 'Arneb' 6-max Seat #1 is the button
Seat 1: pipinoelbreve9 (€3.80 in chips) 
Seat 2: BestiaESP12 (€2.90 in chips) 
Seat 3: PrendsCa (€2 in chips) 
Seat 4: Choonchas (€1.11 in chips) 
Seat 5: marcosbalsaa (€5.90 in chips) 
Seat 6: Bilintx703 (€2 in chips) 
BestiaESP12: posts small blind €0.01
PrendsCa: posts big blind €0.02
*** HOLE CARDS ***
Dealt to pipinoelbreve9 [4d 5h]
Choonchas: raises €0.03 to €0.05
marcosbalsaa: folds 
Bilintx703: folds 
pipinoelbreve9: folds 
BestiaESP12: folds 
PrendsCa: folds 
Uncalled bet (€0.03) returned to Choonchas
Choonchas collected €0.05 from pot
Choonchas: doesn't show hand 
*** SUMMARY ***
Total pot €0.05 | Rake €0 
Seat 1: pipinoelbreve9 (button) folded before Flop (didn't bet)
Seat 2: BestiaESP12 (small blind) folded before Flop
Seat 3: PrendsCa (big blind) folded before Flop
Seat 4: Choonchas collected (€0.05)
Seat 5: marcosbalsaa folded before Flop (didn't bet)
Seat 6: Bilintx703 folded before Flop (didn't bet)



PokerStars Zoom Hand #257559088554:  Hold'em No Limit (€0.01/€0.02) - 2025/08/31 19:16:40 CET [2025/08/31 13:16:40 ET]
Table 'Arneb' 6-max Seat #1 is the button
Seat 1: 34pluto (€0.95 in chips) 
Seat 2: pipinoelbreve9 (€3.80 in chips) 
Seat 3: Manuxanxe78 (€3.92 in chips) 
Seat 4: kaou35 (€3.52 in chips) 
Seat 5: Mai SA135 (€1.68 in chips) 
Seat 6: MagicGitox (€2.41 in chips) 
pipinoelbreve9: posts small blind €0.01
Manuxanxe78: posts big blind €0.02
*** HOLE CARDS ***
Dealt to pipinoelbreve9 [Jh Ah]
kaou35: folds 
Mai SA135: raises €0.04 to €0.06
MagicGitox: folds 
34pluto: folds 
pipinoelbreve9: raises €0.12 to €0.18
Manuxanxe78: folds 
Mai SA135: raises €0.20 to €0.38
pipinoelbreve9: calls €0.20
*** FLOP *** [Kd 3s 4c]
pipinoelbreve9: checks 
Mai SA135: bets €0.37
pipinoelbreve9: folds 
Uncalled bet (€0.37) returned to Mai SA135
Mai SA135 collected €0.74 from pot
Mai SA135: doesn't show hand 
*** SUMMARY ***
Total pot €0.78 | Rake €0.04 
Board [Kd 3s 4c]
Seat 1: 34pluto (button) folded before Flop (didn't bet)
Seat 2: pipinoelbreve9 (small blind) folded on the Flop
Seat 3: Manuxanxe78 (big blind) folded before Flop
Seat 4: kaou35 folded before Flop (didn't bet)
Seat 5: Mai SA135 collected (€0.74)
Seat 6: MagicGitox folded before Flop (didn't bet)



PokerStars Zoom Hand #257559104504:  Hold'em No Limit (€0.01/€0.02) - 2025/08/31 19:17:44 CET [2025/08/31 13:17:44 ET]
Table 'Arneb' 6-max Seat #1 is the button
Seat 1: Älejo (€2.17 in chips) 
Seat 2: Bad_Tripss (€4.62 in chips) 
Seat 3: juan@luis800 (€1.63 in chips) 
Seat 4: pipinoelbreve9 (€3.42 in chips) 
Seat 5: Manuxanxe78 (€2.06 in chips) 
Seat 6: trinityandme (€2 in chips) 
Bad_Tripss: posts small blind €0.01
juan@luis800: posts big blind €0.02
*** HOLE CARDS ***
Dealt to pipinoelbreve9 [4s 3c]
pipinoelbreve9: folds 
Manuxanxe78: folds 
trinityandme: folds 
Älejo: folds 
Bad_Tripss: raises €0.04 to €0.06
juan@luis800: folds 
Uncalled bet (€0.04) returned to Bad_Tripss
Bad_Tripss collected €0.04 from pot
Bad_Tripss: doesn't show hand 
*** SUMMARY ***
Total pot €0.04 | Rake €0 
Seat 1: Älejo (button) folded before Flop (didn't bet)
Seat 2: Bad_Tripss (small blind) collected (€0.04)
Seat 3: juan@luis800 (big blind) folded before Flop
Seat 4: pipinoelbreve9 folded before Flop (didn't bet)
Seat 5: Manuxanxe78 folded before Flop (didn't bet)
Seat 6: trinityandme folded before Flop (didn't bet)



PokerStars Zoom Hand #257559105832:  Hold'em No Limit (€0.01/€0.02) - 2025/08/31 19:17:50 CET [2025/08/31 13:17:50 ET]
Table 'Arneb' 6-max Seat #1 is the button
Seat 1: xKelbi. (€2.21 in chips) 
Seat 2: ZoasHein (€3.04 in chips) 
Seat 3: pipinoelbreve9 (€3.42 in chips) 
Seat 4: Jota_uVe_1 (€2.06 in chips) 
Seat 5: LGC04 (€2.03 in chips) 
Seat 6: QQpkrQQ (€2 in chips) 
ZoasHein: posts small blind €0.01
pipinoelbreve9: posts big blind €0.02
*** HOLE CARDS ***
Dealt to pipinoelbreve9 [2d Ks]
Jota_uVe_1: raises €0.03 to €0.05
LGC04: folds 
QQpkrQQ: calls €0.05
xKelbi.: folds 
ZoasHein: folds 
pipinoelbreve9: folds 
*** FLOP *** [5d 6c 7h]
Jota_uVe_1: bets €0.04
QQpkrQQ: folds 
Uncalled bet (€0.04) returned to Jota_uVe_1
Jota_uVe_1 collected €0.12 from pot
Jota_uVe_1: doesn't show hand 
*** SUMMARY ***
Total pot €0.13 | Rake €0.01 
Board [5d 6c 7h]
Seat 1: xKelbi. (button) folded before Flop (didn't bet)
Seat 2: ZoasHein (small blind) folded before Flop
Seat 3: pipinoelbreve9 (big blind) folded before Flop
Seat 4: Jota_uVe_1 collected (€0.12)
Seat 5: LGC04 folded before Flop (didn't bet)
Seat 6: QQpkrQQ folded on the Flop



PokerStars Zoom Hand #257559107886:  Hold'em No Limit (€0.01/€0.02) - 2025/08/31 19:17:58 CET [2025/08/31 13:17:58 ET]
Table 'Arneb' 6-max Seat #1 is the button
Seat 1: McMack626 (€1.46 in chips) 
Seat 2: juan@luis800 (€1.61 in chips) 
Seat 3: juolivs (€0.97 in chips) 
Seat 4: hope201319 (€1.71 in chips) 
Seat 5: Älejo (€2.18 in chips) 
Seat 6: pipinoelbreve9 (€3.40 in chips) 
juan@luis800: posts small blind €0.01
juolivs: posts big blind €0.02
*** HOLE CARDS ***
Dealt to pipinoelbreve9 [3h 3d]
hope201319: folds 
Älejo: raises €0.04 to €0.06
pipinoelbreve9: calls €0.06
McMack626: folds 
juan@luis800: folds 
juolivs: calls €0.04
*** FLOP *** [Jh 4h 8c]
juolivs: checks 
Älejo: bets €0.06
pipinoelbreve9: folds 
juolivs: folds 
Uncalled bet (€0.06) returned to Älejo
Älejo collected €0.18 from pot
Älejo: doesn't show hand 
*** SUMMARY ***
Total pot €0.19 | Rake €0.01 
Board [Jh 4h 8c]
Seat 1: McMack626 (button) folded before Flop (didn't bet)
Seat 2: juan@luis800 (small blind) folded before Flop
Seat 3: juolivs (big blind) folded on the Flop
Seat 4: hope201319 folded before Flop (didn't bet)
Seat 5: Älejo collected (€0.18)
Seat 6: pipinoelbreve9 folded on the Flop



PokerStars Zoom Hand #257559113201:  Hold'em No Limit (€0.01/€0.02) - 2025/08/31 19:18:20 CET [2025/08/31 13:18:20 ET]
Table 'Arneb' 6-max Seat #1 is the button
Seat 1: Choonchas (€0.98 in chips) 
Seat 2: charlyleon92 (€1.66 in chips) 
Seat 3: Jota_uVe_1 (€2.13 in chips) 
Seat 4: andresrodr8 (€2.55 in chips) 
Seat 5: pipinoelbreve9 (€3.34 in chips) 
Seat 6: marcel13013 (€2.19 in chips) 
charlyleon92: posts small blind €0.01
Jota_uVe_1: posts big blind €0.02
*** HOLE CARDS ***
Dealt to pipinoelbreve9 [Jd 3c]
andresrodr8: folds 
pipinoelbreve9: folds 
marcel13013: folds 
Choonchas: raises €0.03 to €0.05
charlyleon92: folds 
Jota_uVe_1: folds 
Uncalled bet (€0.03) returned to Choonchas
Choonchas collected €0.05 from pot
Choonchas: doesn't show hand 
*** SUMMARY ***
Total pot €0.05 | Rake €0 
Seat 1: Choonchas (button) collected (€0.05)
Seat 2: charlyleon92 (small blind) folded before Flop
Seat 3: Jota_uVe_1 (big blind) folded before Flop
Seat 4: andresrodr8 folded before Flop (didn't bet)
Seat 5: pipinoelbreve9 folded before Flop (didn't bet)
Seat 6: marcel13013 folded before Flop (didn't bet)



PokerStars Zoom Hand #257559117337:  Hold'em No Limit (€0.01/€0.02) - 2025/08/31 19:18:36 CET [2025/08/31 13:18:36 ET]
Table 'Arneb' 6-max Seat #1 is the button
Seat 1: pipinoelbreve9 (€3.34 in chips) 
Seat 2: OMaisPesado1 (€2.16 in chips) 
Seat 3: Mai SA135 (€2.01 in chips) 
Seat 4: McMack626 (€1.46 in chips) 
Seat 5: lorocontento (€1.21 in chips) 
Seat 6: FELIPE439 (€5.28 in chips) 
OMaisPesado1: posts small blind €0.01
Mai SA135: posts big blind €0.02
*** HOLE CARDS ***
Dealt to pipinoelbreve9 [7s 5c]
McMack626: folds 
lorocontento: folds 
FELIPE439: folds 
pipinoelbreve9: folds 
OMaisPesado1: raises €0.03 to €0.05
Mai SA135: raises €0.10 to €0.15
OMaisPesado1: calls €0.10
*** FLOP *** [Ac 9d 2h]
OMaisPesado1: checks 
Mai SA135: checks 
*** TURN *** [Ac 9d 2h] [Jh]
OMaisPesado1: bets €0.09
Mai SA135: raises €0.13 to €0.22
OMaisPesado1: folds 
Uncalled bet (€0.13) returned to Mai SA135
Mai SA135 collected €0.46 from pot
Mai SA135: doesn't show hand 
*** SUMMARY ***
Total pot €0.48 | Rake €0.02 
Board [Ac 9d 2h Jh]
Seat 1: pipinoelbreve9 (button) folded before Flop (didn't bet)
Seat 2: OMaisPesado1 (small blind) folded on the Turn
Seat 3: Mai SA135 (big blind) collected (€0.46)
Seat 4: McMack626 folded before Flop (didn't bet)
Seat 5: lorocontento folded before Flop (didn't bet)
Seat 6: FELIPE439 folded before Flop (didn't bet)



PokerStars Zoom Hand #257559118435:  Hold'em No Limit (€0.01/€0.02) - 2025/08/31 19:18:40 CET [2025/08/31 13:18:40 ET]
Table 'Arneb' 6-max Seat #1 is the button
Seat 1: vayewis (€2.14 in chips) 
Seat 2: pipinoelbreve9 (€3.34 in chips) 
Seat 3: Choonchas (€1.01 in chips) 
Seat 4: issatop (€2.03 in chips) 
Seat 5: candarias (€0.78 in chips) 
Seat 6: juolivs (€0.88 in chips) 
pipinoelbreve9: posts small blind €0.01
Choonchas: posts big blind €0.02
*** HOLE CARDS ***
Dealt to pipinoelbreve9 [2c Jd]
issatop: folds 
candarias: folds 
juolivs: calls €0.02
vayewis: raises €0.07 to €0.09
pipinoelbreve9: folds 
Choonchas: calls €0.07
juolivs: folds 
*** FLOP *** [Jc Ts As]
Choonchas: checks 
vayewis: bets €0.10
Choonchas: calls €0.10
*** TURN *** [Jc Ts As] [Td]
Choonchas: checks 
vayewis: bets €0.20
Choonchas: calls €0.20
*** RIVER *** [Jc Ts As Td] [Qd]
Choonchas: checks 
vayewis: checks 
*** SHOW DOWN ***
Choonchas: shows [9h Ac] (two pair, Aces and Tens)
vayewis: shows [Qc Ah] (two pair, Aces and Queens)
vayewis collected €0.77 from pot
*** SUMMARY ***
Total pot €0.81 | Rake €0.04 
Board [Jc Ts As Td Qd]
Seat 1: vayewis (button) showed [Qc Ah] and won (€0.77) with two pair, Aces and Queens
Seat 2: pipinoelbreve9 (small blind) folded before Flop
Seat 3: Choonchas (big blind) showed [9h Ac] and lost with two pair, Aces and Tens
Seat 4: issatop folded before Flop (didn't bet)
Seat 5: candarias folded before Flop (didn't bet)
Seat 6: juolivs folded before Flop



PokerStars Zoom Hand #257559115968:  Hold'em No Limit (€0.01/€0.02) - 2025/08/31 19:18:31 CET [2025/08/31 13:18:31 ET]
Table 'Arneb' 6-max Seat #1 is the button
Seat 1: Mai SA135 (€2.01 in chips) 
Seat 2: Manuxanxe78 (€3.98 in chips) 
Seat 3: calou100 (€1.60 in chips) 
Seat 4: pipinoelbreve9 (€3.34 in chips) 
Seat 5: dday14540 (€2.43 in chips) 
Seat 6: lorocontento (€1.21 in chips) 
Manuxanxe78: posts small blind €0.01
calou100: posts big blind €0.02
*** HOLE CARDS ***
Dealt to pipinoelbreve9 [9c 2d]
pipinoelbreve9: folds 
dday14540: raises €0.04 to €0.06
lorocontento: folds 
Mai SA135: folds 
Manuxanxe78: calls €0.05
calou100: calls €0.04
*** FLOP *** [3c 8c 4c]
Manuxanxe78: checks 
calou100: checks 
dday14540: bets €0.17
Manuxanxe78: calls €0.17
calou100: folds 
*** TURN *** [3c 8c 4c] [Qc]
Manuxanxe78: checks 
dday14540: checks 
*** RIVER *** [3c 8c 4c Qc] [5h]
Manuxanxe78: bets €0.59
dday14540: folds 
Uncalled bet (€0.59) returned to Manuxanxe78
Manuxanxe78 collected €0.49 from pot
Manuxanxe78: doesn't show hand 
*** SUMMARY ***
Total pot €0.52 | Rake €0.03 
Board [3c 8c 4c Qc 5h]
Seat 1: Mai SA135 (button) folded before Flop (didn't bet)
Seat 2: Manuxanxe78 (small blind) collected (€0.49)
Seat 3: calou100 (big blind) folded on the Flop
Seat 4: pipinoelbreve9 folded before Flop (didn't bet)
Seat 5: dday14540 folded on the River
Seat 6: lorocontento folded before Flop (didn't bet)



PokerStars Zoom Hand #257559196645:  Hold'em No Limit (€0.01/€0.02) - 2025/08/31 19:23:49 CET [2025/08/31 13:23:49 ET]
Table 'Arneb' 6-max Seat #1 is the button
Seat 1: marcosbalsaa (€7.15 in chips) 
Seat 2: Korver K (€2.09 in chips) 
Seat 3: pipinoelbreve9 (€3.33 in chips) 
Seat 4: vicen7010 (€0.41 in chips) 
Seat 5: camnoun (€1.20 in chips) 
Seat 6: lorocontento (€1.06 in chips) 
Korver K: posts small blind €0.01
pipinoelbreve9: posts big blind €0.02
*** HOLE CARDS ***
Dealt to pipinoelbreve9 [7h As]
vicen7010: raises €0.02 to €0.04
camnoun: calls €0.04
lorocontento: folds 
marcosbalsaa: calls €0.04
Korver K: folds 
pipinoelbreve9: calls €0.02
*** FLOP *** [Ts 3s 7d]
pipinoelbreve9: checks 
vicen7010: checks 
camnoun: checks 
marcosbalsaa: checks 
*** TURN *** [Ts 3s 7d] [5h]
pipinoelbreve9: bets €0.08
vicen7010: folds 
camnoun: folds 
marcosbalsaa: folds 
Uncalled bet (€0.08) returned to pipinoelbreve9
pipinoelbreve9 collected €0.16 from pot
pipinoelbreve9: doesn't show hand 
*** SUMMARY ***
Total pot €0.17 | Rake €0.01 
Board [Ts 3s 7d 5h]
Seat 1: marcosbalsaa (button) folded on the Turn
Seat 2: Korver K (small blind) folded before Flop
Seat 3: pipinoelbreve9 (big blind) collected (€0.16)
Seat 4: vicen7010 folded on the Turn
Seat 5: camnoun folded on the Turn
Seat 6: lorocontento folded before Flop (didn't bet)



PokerStars Zoom Hand #257559208573:  Hold'em No Limit (€0.01/€0.02) - 2025/08/31 19:24:36 CET [2025/08/31 13:24:36 ET]
Table 'Arneb' 6-max Seat #1 is the button
Seat 1: marcosbalsaa (€7.11 in chips) 
Seat 2: pipinoelbreve9 (€3.45 in chips) 
Seat 3: DeividBox980 (€1.02 in chips) 
Seat 4: odace15 (€2 in chips) 
Seat 5: pucelazo (€3.86 in chips) 
Seat 6: juan@luis800 (€1.90 in chips) 
pipinoelbreve9: posts small blind €0.01
DeividBox980: posts big blind €0.02
*** HOLE CARDS ***
Dealt to pipinoelbreve9 [3h Kc]
odace15: folds 
pucelazo: folds 
juan@luis800: raises €0.02 to €0.04
marcosbalsaa: folds 
pipinoelbreve9: folds 
DeividBox980: folds 
Uncalled bet (€0.02) returned to juan@luis800
juan@luis800 collected €0.05 from pot
juan@luis800: doesn't show hand 
*** SUMMARY ***
Total pot €0.05 | Rake €0 
Seat 1: marcosbalsaa (button) folded before Flop (didn't bet)
Seat 2: pipinoelbreve9 (small blind) folded before Flop
Seat 3: DeividBox980 (big blind) folded before Flop
Seat 4: odace15 folded before Flop (didn't bet)
Seat 5: pucelazo folded before Flop (didn't bet)
Seat 6: juan@luis800 collected (€0.05)



PokerStars Zoom Hand #257559212732:  Hold'em No Limit (€0.01/€0.02) - 2025/08/31 19:24:53 CET [2025/08/31 13:24:53 ET]
Table 'Arneb' 6-max Seat #1 is the button
Seat 1: pipinoelbreve9 (€3.44 in chips) 
Seat 2: vayewis (€3.70 in chips) 
Seat 3: calou100 (€1.60 in chips) 
Seat 4: fernan_282t (€1.06 in chips) 
Seat 5: odace15 (€3.02 in chips) 
Seat 6: cuenca10 (€2.82 in chips) 
vayewis: posts small blind €0.01
calou100: posts big blind €0.02
*** HOLE CARDS ***
Dealt to pipinoelbreve9 [8s 3d]
fernan_282t: raises €0.04 to €0.06
odace15: folds 
cuenca10: folds 
pipinoelbreve9: folds 
vayewis: folds 
calou100: calls €0.04
*** FLOP *** [9h 8d Jh]
calou100: checks 
fernan_282t: bets €0.02
calou100: calls €0.02
*** TURN *** [9h 8d Jh] [7s]
calou100: checks 
fernan_282t: checks 
*** RIVER *** [9h 8d Jh 7s] [7h]
calou100: bets €0.22
fernan_282t: folds 
Uncalled bet (€0.22) returned to calou100
calou100 collected €0.16 from pot
calou100: doesn't show hand 
*** SUMMARY ***
Total pot €0.17 | Rake €0.01 
Board [9h 8d Jh 7s 7h]
Seat 1: pipinoelbreve9 (button) folded before Flop (didn't bet)
Seat 2: vayewis (small blind) folded before Flop
Seat 3: calou100 (big blind) collected (€0.16)
Seat 4: fernan_282t folded on the River
Seat 5: odace15 folded before Flop (didn't bet)
Seat 6: cuenca10 folded before Flop (didn't bet)



PokerStars Zoom Hand #257559214559:  Hold'em No Limit (€0.01/€0.02) - 2025/08/31 19:25:00 CET [2025/08/31 13:25:00 ET]
Table 'Arneb' 6-max Seat #1 is the button
Seat 1: NEMOXYX (€2.43 in chips) 
Seat 2: Fulcrumm (€2.88 in chips) 
Seat 3: booster74 (€2.37 in chips) 
Seat 4: lorocontento (€1.20 in chips) 
Seat 5: issatop (€1.60 in chips) 
Seat 6: pipinoelbreve9 (€3.44 in chips) 
Fulcrumm: posts small blind €0.01
booster74: posts big blind €0.02
*** HOLE CARDS ***
Dealt to pipinoelbreve9 [Ah 9h]
lorocontento: raises €0.02 to €0.04
issatop: calls €0.04
pipinoelbreve9: raises €0.14 to €0.18
NEMOXYX: folds 
Fulcrumm: folds 
booster74: folds 
lorocontento: raises €1.02 to €1.20 and is all-in
issatop: folds 
pipinoelbreve9: folds 
Uncalled bet (€1.02) returned to lorocontento
lorocontento collected €0.43 from pot
lorocontento: doesn't show hand 
*** SUMMARY ***
Total pot €0.43 | Rake €0 
Seat 1: NEMOXYX (button) folded before Flop (didn't bet)
Seat 2: Fulcrumm (small blind) folded before Flop
Seat 3: booster74 (big blind) folded before Flop
Seat 4: lorocontento collected (€0.43)
Seat 5: issatop folded before Flop
Seat 6: pipinoelbreve9 folded before Flop



PokerStars Zoom Hand #257559220615:  Hold'em No Limit (€0.01/€0.02) - 2025/08/31 19:25:24 CET [2025/08/31 13:25:24 ET]
Table 'Arneb' 6-max Seat #1 is the button
Seat 1: cuenca10 (€2.79 in chips) 
Seat 2: Fvieira1984 (€1.54 in chips) 
Seat 3: Gginer2812 (€1.37 in chips) 
Seat 4: booster74 (€2.34 in chips) 
Seat 5: pipinoelbreve9 (€3.26 in chips) 
Seat 6: MagicGitox (€2.36 in chips) 
Fvieira1984: posts small blind €0.01
Gginer2812: posts big blind €0.02
*** HOLE CARDS ***
Dealt to pipinoelbreve9 [4c 6s]
booster74: folds 
pipinoelbreve9: folds 
MagicGitox: folds 
cuenca10: calls €0.02
Fvieira1984: folds 
Gginer2812: checks 
*** FLOP *** [3c 9s 4d]
Gginer2812: checks 
cuenca10: checks 
*** TURN *** [3c 9s 4d] [2c]
Gginer2812: checks 
cuenca10: checks 
*** RIVER *** [3c 9s 4d 2c] [6d]
Gginer2812: checks 
cuenca10: checks 
*** SHOW DOWN ***
Gginer2812: shows [Qh 3s] (a pair of Threes)
cuenca10: mucks hand 
Gginer2812 collected €0.05 from pot
*** SUMMARY ***
Total pot €0.05 | Rake €0 
Board [3c 9s 4d 2c 6d]
Seat 1: cuenca10 (button) mucked [Js Ad]
Seat 2: Fvieira1984 (small blind) folded before Flop
Seat 3: Gginer2812 (big blind) showed [Qh 3s] and won (€0.05) with a pair of Threes
Seat 4: booster74 folded before Flop (didn't bet)
Seat 5: pipinoelbreve9 folded before Flop (didn't bet)
Seat 6: MagicGitox folded before Flop (didn't bet)



PokerStars Zoom Hand #257559222632:  Hold'em No Limit (€0.01/€0.02) - 2025/08/31 19:25:33 CET [2025/08/31 13:25:33 ET]
Table 'Arneb' 6-max Seat #1 is the button
Seat 1: NEMOXYX (€2 in chips) 
Seat 2: McMack626 (€2.01 in chips) 
Seat 3: vayewis (€3.29 in chips) 
Seat 4: Manuxanxe78 (€2.97 in chips) 
Seat 5: pipinoelbreve9 (€3.26 in chips) 
Seat 6: Fvieira1984 (€1.53 in chips) 
McMack626: posts small blind €0.01
vayewis: posts big blind €0.02
*** HOLE CARDS ***
Dealt to pipinoelbreve9 [Js 4c]
Manuxanxe78: raises €0.04 to €0.06
pipinoelbreve9: folds 
Fvieira1984: calls €0.06
NEMOXYX: folds 
McMack626: folds 
vayewis: calls €0.04
*** FLOP *** [2s Ts Qh]
vayewis: checks 
Manuxanxe78: bets €0.14
Fvieira1984: calls €0.14
vayewis: folds 
*** TURN *** [2s Ts Qh] [Jd]
Manuxanxe78: checks 
Fvieira1984: bets €0.18
Manuxanxe78: calls €0.18
*** RIVER *** [2s Ts Qh Jd] [6c]
Manuxanxe78: checks 
Fvieira1984: checks 
*** SHOW DOWN ***
Manuxanxe78: shows [Qd Ks] (a pair of Queens)
Fvieira1984: mucks hand 
Manuxanxe78 collected €0.79 from pot
*** SUMMARY ***
Total pot €0.83 | Rake €0.04 
Board [2s Ts Qh Jd 6c]
Seat 1: NEMOXYX (button) folded before Flop (didn't bet)
Seat 2: McMack626 (small blind) folded before Flop
Seat 3: vayewis (big blind) folded on the Flop
Seat 4: Manuxanxe78 showed [Qd Ks] and won (€0.79) with a pair of Queens
Seat 5: pipinoelbreve9 folded before Flop (didn't bet)
Seat 6: Fvieira1984 mucked [8h Jh]



PokerStars Zoom Hand #257559221560:  Hold'em No Limit (€0.01/€0.02) - 2025/08/31 19:25:28 CET [2025/08/31 13:25:28 ET]
Table 'Arneb' 6-max Seat #1 is the button
Seat 1: fernan_282t (€0.98 in chips) 
Seat 2: FELIPE439 (€3.73 in chips) 
Seat 3: ZeroKilpgm (€1.60 in chips) 
Seat 4: pipinoelbreve9 (€3.26 in chips) 
Seat 5: marcosbalsaa (€8.17 in chips) 
Seat 6: DeividBox980 (€0.99 in chips) 
FELIPE439: posts small blind €0.01
ZeroKilpgm: posts big blind €0.02
*** HOLE CARDS ***
Dealt to pipinoelbreve9 [4d 3h]
pipinoelbreve9: folds 
marcosbalsaa: folds 
DeividBox980: folds 
fernan_282t: raises €0.02 to €0.04
FELIPE439: calls €0.03
ZeroKilpgm: calls €0.02
*** FLOP *** [6h 5c 9d]
FELIPE439: checks 
ZeroKilpgm: bets €0.11
fernan_282t: folds 
FELIPE439: calls €0.11
*** TURN *** [6h 5c 9d] [3d]
FELIPE439: checks 
ZeroKilpgm: bets €0.16
FELIPE439: calls €0.16
*** RIVER *** [6h 5c 9d 3d] [9c]
FELIPE439: checks 
ZeroKilpgm: bets €0.59
FELIPE439: raises €2.83 to €3.42 and is all-in
ZeroKilpgm: folds 
Uncalled bet (€2.83) returned to FELIPE439
FELIPE439 collected €1.75 from pot
FELIPE439: doesn't show hand 
*** SUMMARY ***
Total pot €1.84 | Rake €0.09 
Board [6h 5c 9d 3d 9c]
Seat 1: fernan_282t (button) folded on the Flop
Seat 2: FELIPE439 (small blind) collected (€1.75)
Seat 3: ZeroKilpgm (big blind) folded on the River
Seat 4: pipinoelbreve9 folded before Flop (didn't bet)
Seat 5: marcosbalsaa folded before Flop (didn't bet)
Seat 6: DeividBox980 folded before Flop (didn't bet)



PokerStars Zoom Hand #257559247348:  Hold'em No Limit (€0.01/€0.02) - 2025/08/31 19:27:10 CET [2025/08/31 13:27:10 ET]
Table 'Arneb' 6-max Seat #1 is the button
Seat 1: janjos69 (€2.27 in chips) 
Seat 2: Manuxanxe78 (€2 in chips) 
Seat 3: pipinoelbreve9 (€3.26 in chips) 
Seat 4: Korver K (€2.01 in chips) 
Seat 5: Nightshade407 (€1.95 in chips) 
Seat 6: 34pluto (€1.02 in chips) 
Manuxanxe78: posts small blind €0.01
pipinoelbreve9: posts big blind €0.02
*** HOLE CARDS ***
Dealt to pipinoelbreve9 [8s Jh]
Korver K: folds 
Nightshade407: folds 
34pluto: folds 
janjos69: folds 
Manuxanxe78: folds 
Uncalled bet (€0.01) returned to pipinoelbreve9
pipinoelbreve9 collected €0.02 from pot
pipinoelbreve9: doesn't show hand 
*** SUMMARY ***
Total pot €0.02 | Rake €0 
Seat 1: janjos69 (button) folded before Flop (didn't bet)
Seat 2: Manuxanxe78 (small blind) folded before Flop
Seat 3: pipinoelbreve9 (big blind) collected (€0.02)
Seat 4: Korver K folded before Flop (didn't bet)
Seat 5: Nightshade407 folded before Flop (didn't bet)
Seat 6: 34pluto folded before Flop (didn't bet)



PokerStars Zoom Hand #257559249615:  Hold'em No Limit (€0.01/€0.02) - 2025/08/31 19:27:19 CET [2025/08/31 13:27:19 ET]
Table 'Arneb' 6-max Seat #1 is the button
Seat 1: pipinoelbreve9 (€3.27 in chips) 
Seat 2: issatop (€2.81 in chips) 
Seat 3: Manuxanxe78 (€2 in chips) 
Seat 4: 34pluto (€1.02 in chips) 
Seat 5: critsio (€0.86 in chips) 
Seat 6: Sr.Trebejo (€2.91 in chips) 
issatop: posts small blind €0.01
Manuxanxe78: posts big blind €0.02
*** HOLE CARDS ***
Dealt to pipinoelbreve9 [6c Ad]
34pluto: folds 
critsio: calls €0.02
Sr.Trebejo: folds 
pipinoelbreve9: raises €0.08 to €0.10
issatop: folds 
Manuxanxe78: calls €0.08
critsio: calls €0.08
*** FLOP *** [Qd 6h Td]
Manuxanxe78: checks 
critsio: bets €0.08
pipinoelbreve9: calls €0.08
Manuxanxe78: calls €0.08
*** TURN *** [Qd 6h Td] [Tc]
Manuxanxe78: checks 
critsio: bets €0.14
pipinoelbreve9: folds 
Manuxanxe78: folds 
Uncalled bet (€0.14) returned to critsio
critsio collected €0.52 from pot
critsio: doesn't show hand 
*** SUMMARY ***
Total pot €0.55 | Rake €0.03 
Board [Qd 6h Td Tc]
Seat 1: pipinoelbreve9 (button) folded on the Turn
Seat 2: issatop (small blind) folded before Flop
Seat 3: Manuxanxe78 (big blind) folded on the Turn
Seat 4: 34pluto folded before Flop (didn't bet)
Seat 5: critsio collected (€0.52)
Seat 6: Sr.Trebejo folded before Flop (didn't bet)



PokerStars Zoom Hand #257559260457:  Hold'em No Limit (€0.01/€0.02) - 2025/08/31 19:28:01 CET [2025/08/31 13:28:01 ET]
Table 'Arneb' 6-max Seat #1 is the button
Seat 1: Jota_uVe_1 (€2 in chips) 
Seat 2: pipinoelbreve9 (€3.09 in chips) 
Seat 3: andresrodr8 (€3.09 in chips) 
Seat 4: Gginer2812 (€1.27 in chips) 
Seat 5: FELIPE439 (€1.42 in chips) 
Seat 6: marcel13013 (€1.87 in chips) 
pipinoelbreve9: posts small blind €0.01
andresrodr8: posts big blind €0.02
*** HOLE CARDS ***
Dealt to pipinoelbreve9 [7h Kh]
Gginer2812: folds 
FELIPE439: folds 
marcel13013: calls €0.02
Jota_uVe_1: raises €0.06 to €0.08
pipinoelbreve9: calls €0.07
andresrodr8: calls €0.06
marcel13013: folds 
*** FLOP *** [4s Qc 9h]
pipinoelbreve9: checks 
andresrodr8: bets €0.06
Jota_uVe_1: folds 
pipinoelbreve9: folds 
Uncalled bet (€0.06) returned to andresrodr8
andresrodr8 collected €0.25 from pot
andresrodr8: doesn't show hand 
*** SUMMARY ***
Total pot €0.26 | Rake €0.01 
Board [4s Qc 9h]
Seat 1: Jota_uVe_1 (button) folded on the Flop
Seat 2: pipinoelbreve9 (small blind) folded on the Flop
Seat 3: andresrodr8 (big blind) collected (€0.25)
Seat 4: Gginer2812 folded before Flop (didn't bet)
Seat 5: FELIPE439 folded before Flop (didn't bet)
Seat 6: marcel13013 folded before Flop



PokerStars Zoom Hand #257559274325:  Hold'em No Limit (€0.01/€0.02) - 2025/08/31 19:28:56 CET [2025/08/31 13:28:56 ET]
Table 'Arneb' 6-max Seat #1 is the button
Seat 1: andresrodr8 (€4.92 in chips) 
Seat 2: OMaisPesado1 (€3.62 in chips) 
Seat 3: Manuxanxe78 (€3.48 in chips) 
Seat 4: QuerlyHiHi (€2.07 in chips) 
Seat 5: pipinoelbreve9 (€3.01 in chips) 
Seat 6: candarias (€1.62 in chips) 
OMaisPesado1: posts small blind €0.01
Manuxanxe78: posts big blind €0.02
*** HOLE CARDS ***
Dealt to pipinoelbreve9 [Qc Qd]
QuerlyHiHi: folds 
pipinoelbreve9: raises €0.04 to €0.06
candarias: folds 
andresrodr8: folds 
OMaisPesado1: folds 
Manuxanxe78: folds 
Uncalled bet (€0.04) returned to pipinoelbreve9
pipinoelbreve9 collected €0.05 from pot
pipinoelbreve9: doesn't show hand 
*** SUMMARY ***
Total pot €0.05 | Rake €0 
Seat 1: andresrodr8 (button) folded before Flop (didn't bet)
Seat 2: OMaisPesado1 (small blind) folded before Flop
Seat 3: Manuxanxe78 (big blind) folded before Flop
Seat 4: QuerlyHiHi folded before Flop (didn't bet)
Seat 5: pipinoelbreve9 collected (€0.05)
Seat 6: candarias folded before Flop (didn't bet)



PokerStars Zoom Hand #257559271022:  Hold'em No Limit (€0.01/€0.02) - 2025/08/31 19:28:43 CET [2025/08/31 13:28:43 ET]
Table 'Arneb' 6-max Seat #1 is the button
Seat 1: andresrodr8 (€2.48 in chips) 
Seat 2: julsau81 (€4.95 in chips) 
Seat 3: PrendsCa (€2.84 in chips) 
Seat 4: marcel13013 (€1.84 in chips) 
Seat 5: HGrenha (€2.92 in chips) 
Seat 6: pipinoelbreve9 (€3.01 in chips) 
julsau81: posts small blind €0.01
PrendsCa: posts big blind €0.02
*** HOLE CARDS ***
Dealt to pipinoelbreve9 [Qc 8c]
marcel13013: folds 
HGrenha: calls €0.02
pipinoelbreve9: folds 
andresrodr8: raises €0.08 to €0.10
julsau81: folds 
PrendsCa: folds 
HGrenha: calls €0.08
*** FLOP *** [4s Qs 6s]
HGrenha: checks 
andresrodr8: bets €0.07
HGrenha: calls €0.07
*** TURN *** [4s Qs 6s] [2c]
HGrenha: checks 
andresrodr8: checks 
*** RIVER *** [4s Qs 6s 2c] [3d]
HGrenha: bets €2.75 and is all-in
andresrodr8: folds 
Uncalled bet (€2.75) returned to HGrenha
HGrenha collected €0.35 from pot
HGrenha: doesn't show hand 
*** SUMMARY ***
Total pot €0.37 | Rake €0.02 
Board [4s Qs 6s 2c 3d]
Seat 1: andresrodr8 (button) folded on the River
Seat 2: julsau81 (small blind) folded before Flop
Seat 3: PrendsCa (big blind) folded before Flop
Seat 4: marcel13013 folded before Flop (didn't bet)
Seat 5: HGrenha collected (€0.35)
Seat 6: pipinoelbreve9 folded before Flop (didn't bet)



PokerStars Zoom Hand #257559280997:  Hold'em No Limit (€0.01/€0.02) - 2025/08/31 19:29:23 CET [2025/08/31 13:29:23 ET]
Table 'Arneb' 6-max Seat #1 is the button
Seat 1: vicen7010 (€0.87 in chips) 
Seat 2: masquisiera (€1.17 in chips) 
Seat 3: bdcscstars (€2.16 in chips) 
Seat 4: marcel13013 (€1.50 in chips) 
Seat 5: pipinoelbreve9 (€3.04 in chips) 
Seat 6: Manuxanxe78 (€3.46 in chips) 
masquisiera: posts small blind €0.01
bdcscstars: posts big blind €0.02
*** HOLE CARDS ***
Dealt to pipinoelbreve9 [3c 2c]
marcel13013: folds 
pipinoelbreve9: folds 
Manuxanxe78 has timed out
Manuxanxe78: folds 
vicen7010: folds 
masquisiera: folds 
Uncalled bet (€0.01) returned to bdcscstars
bdcscstars collected €0.02 from pot
bdcscstars: doesn't show hand 
*** SUMMARY ***
Total pot €0.02 | Rake €0 
Seat 1: vicen7010 (button) folded before Flop (didn't bet)
Seat 2: masquisiera (small blind) folded before Flop
Seat 3: bdcscstars (big blind) collected (€0.02)
Seat 4: marcel13013 folded before Flop (didn't bet)
Seat 5: pipinoelbreve9 folded before Flop (didn't bet)
Seat 6: Manuxanxe78 folded before Flop (didn't bet)



PokerStars Zoom Hand #257559415920:  Hold'em No Limit (€0.01/€0.02) - 2025/08/31 19:38:02 CET [2025/08/31 13:38:02 ET]
Table 'Arneb' 6-max Seat #1 is the button
Seat 1: hope201319 (€1.60 in chips) 
Seat 2: myrtus9 (€1.75 in chips) 
Seat 3: pipinoelbreve9 (€3.04 in chips) 
Seat 4: 76jusab76 (€0.98 in chips) 
Seat 5: BestiaESP12 (€2.40 in chips) 
Seat 6: Gginer2812 (€1.14 in chips) 
myrtus9: posts small blind €0.01
pipinoelbreve9: posts big blind €0.02
*** HOLE CARDS ***
Dealt to pipinoelbreve9 [6h 5s]
76jusab76: calls €0.02
BestiaESP12: folds 
Gginer2812: calls €0.02
hope201319: folds 
myrtus9: calls €0.01
pipinoelbreve9: checks 
*** FLOP *** [6d Js 9s]
myrtus9: checks 
pipinoelbreve9: checks 
76jusab76: bets €0.04
Gginer2812: folds 
myrtus9: calls €0.04
pipinoelbreve9: folds 
*** TURN *** [6d Js 9s] [4d]
myrtus9: checks 
76jusab76: checks 
*** RIVER *** [6d Js 9s 4d] [3s]
myrtus9: checks 
76jusab76: checks 
*** SHOW DOWN ***
myrtus9: shows [Ac 9d] (a pair of Nines)
76jusab76: mucks hand 
myrtus9 collected €0.15 from pot
*** SUMMARY ***
Total pot €0.16 | Rake €0.01 
Board [6d Js 9s 4d 3s]
Seat 1: hope201319 (button) folded before Flop (didn't bet)
Seat 2: myrtus9 (small blind) showed [Ac 9d] and won (€0.15) with a pair of Nines
Seat 3: pipinoelbreve9 (big blind) folded on the Flop
Seat 4: 76jusab76 mucked [Qd Tc]
Seat 5: BestiaESP12 folded before Flop (didn't bet)
Seat 6: Gginer2812 folded on the Flop



PokerStars Zoom Hand #257559423369:  Hold'em No Limit (€0.01/€0.02) - 2025/08/31 19:38:30 CET [2025/08/31 13:38:30 ET]
Table 'Arneb' 6-max Seat #1 is the button
Seat 1: candarias (€0.82 in chips) 
Seat 2: pipinoelbreve9 (€3.02 in chips) 
Seat 3: marcosbalsaa (€4.08 in chips) 
Seat 4: QuerlyHiHi (€2 in chips) 
Seat 5: McMack626 (€1.93 in chips) 
Seat 6: masquisiera (€1.15 in chips) 
pipinoelbreve9: posts small blind €0.01
marcosbalsaa: posts big blind €0.02
*** HOLE CARDS ***
Dealt to pipinoelbreve9 [5s 3s]
QuerlyHiHi: folds 
McMack626: folds 
masquisiera: folds 
candarias: folds 
pipinoelbreve9: raises €0.04 to €0.06
marcosbalsaa: calls €0.04
*** FLOP *** [7c 2h Td]
pipinoelbreve9: checks 
marcosbalsaa: bets €0.07
pipinoelbreve9: folds 
Uncalled bet (€0.07) returned to marcosbalsaa
marcosbalsaa collected €0.11 from pot
marcosbalsaa: doesn't show hand 
*** SUMMARY ***
Total pot €0.12 | Rake €0.01 
Board [7c 2h Td]
Seat 1: candarias (button) folded before Flop (didn't bet)
Seat 2: pipinoelbreve9 (small blind) folded on the Flop
Seat 3: marcosbalsaa (big blind) collected (€0.11)
Seat 4: QuerlyHiHi folded before Flop (didn't bet)
Seat 5: McMack626 folded before Flop (didn't bet)
Seat 6: masquisiera folded before Flop (didn't bet)



PokerStars Zoom Hand #257559435252:  Hold'em No Limit (€0.01/€0.02) - 2025/08/31 19:39:15 CET [2025/08/31 13:39:15 ET]
Table 'Arneb' 6-max Seat #1 is the button
Seat 1: pipinoelbreve9 (€2.96 in chips) 
Seat 2: Aldrin.Z (€2 in chips) 
Seat 3: cuenca10 (€3.14 in chips) 
Seat 4: janjos69 (€2.08 in chips) 
Seat 5: NEMOXYX (€2.60 in chips) 
Seat 6: hope201319 (€1.60 in chips) 
Aldrin.Z: posts small blind €0.01
cuenca10: posts big blind €0.02
*** HOLE CARDS ***
Dealt to pipinoelbreve9 [Qh Jc]
janjos69: raises €0.04 to €0.06
NEMOXYX: folds 
hope201319: folds 
pipinoelbreve9: calls €0.06
Aldrin.Z: folds 
cuenca10: folds 
*** FLOP *** [5c 6c 4c]
janjos69: checks 
pipinoelbreve9: checks 
*** TURN *** [5c 6c 4c] [Qd]
janjos69: checks 
pipinoelbreve9: bets €0.07
janjos69: folds 
Uncalled bet (€0.07) returned to pipinoelbreve9
pipinoelbreve9 collected €0.14 from pot
pipinoelbreve9: doesn't show hand 
*** SUMMARY ***
Total pot €0.15 | Rake €0.01 
Board [5c 6c 4c Qd]
Seat 1: pipinoelbreve9 (button) collected (€0.14)
Seat 2: Aldrin.Z (small blind) folded before Flop
Seat 3: cuenca10 (big blind) folded before Flop
Seat 4: janjos69 folded on the Turn
Seat 5: NEMOXYX folded before Flop (didn't bet)
Seat 6: hope201319 folded before Flop (didn't bet)



PokerStars Zoom Hand #257559945895:  Hold'em No Limit (€0.01/€0.02) - 2025/08/31 19:39:55 CET [2025/08/31 13:39:55 ET]
Table 'Arneb' 6-max Seat #1 is the button
Seat 1: pucelazo (€3.59 in chips) 
Seat 2: hope201319 (€1.60 in chips) 
Seat 3: OMaisPesado1 (€4.05 in chips) 
Seat 4: TIOGUY7 (€0.75 in chips) 
Seat 5: booster74 (€3.18 in chips) 
Seat 6: pipinoelbreve9 (€3.04 in chips) 
hope201319: posts small blind €0.01
OMaisPesado1: posts big blind €0.02
*** HOLE CARDS ***
Dealt to pipinoelbreve9 [As Jc]
TIOGUY7: folds 
booster74: folds 
pipinoelbreve9: raises €0.04 to €0.06
pucelazo: folds 
hope201319: folds 
OMaisPesado1: folds 
Uncalled bet (€0.04) returned to pipinoelbreve9
pipinoelbreve9 collected €0.05 from pot
pipinoelbreve9: doesn't show hand 
*** SUMMARY ***
Total pot €0.05 | Rake €0 
Seat 1: pucelazo (button) folded before Flop (didn't bet)
Seat 2: hope201319 (small blind) folded before Flop
Seat 3: OMaisPesado1 (big blind) folded before Flop
Seat 4: TIOGUY7 folded before Flop (didn't bet)
Seat 5: booster74 folded before Flop (didn't bet)
Seat 6: pipinoelbreve9 collected (€0.05)



PokerStars Zoom Hand #257559944016:  Hold'em No Limit (€0.01/€0.02) - 2025/08/31 19:39:48 CET [2025/08/31 13:39:48 ET]
Table 'Arneb' 6-max Seat #1 is the button
Seat 1: Gginer2812 (€1.01 in chips) 
Seat 2: bdcscstars (€1.96 in chips) 
Seat 3: losi10 (€3.18 in chips) 
Seat 4: pucelazo (€2.37 in chips) 
Seat 5: pipinoelbreve9 (€3.04 in chips) 
Seat 6: lorocontento (€1 in chips) 
bdcscstars: posts small blind €0.01
losi10: posts big blind €0.02
*** HOLE CARDS ***
Dealt to pipinoelbreve9 [8s 4h]
pucelazo: folds 
pipinoelbreve9: folds 
lorocontento: raises €0.02 to €0.04
Gginer2812: calls €0.04
bdcscstars: folds 
losi10: folds 
*** FLOP *** [9h Qs 3h]
lorocontento: bets €0.08
Gginer2812: folds 
Uncalled bet (€0.08) returned to lorocontento
lorocontento collected €0.10 from pot
lorocontento: doesn't show hand 
*** SUMMARY ***
Total pot €0.11 | Rake €0.01 
Board [9h Qs 3h]
Seat 1: Gginer2812 (button) folded on the Flop
Seat 2: bdcscstars (small blind) folded before Flop
Seat 3: losi10 (big blind) folded before Flop
Seat 4: pucelazo folded before Flop (didn't bet)
Seat 5: pipinoelbreve9 folded before Flop (didn't bet)
Seat 6: lorocontento collected (€0.10)



PokerStars Zoom Hand #257559960881:  Hold'em No Limit (€0.01/€0.02) - 2025/08/31 19:40:52 CET [2025/08/31 13:40:52 ET]
Table 'Arneb' 6-max Seat #1 is the button
Seat 1: OMaisPesado1 (€4.02 in chips) 
Seat 2: pipinoelbreve9 (€2.74 in chips) 
Seat 3: Aldrin.Z (€2 in chips) 
Seat 4: stephspace (€1.68 in chips) 
Seat 5: cuenca10 (€3.04 in chips) 
Seat 6: ratomi (€1.31 in chips) 
pipinoelbreve9: posts small blind €0.01
Aldrin.Z: posts big blind €0.02
*** HOLE CARDS ***
Dealt to pipinoelbreve9 [5c 9c]
stephspace: folds 
cuenca10: folds 
ratomi: folds 
OMaisPesado1: folds 
pipinoelbreve9: folds 
Uncalled bet (€0.01) returned to Aldrin.Z
Aldrin.Z collected €0.02 from pot
Aldrin.Z: doesn't show hand 
*** SUMMARY ***
Total pot €0.02 | Rake €0 
Seat 1: OMaisPesado1 (button) folded before Flop (didn't bet)
Seat 2: pipinoelbreve9 (small blind) folded before Flop
Seat 3: Aldrin.Z (big blind) collected (€0.02)
Seat 4: stephspace folded before Flop (didn't bet)
Seat 5: cuenca10 folded before Flop (didn't bet)
Seat 6: ratomi folded before Flop (didn't bet)



PokerStars Zoom Hand #257559949806:  Hold'em No Limit (€0.01/€0.02) - 2025/08/31 19:40:10 CET [2025/08/31 13:40:10 ET]
Table 'Arneb' 6-max Seat #1 is the button
Seat 1: pipinoelbreve9 (€3.07 in chips) 
Seat 2: Tymoko (€1.70 in chips) 
Seat 3: janjos69 (€2.01 in chips) 
Seat 4: Jota_uVe_1 (€2.43 in chips) 
Seat 5: bdcscstars (€2.60 in chips) 
Seat 6: pucelazo (€3.60 in chips) 
Tymoko: posts small blind €0.01
janjos69: posts big blind €0.02
*** HOLE CARDS ***
Dealt to pipinoelbreve9 [Js Ks]
Jota_uVe_1: raises €0.03 to €0.05
bdcscstars: raises €0.13 to €0.18
pucelazo: folds 
pipinoelbreve9: calls €0.18
Tymoko: folds 
janjos69: raises €0.15 to €0.33
Jota_uVe_1: folds 
bdcscstars: calls €0.15
pipinoelbreve9: calls €0.15
*** FLOP *** [3c Tc 7d]
janjos69: bets €1.68 and is all-in
bdcscstars: folds 
pipinoelbreve9: folds 
Uncalled bet (€1.68) returned to janjos69
janjos69 collected €1 from pot
janjos69: doesn't show hand 
*** SUMMARY ***
Total pot €1.05 | Rake €0.05 
Board [3c Tc 7d]
Seat 1: pipinoelbreve9 (button) folded on the Flop
Seat 2: Tymoko (small blind) folded before Flop
Seat 3: janjos69 (big blind) collected (€1)
Seat 4: Jota_uVe_1 folded before Flop
Seat 5: bdcscstars folded on the Flop
Seat 6: pucelazo folded before Flop (didn't bet)



PokerStars Zoom Hand #257559961790:  Hold'em No Limit (€0.01/€0.02) - 2025/08/31 19:40:56 CET [2025/08/31 13:40:56 ET]
Table 'Arneb' 6-max Seat #1 is the button
Seat 1: pucelazo (€2.41 in chips) 
Seat 2: TIOGUY7 (€0.73 in chips) 
Seat 3: pipinoelbreve9 (€2.73 in chips) 
Seat 4: PrendsCa (€3.66 in chips) 
Seat 5: masquisiera (€1 in chips) 
Seat 6: Chichoampuero12 (€2.60 in chips) 
TIOGUY7: posts small blind €0.01
pipinoelbreve9: posts big blind €0.02
*** HOLE CARDS ***
Dealt to pipinoelbreve9 [Ts 5s]
PrendsCa: folds 
masquisiera: folds 
Chichoampuero12: folds 
pucelazo: raises €0.04 to €0.06
TIOGUY7: folds 
pipinoelbreve9: calls €0.04
*** FLOP *** [8d Jh 7s]
pipinoelbreve9: checks 
pucelazo: checks 
*** TURN *** [8d Jh 7s] [6h]
pipinoelbreve9: bets €0.06
pucelazo: folds 
Uncalled bet (€0.06) returned to pipinoelbreve9
pipinoelbreve9 collected €0.12 from pot
pipinoelbreve9: doesn't show hand 
*** SUMMARY ***
Total pot €0.13 | Rake €0.01 
Board [8d Jh 7s 6h]
Seat 1: pucelazo (button) folded on the Turn
Seat 2: TIOGUY7 (small blind) folded before Flop
Seat 3: pipinoelbreve9 (big blind) collected (€0.12)
Seat 4: PrendsCa folded before Flop (didn't bet)
Seat 5: masquisiera folded before Flop (didn't bet)
Seat 6: Chichoampuero12 folded before Flop (didn't bet)



PokerStars Zoom Hand #257559970795:  Hold'em No Limit (€0.01/€0.02) - 2025/08/31 19:41:30 CET [2025/08/31 13:41:30 ET]
Table 'Arneb' 6-max Seat #1 is the button
Seat 1: stephspace (€1.68 in chips) 
Seat 2: Jota_uVe_1 (€2 in chips) 
Seat 3: DoYouWantMoney (€2.12 in chips) 
Seat 4: pipinoelbreve9 (€2.79 in chips) 
Seat 5: Chichoampuero12 (€2 in chips) 
Seat 6: migueld1 (€3 in chips) 
Jota_uVe_1: posts small blind €0.01
DoYouWantMoney: posts big blind €0.02
*** HOLE CARDS ***
Dealt to pipinoelbreve9 [Kh Js]
pipinoelbreve9: raises €0.04 to €0.06
Chichoampuero12: folds 
migueld1: folds 
stephspace: folds 
Jota_uVe_1: folds 
DoYouWantMoney: calls €0.04
*** FLOP *** [Qh Ac Tc]
DoYouWantMoney: checks 
pipinoelbreve9: bets €0.06
DoYouWantMoney: calls €0.06
*** TURN *** [Qh Ac Tc] [2s]
DoYouWantMoney: checks 
pipinoelbreve9: bets €0.16
DoYouWantMoney: calls €0.16
*** RIVER *** [Qh Ac Tc 2s] [9c]
DoYouWantMoney: checks 
pipinoelbreve9: bets €0.54
DoYouWantMoney: calls €0.54
*** SHOW DOWN ***
pipinoelbreve9: shows [Kh Js] (a straight, Ten to Ace)
DoYouWantMoney: mucks hand 
pipinoelbreve9 collected €1.57 from pot
*** SUMMARY ***
Total pot €1.65 | Rake €0.08 
Board [Qh Ac Tc 2s 9c]
Seat 1: stephspace (button) folded before Flop (didn't bet)
Seat 2: Jota_uVe_1 (small blind) folded before Flop
Seat 3: DoYouWantMoney (big blind) mucked [2h Ah]
Seat 4: pipinoelbreve9 showed [Kh Js] and won (€1.57) with a straight, Ten to Ace
Seat 5: Chichoampuero12 folded before Flop (didn't bet)
Seat 6: migueld1 folded before Flop (didn't bet)



PokerStars Zoom Hand #257559981997:  Hold'em No Limit (€0.01/€0.02) - 2025/08/31 19:42:14 CET [2025/08/31 13:42:14 ET]
Table 'Arneb' 6-max Seat #1 is the button
Seat 1: McMack626 (€1.20 in chips) 
Seat 2: Gginer2812 (€1.02 in chips) 
Seat 3: BestiaESP12 (€2.04 in chips) 
Seat 4: vicen7010 (€0.32 in chips) 
Seat 5: bdcscstars (€2.24 in chips) 
Seat 6: pipinoelbreve9 (€3.54 in chips) 
Gginer2812: posts small blind €0.01
BestiaESP12: posts big blind €0.02
*** HOLE CARDS ***
Dealt to pipinoelbreve9 [Qd 4d]
vicen7010: folds 
bdcscstars: folds 
pipinoelbreve9: raises €0.04 to €0.06
McMack626: folds 
Gginer2812: folds 
BestiaESP12: folds 
Uncalled bet (€0.04) returned to pipinoelbreve9
pipinoelbreve9 collected €0.05 from pot
pipinoelbreve9: doesn't show hand 
*** SUMMARY ***
Total pot €0.05 | Rake €0 
Seat 1: McMack626 (button) folded before Flop (didn't bet)
Seat 2: Gginer2812 (small blind) folded before Flop
Seat 3: BestiaESP12 (big blind) folded before Flop
Seat 4: vicen7010 folded before Flop (didn't bet)
Seat 5: bdcscstars folded before Flop (didn't bet)
Seat 6: pipinoelbreve9 collected (€0.05)



PokerStars Zoom Hand #257559988674:  Hold'em No Limit (€0.01/€0.02) - 2025/08/31 19:42:39 CET [2025/08/31 13:42:39 ET]
Table 'Arneb' 6-max Seat #1 is the button
Seat 1: SrLyrox (€3.48 in chips) 
Seat 2: Aldrin.Z (€2 in chips) 
Seat 3: pipinoelbreve9 (€3.57 in chips) 
Seat 4: Fvieira1984 (€5.34 in chips) 
Seat 5: Jota_uVe_1 (€2.03 in chips) 
Seat 6: marcdevil (€2 in chips) 
Aldrin.Z: posts small blind €0.01
pipinoelbreve9: posts big blind €0.02
*** HOLE CARDS ***
Dealt to pipinoelbreve9 [Kc 2c]
Fvieira1984: calls €0.02
Jota_uVe_1: folds 
marcdevil: folds 
SrLyrox: raises €0.06 to €0.08
Aldrin.Z: folds 
pipinoelbreve9: folds 
Fvieira1984: folds 
Uncalled bet (€0.06) returned to SrLyrox
SrLyrox collected €0.07 from pot
SrLyrox: doesn't show hand 
*** SUMMARY ***
Total pot €0.07 | Rake €0 
Seat 1: SrLyrox (button) collected (€0.07)
Seat 2: Aldrin.Z (small blind) folded before Flop
Seat 3: pipinoelbreve9 (big blind) folded before Flop
Seat 4: Fvieira1984 folded before Flop
Seat 5: Jota_uVe_1 folded before Flop (didn't bet)
Seat 6: marcdevil folded before Flop (didn't bet)



PokerStars Zoom Hand #257559986148:  Hold'em No Limit (€0.01/€0.02) - 2025/08/31 19:42:29 CET [2025/08/31 13:42:29 ET]
Table 'Arneb' 6-max Seat #1 is the button
Seat 1: migueld1 (€2.97 in chips) 
Seat 2: Bad_Tripss (€2.22 in chips) 
Seat 3: marcdevil (€2 in chips) 
Seat 4: DoYouWantMoney (€1.29 in chips) 
Seat 5: pipinoelbreve9 (€3.57 in chips) 
Seat 6: Manuxanxe78 (€3.78 in chips) 
Bad_Tripss: posts small blind €0.01
marcdevil: posts big blind €0.02
*** HOLE CARDS ***
Dealt to pipinoelbreve9 [Kh 3s]
DoYouWantMoney: folds 
pipinoelbreve9: folds 
Manuxanxe78 has timed out
Manuxanxe78: folds 
migueld1: folds 
Bad_Tripss: raises €0.04 to €0.06
marcdevil: calls €0.04
*** FLOP *** [As Qd Tc]
Bad_Tripss: checks 
marcdevil: checks 
*** TURN *** [As Qd Tc] [Ts]
Bad_Tripss: checks 
marcdevil: bets €0.06
Bad_Tripss: calls €0.06
*** RIVER *** [As Qd Tc Ts] [7h]
Bad_Tripss: checks 
marcdevil: checks 
*** SHOW DOWN ***
Bad_Tripss: shows [5s Qs] (two pair, Queens and Tens)
marcdevil: shows [9s Qh] (two pair, Queens and Tens)
Bad_Tripss collected €0.12 from pot
marcdevil collected €0.11 from pot
*** SUMMARY ***
Total pot €0.24 | Rake €0.01 
Board [As Qd Tc Ts 7h]
Seat 1: migueld1 (button) folded before Flop (didn't bet)
Seat 2: Bad_Tripss (small blind) showed [5s Qs] and won (€0.12) with two pair, Queens and Tens
Seat 3: marcdevil (big blind) showed [9s Qh] and won (€0.11) with two pair, Queens and Tens
Seat 4: DoYouWantMoney folded before Flop (didn't bet)
Seat 5: pipinoelbreve9 folded before Flop (didn't bet)
Seat 6: Manuxanxe78 folded before Flop (didn't bet)



PokerStars Zoom Hand #257559987456:  Hold'em No Limit (€0.01/€0.02) - 2025/08/31 19:42:35 CET [2025/08/31 13:42:35 ET]
Table 'Arneb' 6-max Seat #1 is the button
Seat 1: verdugo2275 (€2.22 in chips) 
Seat 2: SrLyrox (€3.49 in chips) 
Seat 3: masquisiera (€1.20 in chips) 
Seat 4: pipinoelbreve9 (€3.57 in chips) 
Seat 5: bdcscstars (€2.23 in chips) 
Seat 6: DoYouWantMoney (€1.29 in chips) 
SrLyrox: posts small blind €0.01
masquisiera: posts big blind €0.02
*** HOLE CARDS ***
Dealt to pipinoelbreve9 [Ks 6d]
pipinoelbreve9: folds 
bdcscstars: folds 
DoYouWantMoney: folds 
verdugo2275: raises €0.03 to €0.05
SrLyrox: folds 
masquisiera: calls €0.03
*** FLOP *** [7h Th 6h]
masquisiera: checks 
verdugo2275: bets €0.07
masquisiera: calls €0.07
*** TURN *** [7h Th 6h] [Kh]
masquisiera: checks 
verdugo2275: checks 
*** RIVER *** [7h Th 6h Kh] [8h]
masquisiera: bets €0.26
verdugo2275: folds 
Uncalled bet (€0.26) returned to masquisiera
masquisiera collected €0.24 from pot
masquisiera: doesn't show hand 
*** SUMMARY ***
Total pot €0.25 | Rake €0.01 
Board [7h Th 6h Kh 8h]
Seat 1: verdugo2275 (button) folded on the River
Seat 2: SrLyrox (small blind) folded before Flop
Seat 3: masquisiera (big blind) collected (€0.24)
Seat 4: pipinoelbreve9 folded before Flop (didn't bet)
Seat 5: bdcscstars folded before Flop (didn't bet)
Seat 6: DoYouWantMoney folded before Flop (didn't bet)



PokerStars Zoom Hand #257559995857:  Hold'em No Limit (€0.01/€0.02) - 2025/08/31 19:43:07 CET [2025/08/31 13:43:07 ET]
Table 'Arneb' 6-max Seat #1 is the button
Seat 1: ColonyStr (€2.32 in chips) 
Seat 2: pipinoelbreve9 (€3.55 in chips) 
Seat 3: DeividBox980 (€0.77 in chips) 
Seat 4: Popins0011 (€1.39 in chips) 
Seat 5: Gginer2812 (€0.98 in chips) 
Seat 6: Jota_uVe_1 (€2.01 in chips) 
pipinoelbreve9: posts small blind €0.01
DeividBox980: posts big blind €0.02
*** HOLE CARDS ***
Dealt to pipinoelbreve9 [5c Ad]
Popins0011: calls €0.02
Gginer2812: folds 
Jota_uVe_1: folds 
ColonyStr: folds 
pipinoelbreve9: calls €0.01
DeividBox980: checks 
*** FLOP *** [5s 4c 6c]
pipinoelbreve9: bets €0.03
DeividBox980: folds 
Popins0011: calls €0.03
*** TURN *** [5s 4c 6c] [Jd]
pipinoelbreve9: bets €0.06
Popins0011: folds 
Uncalled bet (€0.06) returned to pipinoelbreve9
pipinoelbreve9 collected €0.11 from pot
pipinoelbreve9: doesn't show hand 
*** SUMMARY ***
Total pot €0.12 | Rake €0.01 
Board [5s 4c 6c Jd]
Seat 1: ColonyStr (button) folded before Flop (didn't bet)
Seat 2: pipinoelbreve9 (small blind) collected (€0.11)
Seat 3: DeividBox980 (big blind) folded on the Flop
Seat 4: Popins0011 folded on the Turn
Seat 5: Gginer2812 folded before Flop (didn't bet)
Seat 6: Jota_uVe_1 folded before Flop (didn't bet)



PokerStars Zoom Hand #257560004396:  Hold'em No Limit (€0.01/€0.02) - 2025/08/31 19:43:39 CET [2025/08/31 13:43:39 ET]
Table 'Arneb' 6-max Seat #1 is the button
Seat 1: lorocontento (€1.24 in chips) 
Seat 2: bdcscstars (€2.68 in chips) 
Seat 3: Manuxanxe78 (€3.91 in chips) 
Seat 4: Tymoko (€1.14 in chips) 
Seat 5: pipinoelbreve9 (€3.61 in chips) 
Seat 6: 76jusab76 (€0.60 in chips) 
bdcscstars: posts small blind €0.01
Manuxanxe78: posts big blind €0.02
*** HOLE CARDS ***
Dealt to pipinoelbreve9 [3h 4h]
Tymoko: raises €1.12 to €1.14 and is all-in
pipinoelbreve9: folds 
76jusab76: folds 
lorocontento: folds 
bdcscstars: folds 
Manuxanxe78: folds 
Uncalled bet (€1.12) returned to Tymoko
Tymoko collected €0.05 from pot
Tymoko: doesn't show hand 
*** SUMMARY ***
Total pot €0.05 | Rake €0 
Seat 1: lorocontento (button) folded before Flop (didn't bet)
Seat 2: bdcscstars (small blind) folded before Flop
Seat 3: Manuxanxe78 (big blind) folded before Flop
Seat 4: Tymoko collected (€0.05)
Seat 5: pipinoelbreve9 folded before Flop (didn't bet)
Seat 6: 76jusab76 folded before Flop (didn't bet)



PokerStars Zoom Hand #257560005475:  Hold'em No Limit (€0.01/€0.02) - 2025/08/31 19:43:43 CET [2025/08/31 13:43:43 ET]
Table 'Arneb' 6-max Seat #1 is the button
Seat 1: Chichoampuero12 (€2.05 in chips) 
Seat 2: Popins0011 (€1.35 in chips) 
Seat 3: lorocontento (€1.24 in chips) 
Seat 4: pucelazo (€2.25 in chips) 
Seat 5: pantera86 (€2.98 in chips) 
Seat 6: pipinoelbreve9 (€3.61 in chips) 
Popins0011: posts small blind €0.01
lorocontento: posts big blind €0.02
*** HOLE CARDS ***
Dealt to pipinoelbreve9 [2h Jc]
pucelazo: folds 
pantera86: folds 
pipinoelbreve9: folds 
Chichoampuero12: folds 
Popins0011: folds 
Uncalled bet (€0.01) returned to lorocontento
lorocontento collected €0.02 from pot
lorocontento: doesn't show hand 
*** SUMMARY ***
Total pot €0.02 | Rake €0 
Seat 1: Chichoampuero12 (button) folded before Flop (didn't bet)
Seat 2: Popins0011 (small blind) folded before Flop
Seat 3: lorocontento (big blind) collected (€0.02)
Seat 4: pucelazo folded before Flop (didn't bet)
Seat 5: pantera86 folded before Flop (didn't bet)
Seat 6: pipinoelbreve9 folded before Flop (didn't bet)



PokerStars Zoom Hand #257560006678:  Hold'em No Limit (€0.01/€0.02) - 2025/08/31 19:43:48 CET [2025/08/31 13:43:48 ET]
Table 'Arneb' 6-max Seat #1 is the button
Seat 1: NEMOXYX (€2.46 in chips) 
Seat 2: Manuxanxe78 (€4.53 in chips) 
Seat 3: trinityandme (€1.60 in chips) 
Seat 4: booster74 (€3.29 in chips) 
Seat 5: pipinoelbreve9 (€3.61 in chips) 
Seat 6: Jota_uVe_1 (€2.31 in chips) 
Manuxanxe78: posts small blind €0.01
trinityandme: posts big blind €0.02
*** HOLE CARDS ***
Dealt to pipinoelbreve9 [Kc 4s]
booster74: folds 
pipinoelbreve9: folds 
Jota_uVe_1: folds 
NEMOXYX: raises €0.03 to €0.05
Manuxanxe78: folds 
trinityandme: folds 
Uncalled bet (€0.03) returned to NEMOXYX
NEMOXYX collected €0.05 from pot
NEMOXYX: doesn't show hand 
*** SUMMARY ***
Total pot €0.05 | Rake €0 
Seat 1: NEMOXYX (button) collected (€0.05)
Seat 2: Manuxanxe78 (small blind) folded before Flop
Seat 3: trinityandme (big blind) folded before Flop
Seat 4: booster74 folded before Flop (didn't bet)
Seat 5: pipinoelbreve9 folded before Flop (didn't bet)
Seat 6: Jota_uVe_1 folded before Flop (didn't bet)



PokerStars Zoom Hand #257560003374:  Hold'em No Limit (€0.01/€0.02) - 2025/08/31 19:43:35 CET [2025/08/31 13:43:35 ET]
Table 'Arneb' 6-max Seat #1 is the button
Seat 1: pipinoelbreve9 (€3.61 in chips) 
Seat 2: pucelazo (€2 in chips) 
Seat 3: Fvieira1984 (€5.26 in chips) 
Seat 4: charlyleon92 (€1.89 in chips) 
Seat 5: marcosbalsaa (€6.78 in chips) 
Seat 6: Regalodon95 (€2.47 in chips) 
pucelazo: posts small blind €0.01
Fvieira1984: posts big blind €0.02
*** HOLE CARDS ***
Dealt to pipinoelbreve9 [3h 6d]
charlyleon92: folds 
marcosbalsaa: raises €0.04 to €0.06
Regalodon95: raises €0.04 to €0.10
pipinoelbreve9: folds 
pucelazo: folds 
Fvieira1984: folds 
marcosbalsaa: raises €0.16 to €0.26
Regalodon95: calls €0.16
*** FLOP *** [9h 5s Qs]
marcosbalsaa: bets €0.12
Regalodon95: folds 
Uncalled bet (€0.12) returned to marcosbalsaa
marcosbalsaa collected €0.52 from pot
marcosbalsaa: doesn't show hand 
*** SUMMARY ***
Total pot €0.55 | Rake €0.03 
Board [9h 5s Qs]
Seat 1: pipinoelbreve9 (button) folded before Flop (didn't bet)
Seat 2: pucelazo (small blind) folded before Flop
Seat 3: Fvieira1984 (big blind) folded before Flop
Seat 4: charlyleon92 folded before Flop (didn't bet)
Seat 5: marcosbalsaa collected (€0.52)
Seat 6: Regalodon95 folded on the Flop



PokerStars Zoom Hand #257560008341:  Hold'em No Limit (€0.01/€0.02) - 2025/08/31 19:43:54 CET [2025/08/31 13:43:54 ET]
Table 'Arneb' 6-max Seat #1 is the button
Seat 1: ratomi (€1.43 in chips) 
Seat 2: Gginer2812 (€0.99 in chips) 
Seat 3: pipinoelbreve9 (€3.61 in chips) 
Seat 4: Fulcrumm (€2.31 in chips) 
Seat 5: Chichoampuero12 (€2.22 in chips) 
Seat 6: TIOGUY7 (€0.74 in chips) 
Gginer2812: posts small blind €0.01
pipinoelbreve9: posts big blind €0.02
*** HOLE CARDS ***
Dealt to pipinoelbreve9 [Ah 4d]
Fulcrumm has timed out
Fulcrumm: folds 
Chichoampuero12: folds 
TIOGUY7: folds 
ratomi: calls €0.02
Gginer2812: folds 
pipinoelbreve9: raises €0.04 to €0.06
ratomi: calls €0.04
*** FLOP *** [3h 3c 8d]
pipinoelbreve9: checks 
ratomi: checks 
*** TURN *** [3h 3c 8d] [8h]
pipinoelbreve9: bets €0.06
ratomi: folds 
Uncalled bet (€0.06) returned to pipinoelbreve9
pipinoelbreve9 collected €0.12 from pot
pipinoelbreve9: doesn't show hand 
*** SUMMARY ***
Total pot €0.13 | Rake €0.01 
Board [3h 3c 8d 8h]
Seat 1: ratomi (button) folded on the Turn
Seat 2: Gginer2812 (small blind) folded before Flop
Seat 3: pipinoelbreve9 (big blind) collected (€0.12)
Seat 4: Fulcrumm folded before Flop (didn't bet)
Seat 5: Chichoampuero12 folded before Flop (didn't bet)
Seat 6: TIOGUY7 folded before Flop (didn't bet)



PokerStars Zoom Hand #257560022149:  Hold'em No Limit (€0.01/€0.02) - 2025/08/31 19:44:47 CET [2025/08/31 13:44:47 ET]
Table 'Arneb' 6-max Seat #1 is the button
Seat 1: pucelazo (€2.18 in chips) 
Seat 2: pipinoelbreve9 (€3.67 in chips) 
Seat 3: marcel13013 (€0.82 in chips) 
Seat 4: Regalodon95 (€2.22 in chips) 
Seat 5: pauma1123 (€3.14 in chips) 
Seat 6: cuenca10 (€3.03 in chips) 
pipinoelbreve9: posts small blind €0.01
marcel13013: posts big blind €0.02
*** HOLE CARDS ***
Dealt to pipinoelbreve9 [Qc Qs]
Regalodon95: folds 
pauma1123: raises €0.04 to €0.06
cuenca10: folds 
pucelazo: folds 
pipinoelbreve9: raises €0.14 to €0.20
marcel13013: folds 
pauma1123: calls €0.14
*** FLOP *** [Ad 7s Kd]
pipinoelbreve9: bets €0.20
pauma1123: calls €0.20
*** TURN *** [Ad 7s Kd] [7d]
pipinoelbreve9: checks 
pauma1123: bets €0.20
pipinoelbreve9: calls €0.20
*** RIVER *** [Ad 7s Kd 7d] [4h]
pipinoelbreve9: checks 
pauma1123: bets €0.47
pipinoelbreve9: folds 
Uncalled bet (€0.47) returned to pauma1123
pauma1123 collected €1.16 from pot
pauma1123: doesn't show hand 
*** SUMMARY ***
Total pot €1.22 | Rake €0.06 
Board [Ad 7s Kd 7d 4h]
Seat 1: pucelazo (button) folded before Flop (didn't bet)
Seat 2: pipinoelbreve9 (small blind) folded on the River
Seat 3: marcel13013 (big blind) folded before Flop
Seat 4: Regalodon95 folded before Flop (didn't bet)
Seat 5: pauma1123 collected (€1.16)
Seat 6: cuenca10 folded before Flop (didn't bet)



PokerStars Zoom Hand #257560034080:  Hold'em No Limit (€0.01/€0.02) - 2025/08/31 19:45:33 CET [2025/08/31 13:45:33 ET]
Table 'Arneb' 6-max Seat #1 is the button
Seat 1: pipinoelbreve9 (€3.07 in chips) 
Seat 2: cuenca10 (€3.01 in chips) 
Seat 3: elenita_nait (€1.85 in chips) 
Seat 4: bdcscstars (€2.58 in chips) 
Seat 5: candarias (€0.80 in chips) 
Seat 6: charlyleon92 (€1.16 in chips) 
cuenca10: posts small blind €0.01
elenita_nait: posts big blind €0.02
*** HOLE CARDS ***
Dealt to pipinoelbreve9 [4c 4h]
bdcscstars: folds 
candarias: folds 
charlyleon92: folds 
pipinoelbreve9: raises €0.04 to €0.06
cuenca10: calls €0.05
elenita_nait: folds 
*** FLOP *** [9c Ks Td]
cuenca10: checks 
pipinoelbreve9: checks 
*** TURN *** [9c Ks Td] [8d]
cuenca10: checks 
pipinoelbreve9: bets €0.07
cuenca10: folds 
Uncalled bet (€0.07) returned to pipinoelbreve9
pipinoelbreve9 collected €0.13 from pot
pipinoelbreve9: doesn't show hand 
*** SUMMARY ***
Total pot €0.14 | Rake €0.01 
Board [9c Ks Td 8d]
Seat 1: pipinoelbreve9 (button) collected (€0.13)
Seat 2: cuenca10 (small blind) folded on the Turn
Seat 3: elenita_nait (big blind) folded before Flop
Seat 4: bdcscstars folded before Flop (didn't bet)
Seat 5: candarias folded before Flop (didn't bet)
Seat 6: charlyleon92 folded before Flop (didn't bet)



PokerStars Zoom Hand #257560042345:  Hold'em No Limit (€0.01/€0.02) - 2025/08/31 19:46:06 CET [2025/08/31 13:46:06 ET]
Table 'Arneb' 6-max Seat #1 is the button
Seat 1: QQpkrQQ (€2 in chips) 
Seat 2: Fulcrumm (€2.11 in chips) 
Seat 3: Jota_uVe_1 (€2.01 in chips) 
Seat 4: julsau81 (€5.53 in chips) 
Seat 5: Manuxanxe78 (€3.83 in chips) 
Seat 6: pipinoelbreve9 (€3.14 in chips) 
Fulcrumm: posts small blind €0.01
Jota_uVe_1: posts big blind €0.02
*** HOLE CARDS ***
Dealt to pipinoelbreve9 [8d 9c]
julsau81: folds 
Manuxanxe78: folds 
pipinoelbreve9: folds 
QQpkrQQ: calls €0.02
Fulcrumm: calls €0.01
Jota_uVe_1: checks 
*** FLOP *** [9s 8s 7c]
Fulcrumm: bets €0.04
Jota_uVe_1: folds 
QQpkrQQ: folds 
Uncalled bet (€0.04) returned to Fulcrumm
Fulcrumm collected €0.06 from pot
Fulcrumm: doesn't show hand 
*** SUMMARY ***
Total pot €0.06 | Rake €0 
Board [9s 8s 7c]
Seat 1: QQpkrQQ (button) folded on the Flop
Seat 2: Fulcrumm (small blind) collected (€0.06)
Seat 3: Jota_uVe_1 (big blind) folded on the Flop
Seat 4: julsau81 folded before Flop (didn't bet)
Seat 5: Manuxanxe78 folded before Flop (didn't bet)
Seat 6: pipinoelbreve9 folded before Flop (didn't bet)



PokerStars Zoom Hand #257560045248:  Hold'em No Limit (€0.01/€0.02) - 2025/08/31 19:46:17 CET [2025/08/31 13:46:17 ET]
Table 'Arneb' 6-max Seat #1 is the button
Seat 1: pipinoelbreve9 (€3.14 in chips) 
Seat 2: pauma1123 (€3.63 in chips) 
Seat 3: trinityandme (€1.49 in chips) 
Seat 4: Apdwins (€2.48 in chips) 
Seat 5: marcosbalsaa (€4.48 in chips) 
Seat 6: NEMOXYX (€2.56 in chips) 
pauma1123: posts small blind €0.01
trinityandme: posts big blind €0.02
*** HOLE CARDS ***
Dealt to pipinoelbreve9 [Td 4c]
Apdwins: folds 
marcosbalsaa: folds 
NEMOXYX: folds 
pipinoelbreve9: folds 
pauma1123: folds 
Uncalled bet (€0.01) returned to trinityandme
trinityandme collected €0.02 from pot
trinityandme: doesn't show hand 
*** SUMMARY ***
Total pot €0.02 | Rake €0 
Seat 1: pipinoelbreve9 (button) folded before Flop (didn't bet)
Seat 2: pauma1123 (small blind) folded before Flop
Seat 3: trinityandme (big blind) collected (€0.02)
Seat 4: Apdwins folded before Flop (didn't bet)
Seat 5: marcosbalsaa folded before Flop (didn't bet)
Seat 6: NEMOXYX folded before Flop (didn't bet)



PokerStars Zoom Hand #257560044214:  Hold'em No Limit (€0.01/€0.02) - 2025/08/31 19:46:12 CET [2025/08/31 13:46:12 ET]
Table 'Arneb' 6-max Seat #1 is the button
Seat 1: cuenca10 (€2.95 in chips) 
Seat 2: masquisiera (€1.37 in chips) 
Seat 3: Desmd72 (€3.70 in chips) 
Seat 4: pipinoelbreve9 (€3.14 in chips) 
Seat 5: julsau81 (€5.53 in chips) 
Seat 6: NEMOXYX (€2.39 in chips) 
masquisiera: posts small blind €0.01
Desmd72: posts big blind €0.02
*** HOLE CARDS ***
Dealt to pipinoelbreve9 [Ac 4h]
pipinoelbreve9: folds 
julsau81: raises €0.02 to €0.04
NEMOXYX: folds 
cuenca10: calls €0.04
masquisiera: folds 
Desmd72: folds 
*** FLOP *** [4c 6h Qc]
julsau81: checks 
cuenca10: checks 
*** TURN *** [4c 6h Qc] [8c]
julsau81: checks 
cuenca10: checks 
*** RIVER *** [4c 6h Qc 8c] [4s]
julsau81: bets €0.03
cuenca10: folds 
Uncalled bet (€0.03) returned to julsau81
julsau81 collected €0.10 from pot
julsau81: doesn't show hand 
*** SUMMARY ***
Total pot €0.11 | Rake €0.01 
Board [4c 6h Qc 8c 4s]
Seat 1: cuenca10 (button) folded on the River
Seat 2: masquisiera (small blind) folded before Flop
Seat 3: Desmd72 (big blind) folded before Flop
Seat 4: pipinoelbreve9 folded before Flop (didn't bet)
Seat 5: julsau81 collected (€0.10)
Seat 6: NEMOXYX folded before Flop (didn't bet)



PokerStars Zoom Hand #257560047990:  Hold'em No Limit (€0.01/€0.02) - 2025/08/31 19:46:27 CET [2025/08/31 13:46:27 ET]
Table 'Arneb' 6-max Seat #1 is the button
Seat 1: marcdevil (€2.06 in chips) 
Seat 2: marcosbalsaa (€7.02 in chips) 
Seat 3: bdcscstars (€2.10 in chips) 
Seat 4: pipinoelbreve9 (€3.14 in chips) 
Seat 5: BestiaESP12 (€2.34 in chips) 
Seat 6: Aldrin.Z (€2.16 in chips) 
marcosbalsaa: posts small blind €0.01
bdcscstars: posts big blind €0.02
*** HOLE CARDS ***
Dealt to pipinoelbreve9 [2s 6c]
pipinoelbreve9: folds 
BestiaESP12: folds 
Aldrin.Z: folds 
marcdevil: folds 
marcosbalsaa: raises €0.04 to €0.06
bdcscstars: raises €0.12 to €0.18
marcosbalsaa: folds 
Uncalled bet (€0.12) returned to bdcscstars
bdcscstars collected €0.12 from pot
bdcscstars: doesn't show hand 
*** SUMMARY ***
Total pot €0.12 | Rake €0 
Seat 1: marcdevil (button) folded before Flop (didn't bet)
Seat 2: marcosbalsaa (small blind) folded before Flop
Seat 3: bdcscstars (big blind) collected (€0.12)
Seat 4: pipinoelbreve9 folded before Flop (didn't bet)
Seat 5: BestiaESP12 folded before Flop (didn't bet)
Seat 6: Aldrin.Z folded before Flop (didn't bet)



PokerStars Zoom Hand #257560049770:  Hold'em No Limit (€0.01/€0.02) - 2025/08/31 19:46:34 CET [2025/08/31 13:46:34 ET]
Table 'Arneb' 6-max Seat #1 is the button
Seat 1: Manuxanxe78 (€4.40 in chips) 
Seat 2: pantera86 (€3.21 in chips) 
Seat 3: pipinoelbreve9 (€3.14 in chips) 
Seat 4: NEMOXYX (€2.56 in chips) 
Seat 5: janjos69 (€1.70 in chips) 
Seat 6: marcdevil (€2 in chips) 
pantera86: posts small blind €0.01
pipinoelbreve9: posts big blind €0.02
*** HOLE CARDS ***
Dealt to pipinoelbreve9 [7c Ad]
NEMOXYX: folds 
janjos69: raises €0.04 to €0.06
marcdevil: folds 
Manuxanxe78: folds 
pantera86: calls €0.05
pipinoelbreve9: calls €0.04
*** FLOP *** [7s 7d Qd]
pantera86: checks 
pipinoelbreve9: checks 
janjos69: checks 
*** TURN *** [7s 7d Qd] [5h]
pantera86: checks 
pipinoelbreve9: bets €0.09
janjos69: folds 
pantera86: folds 
Uncalled bet (€0.09) returned to pipinoelbreve9
pipinoelbreve9 collected €0.17 from pot
pipinoelbreve9: doesn't show hand 
*** SUMMARY ***
Total pot €0.18 | Rake €0.01 
Board [7s 7d Qd 5h]
Seat 1: Manuxanxe78 (button) folded before Flop (didn't bet)
Seat 2: pantera86 (small blind) folded on the Turn
Seat 3: pipinoelbreve9 (big blind) collected (€0.17)
Seat 4: NEMOXYX folded before Flop (didn't bet)
Seat 5: janjos69 folded on the Turn
Seat 6: marcdevil folded before Flop (didn't bet)



PokerStars Zoom Hand #257560046717:  Hold'em No Limit (€0.01/€0.02) - 2025/08/31 19:46:22 CET [2025/08/31 13:46:22 ET]
Table 'Arneb' 6-max Seat #1 is the button
Seat 1: Bad_Tripss (€2.07 in chips) 
Seat 2: vicen7010 (€0.98 in chips) 
Seat 3: Manuxanxe78 (€3.83 in chips) 
Seat 4: QuerlyHiHi (€2.33 in chips) 
Seat 5: pipinoelbreve9 (€3.14 in chips) 
Seat 6: QQpkrQQ (€2 in chips) 
vicen7010: posts small blind €0.01
Manuxanxe78: posts big blind €0.02
*** HOLE CARDS ***
Dealt to pipinoelbreve9 [2c 8c]
QuerlyHiHi: raises €0.04 to €0.06
pipinoelbreve9: folds 
QQpkrQQ: folds 
Bad_Tripss: calls €0.06
vicen7010: calls €0.05
Manuxanxe78: folds 
*** FLOP *** [Ks 3s Jc]
vicen7010: checks 
QuerlyHiHi: bets €0.06
Bad_Tripss: calls €0.06
vicen7010: folds 
*** TURN *** [Ks 3s Jc] [Qh]
QuerlyHiHi: bets €0.15
Bad_Tripss: raises €0.33 to €0.48
QuerlyHiHi: folds 
Uncalled bet (€0.33) returned to Bad_Tripss
Bad_Tripss collected €0.59 from pot
Bad_Tripss: doesn't show hand 
*** SUMMARY ***
Total pot €0.62 | Rake €0.03 
Board [Ks 3s Jc Qh]
Seat 1: Bad_Tripss (button) collected (€0.59)
Seat 2: vicen7010 (small blind) folded on the Flop
Seat 3: Manuxanxe78 (big blind) folded before Flop
Seat 4: QuerlyHiHi folded on the Turn
Seat 5: pipinoelbreve9 folded before Flop (didn't bet)
Seat 6: QQpkrQQ folded before Flop (didn't bet)



PokerStars Zoom Hand #257560059141:  Hold'em No Limit (€0.01/€0.02) - 2025/08/31 19:47:10 CET [2025/08/31 13:47:10 ET]
Table 'Arneb' 6-max Seat #1 is the button
Seat 1: Fulcrumm (€2.09 in chips) 
Seat 2: pipinoelbreve9 (€3.25 in chips) 
Seat 3: janjos69 (€1.64 in chips) 
Seat 4: pantera86 (€3.15 in chips) 
Seat 5: Protos.es (€1.96 in chips) 
Seat 6: Gginer2812 (€0.91 in chips) 
pipinoelbreve9: posts small blind €0.01
janjos69: posts big blind €0.02
*** HOLE CARDS ***
Dealt to pipinoelbreve9 [7h 4h]
pantera86: folds 
Protos.es: folds 
Gginer2812: folds 
Fulcrumm: folds 
pipinoelbreve9: calls €0.01
janjos69: checks 
*** FLOP *** [7d 4c 9h]
pipinoelbreve9: bets €0.02
janjos69 is disconnected 
janjos69 has timed out while disconnected
janjos69: folds 
Uncalled bet (€0.02) returned to pipinoelbreve9
pipinoelbreve9 collected €0.04 from pot
pipinoelbreve9: doesn't show hand 
*** SUMMARY ***
Total pot €0.04 | Rake €0 
Board [7d 4c 9h]
Seat 1: Fulcrumm (button) folded before Flop (didn't bet)
Seat 2: pipinoelbreve9 (small blind) collected (€0.04)
Seat 3: janjos69 (big blind) folded on the Flop
Seat 4: pantera86 folded before Flop (didn't bet)
Seat 5: Protos.es folded before Flop (didn't bet)
Seat 6: Gginer2812 folded before Flop (didn't bet)



PokerStars Zoom Hand #257560983672:  Hold'em No Limit (€0.01/€0.02) - 2025/08/31 20:45:08 CET [2025/08/31 14:45:08 ET]
Table 'Arneb' 6-max Seat #1 is the button
Seat 1: SrLyrox (€3.44 in chips) 
Seat 2: LuisGR90 (€2.27 in chips) 
Seat 3: pipinoelbreve9 (€2 in chips) 
Seat 4: flamencolega (€1.86 in chips) 
Seat 5: UndertheGun7799 (€2.71 in chips) 
Seat 6: NikoBzN (€2.87 in chips) 
LuisGR90: posts small blind €0.01
pipinoelbreve9: posts big blind €0.02
*** HOLE CARDS ***
Dealt to pipinoelbreve9 [Qd Ad]
flamencolega: folds 
UndertheGun7799: folds 
NikoBzN: folds 
SrLyrox: folds 
LuisGR90: folds 
Uncalled bet (€0.01) returned to pipinoelbreve9
pipinoelbreve9 collected €0.02 from pot
pipinoelbreve9: doesn't show hand 
*** SUMMARY ***
Total pot €0.02 | Rake €0 
Seat 1: SrLyrox (button) folded before Flop (didn't bet)
Seat 2: LuisGR90 (small blind) folded before Flop
Seat 3: pipinoelbreve9 (big blind) collected (€0.02)
Seat 4: flamencolega folded before Flop (didn't bet)
Seat 5: UndertheGun7799 folded before Flop (didn't bet)
Seat 6: NikoBzN folded before Flop (didn't bet)



PokerStars Zoom Hand #257560988873:  Hold'em No Limit (€0.01/€0.02) - 2025/08/31 20:45:25 CET [2025/08/31 14:45:25 ET]
Table 'Arneb' 6-max Seat #1 is the button
Seat 1: l2orestes (€2.06 in chips) 
Seat 2: pipinoelbreve9 (€2.01 in chips) 
Seat 3: Tymoko (€4.89 in chips) 
Seat 4: PolCuenca (€1.85 in chips) 
Seat 5: mekinho#1 (€0.78 in chips) 
Seat 6: Chichoampuero12 (€5.23 in chips) 
pipinoelbreve9: posts small blind €0.01
Tymoko: posts big blind €0.02
*** HOLE CARDS ***
Dealt to pipinoelbreve9 [7s Kc]
PolCuenca: folds 
mekinho#1 has timed out
mekinho#1: folds 
Chichoampuero12: folds 
l2orestes: folds 
pipinoelbreve9: raises €0.04 to €0.06
Tymoko: folds 
Uncalled bet (€0.04) returned to pipinoelbreve9
pipinoelbreve9 collected €0.04 from pot
pipinoelbreve9: doesn't show hand 
*** SUMMARY ***
Total pot €0.04 | Rake €0 
Seat 1: l2orestes (button) folded before Flop (didn't bet)
Seat 2: pipinoelbreve9 (small blind) collected (€0.04)
Seat 3: Tymoko (big blind) folded before Flop
Seat 4: PolCuenca folded before Flop (didn't bet)
Seat 5: mekinho#1 folded before Flop (didn't bet)
Seat 6: Chichoampuero12 folded before Flop (didn't bet)



PokerStars Zoom Hand #257560996337:  Hold'em No Limit (€0.01/€0.02) - 2025/08/31 20:45:51 CET [2025/08/31 14:45:51 ET]
Table 'Arneb' 6-max Seat #1 is the button
Seat 1: pipinoelbreve9 (€2.03 in chips) 
Seat 2: l2orestes (€2.07 in chips) 
Seat 3: cris1966564 (€0.92 in chips) 
Seat 4: TEVMONIV (€2 in chips) 
Seat 5: joaninha124 (€1.65 in chips) 
Seat 6: Izibeaxh (€8.02 in chips) 
l2orestes: posts small blind €0.01
cris1966564: posts big blind €0.02
*** HOLE CARDS ***
Dealt to pipinoelbreve9 [Tc 9d]
TEVMONIV: folds 
joaninha124: folds 
Izibeaxh: folds 
pipinoelbreve9: raises €0.02 to €0.04
l2orestes: folds 
cris1966564: calls €0.02
*** FLOP *** [3d Ac 8h]
cris1966564: checks 
pipinoelbreve9: checks 
*** TURN *** [3d Ac 8h] [6h]
cris1966564: checks 
pipinoelbreve9: checks 
*** RIVER *** [3d Ac 8h 6h] [8s]
cris1966564: checks 
pipinoelbreve9: checks 
*** SHOW DOWN ***
cris1966564: shows [Ts 6s] (two pair, Eights and Sixes)
pipinoelbreve9: mucks hand 
cris1966564 collected €0.09 from pot
*** SUMMARY ***
Total pot €0.09 | Rake €0 
Board [3d Ac 8h 6h 8s]
Seat 1: pipinoelbreve9 (button) mucked [Tc 9d]
Seat 2: l2orestes (small blind) folded before Flop
Seat 3: cris1966564 (big blind) showed [Ts 6s] and won (€0.09) with two pair, Eights and Sixes
Seat 4: TEVMONIV folded before Flop (didn't bet)
Seat 5: joaninha124 folded before Flop (didn't bet)
Seat 6: Izibeaxh folded before Flop (didn't bet)



PokerStars Zoom Hand #257561011388:  Hold'em No Limit (€0.01/€0.02) - 2025/08/31 20:46:42 CET [2025/08/31 14:46:42 ET]
Table 'Arneb' 6-max Seat #1 is the button
Seat 1: koka1151 (€2.12 in chips) 
Seat 2: Jota_uVe_1 (€2.64 in chips) 
Seat 3: TJDasNeves (€2.20 in chips) 
Seat 4: l2orestes (€2.04 in chips) 
Seat 5: pipinoelbreve9 (€2 in chips) 
Seat 6: spoke_6969 (€2 in chips) 
Jota_uVe_1: posts small blind €0.01
TJDasNeves: posts big blind €0.02
*** HOLE CARDS ***
Dealt to pipinoelbreve9 [8c Ks]
l2orestes: folds 
pipinoelbreve9: raises €0.04 to €0.06
spoke_6969: folds 
koka1151: folds 
Jota_uVe_1: folds 
TJDasNeves: calls €0.04
*** FLOP *** [5h 4c Ac]
TJDasNeves: checks 
pipinoelbreve9: checks 
*** TURN *** [5h 4c Ac] [Qs]
TJDasNeves: bets €0.08
pipinoelbreve9: folds 
Uncalled bet (€0.08) returned to TJDasNeves
TJDasNeves collected €0.12 from pot
TJDasNeves: doesn't show hand 
*** SUMMARY ***
Total pot €0.13 | Rake €0.01 
Board [5h 4c Ac Qs]
Seat 1: koka1151 (button) folded before Flop (didn't bet)
Seat 2: Jota_uVe_1 (small blind) folded before Flop
Seat 3: TJDasNeves (big blind) collected (€0.12)
Seat 4: l2orestes folded before Flop (didn't bet)
Seat 5: pipinoelbreve9 folded on the Turn
Seat 6: spoke_6969 folded before Flop (didn't bet)



PokerStars Zoom Hand #257561020613:  Hold'em No Limit (€0.01/€0.02) - 2025/08/31 20:47:13 CET [2025/08/31 14:47:13 ET]
Table 'Arneb' 6-max Seat #1 is the button
Seat 1: Chichoampuero12 (€4.73 in chips) 
Seat 2: dragonfly2467 (€2 in chips) 
Seat 3: l2orestes (€2.45 in chips) 
Seat 4: pipinoelbreve9 (€2 in chips) 
Seat 5: eric stl 196 (€0.96 in chips) 
Seat 6: LuisGR90 (€2.40 in chips) 
dragonfly2467: posts small blind €0.01
l2orestes: posts big blind €0.02
*** HOLE CARDS ***
Dealt to pipinoelbreve9 [2d Kc]
pipinoelbreve9: folds 
eric stl 196: folds 
LuisGR90: folds 
Chichoampuero12: folds 
dragonfly2467: folds 
Uncalled bet (€0.01) returned to l2orestes
l2orestes collected €0.02 from pot
l2orestes: doesn't show hand 
*** SUMMARY ***
Total pot €0.02 | Rake €0 
Seat 1: Chichoampuero12 (button) folded before Flop (didn't bet)
Seat 2: dragonfly2467 (small blind) folded before Flop
Seat 3: l2orestes (big blind) collected (€0.02)
Seat 4: pipinoelbreve9 folded before Flop (didn't bet)
Seat 5: eric stl 196 folded before Flop (didn't bet)
Seat 6: LuisGR90 folded before Flop (didn't bet)



PokerStars Zoom Hand #257561023705:  Hold'em No Limit (€0.01/€0.02) - 2025/08/31 20:47:24 CET [2025/08/31 14:47:24 ET]
Table 'Arneb' 6-max Seat #1 is the button
Seat 1: TJDasNeves (€2.26 in chips) 
Seat 2: l2orestes (€2 in chips) 
Seat 3: pipinoelbreve9 (€2 in chips) 
Seat 4: euse383 (€1.91 in chips) 
Seat 5: verdugo2275 (€2.61 in chips) 
Seat 6: spoke_6969 (€2.07 in chips) 
l2orestes: posts small blind €0.01
pipinoelbreve9: posts big blind €0.02
*** HOLE CARDS ***
Dealt to pipinoelbreve9 [7h Jd]
euse383: folds 
verdugo2275: folds 
spoke_6969: folds 
TJDasNeves: folds 
l2orestes: folds 
Uncalled bet (€0.01) returned to pipinoelbreve9
pipinoelbreve9 collected €0.02 from pot
pipinoelbreve9: doesn't show hand 
*** SUMMARY ***
Total pot €0.02 | Rake €0 
Seat 1: TJDasNeves (button) folded before Flop (didn't bet)
Seat 2: l2orestes (small blind) folded before Flop
Seat 3: pipinoelbreve9 (big blind) collected (€0.02)
Seat 4: euse383 folded before Flop (didn't bet)
Seat 5: verdugo2275 folded before Flop (didn't bet)
Seat 6: spoke_6969 folded before Flop (didn't bet)



PokerStars Zoom Hand #257561006155:  Hold'em No Limit (€0.01/€0.02) - 2025/08/31 20:46:24 CET [2025/08/31 14:46:24 ET]
Table 'Arneb' 6-max Seat #1 is the button
Seat 1: NikoBzN (€2.92 in chips) 
Seat 2: TEVMONIV (€1.88 in chips) 
Seat 3: KillVerlaine (€2.45 in chips) 
Seat 4: Jota_uVe_1 (€2.64 in chips) 
Seat 5: PolCuenca (€1.67 in chips) 
Seat 6: pipinoelbreve9 (€2 in chips) 
TEVMONIV: posts small blind €0.01
KillVerlaine: posts big blind €0.02
*** HOLE CARDS ***
Dealt to pipinoelbreve9 [4h Js]
Jota_uVe_1: folds 
PolCuenca: folds 
pipinoelbreve9: folds 
NikoBzN: raises €0.02 to €0.04
TEVMONIV: folds 
KillVerlaine: calls €0.02
*** FLOP *** [8s Th 9s]
KillVerlaine: checks 
NikoBzN: checks 
*** TURN *** [8s Th 9s] [Ks]
KillVerlaine: checks 
NikoBzN: checks 
*** RIVER *** [8s Th 9s Ks] [4d]
KillVerlaine: checks 
NikoBzN: bets €0.05
KillVerlaine: folds 
Uncalled bet (€0.05) returned to NikoBzN
NikoBzN collected €0.09 from pot
NikoBzN: doesn't show hand 
*** SUMMARY ***
Total pot €0.09 | Rake €0 
Board [8s Th 9s Ks 4d]
Seat 1: NikoBzN (button) collected (€0.09)
Seat 2: TEVMONIV (small blind) folded before Flop
Seat 3: KillVerlaine (big blind) folded on the River
Seat 4: Jota_uVe_1 folded before Flop (didn't bet)
Seat 5: PolCuenca folded before Flop (didn't bet)
Seat 6: pipinoelbreve9 folded before Flop (didn't bet)



PokerStars Zoom Hand #257561029280:  Hold'em No Limit (€0.01/€0.02) - 2025/08/31 20:47:44 CET [2025/08/31 14:47:44 ET]
Table 'Arneb' 6-max Seat #1 is the button
Seat 1: l2orestes (€2.45 in chips) 
Seat 2: pipinoelbreve9 (€2.01 in chips) 
Seat 3: kastor59 (€2 in chips) 
Seat 4: TEVMONIV (€1.94 in chips) 
Seat 5: UndertheGun7799 (€2.75 in chips) 
Seat 6: dragonfly2467 (€2.03 in chips) 
pipinoelbreve9: posts small blind €0.01
kastor59: posts big blind €0.02
*** HOLE CARDS ***
Dealt to pipinoelbreve9 [Js Kc]
TEVMONIV: folds 
UndertheGun7799: folds 
dragonfly2467: folds 
l2orestes: raises €0.04 to €0.06
pipinoelbreve9: calls €0.05
kastor59: folds 
*** FLOP *** [8h 8d 3d]
pipinoelbreve9: checks 
l2orestes: bets €0.07
pipinoelbreve9: folds 
Uncalled bet (€0.07) returned to l2orestes
l2orestes collected €0.13 from pot
l2orestes: doesn't show hand 
*** SUMMARY ***
Total pot €0.14 | Rake €0.01 
Board [8h 8d 3d]
Seat 1: l2orestes (button) collected (€0.13)
Seat 2: pipinoelbreve9 (small blind) folded on the Flop
Seat 3: kastor59 (big blind) folded before Flop
Seat 4: TEVMONIV folded before Flop (didn't bet)
Seat 5: UndertheGun7799 folded before Flop (didn't bet)
Seat 6: dragonfly2467 folded before Flop (didn't bet)



PokerStars Zoom Hand #257561044062:  Hold'em No Limit (€0.01/€0.02) - 2025/08/31 20:48:34 CET [2025/08/31 14:48:34 ET]
Table 'Arneb' 6-max Seat #1 is the button
Seat 1: pipinoelbreve9 (€2 in chips) 
Seat 2: Lumifer (€2.61 in chips) 
Seat 3: cabsudo77 (€1.20 in chips) 
Seat 4: HGrenha (€6.85 in chips) 
Seat 5: kastor59 (€1.97 in chips) 
Seat 6: l2orestes (€2.52 in chips) 
Lumifer: posts small blind €0.01
cabsudo77: posts big blind €0.02
*** HOLE CARDS ***
Dealt to pipinoelbreve9 [4h Ac]
HGrenha: folds 
kastor59: folds 
l2orestes: folds 
pipinoelbreve9: folds 
Lumifer: folds 
Uncalled bet (€0.01) returned to cabsudo77
cabsudo77 collected €0.02 from pot
cabsudo77: doesn't show hand 
*** SUMMARY ***
Total pot €0.02 | Rake €0 
Seat 1: pipinoelbreve9 (button) folded before Flop (didn't bet)
Seat 2: Lumifer (small blind) folded before Flop
Seat 3: cabsudo77 (big blind) collected (€0.02)
Seat 4: HGrenha folded before Flop (didn't bet)
Seat 5: kastor59 folded before Flop (didn't bet)
Seat 6: l2orestes folded before Flop (didn't bet)



PokerStars Zoom Hand #257561045382:  Hold'em No Limit (€0.01/€0.02) - 2025/08/31 20:48:39 CET [2025/08/31 14:48:39 ET]
Table 'Arneb' 6-max Seat #1 is the button
Seat 1: verdugo2275 (€2 in chips) 
Seat 2: Apdwins (€2.48 in chips) 
Seat 3: pipinoelbreve9 (€2 in chips) 
Seat 4: diabloduende (€2 in chips) 
Seat 5: ColonyStr (€3.11 in chips) 
Seat 6: Jota_uVe_1 (€2 in chips) 
Apdwins: posts small blind €0.01
pipinoelbreve9: posts big blind €0.02
*** HOLE CARDS ***
Dealt to pipinoelbreve9 [6h Qh]
diabloduende: folds 
ColonyStr: folds 
Jota_uVe_1: folds 
verdugo2275: raises €0.03 to €0.05
Apdwins: folds 
pipinoelbreve9: calls €0.03
*** FLOP *** [3d 6c As]
pipinoelbreve9: bets €0.05
verdugo2275: calls €0.05
*** TURN *** [3d 6c As] [7c]
pipinoelbreve9: checks 
verdugo2275: bets €0.13
pipinoelbreve9: folds 
Uncalled bet (€0.13) returned to verdugo2275
verdugo2275 collected €0.20 from pot
verdugo2275: doesn't show hand 
*** SUMMARY ***
Total pot €0.21 | Rake €0.01 
Board [3d 6c As 7c]
Seat 1: verdugo2275 (button) collected (€0.20)
Seat 2: Apdwins (small blind) folded before Flop
Seat 3: pipinoelbreve9 (big blind) folded on the Turn
Seat 4: diabloduende folded before Flop (didn't bet)
Seat 5: ColonyStr folded before Flop (didn't bet)
Seat 6: Jota_uVe_1 folded before Flop (didn't bet)



PokerStars Zoom Hand #257561059263:  Hold'em No Limit (€0.01/€0.02) - 2025/08/31 20:49:27 CET [2025/08/31 14:49:27 ET]
Table 'Arneb' 6-max Seat #1 is the button
Seat 1: kingarmor (€1.09 in chips) 
Seat 2: PolCuenca (€1.94 in chips) 
Seat 3: Izibeaxh (€7.61 in chips) 
Seat 4: vaker01998 (€2.09 in chips) 
Seat 5: aliner34j (€2.21 in chips) 
Seat 6: pipinoelbreve9 (€2 in chips) 
PolCuenca: posts small blind €0.01
Izibeaxh: posts big blind €0.02
*** HOLE CARDS ***
Dealt to pipinoelbreve9 [3d 7s]
vaker01998: folds 
aliner34j: folds 
pipinoelbreve9: folds 
kingarmor: folds 
PolCuenca: folds 
Uncalled bet (€0.01) returned to Izibeaxh
Izibeaxh collected €0.02 from pot
Izibeaxh: doesn't show hand 
*** SUMMARY ***
Total pot €0.02 | Rake €0 
Seat 1: kingarmor (button) folded before Flop (didn't bet)
Seat 2: PolCuenca (small blind) folded before Flop
Seat 3: Izibeaxh (big blind) collected (€0.02)
Seat 4: vaker01998 folded before Flop (didn't bet)
Seat 5: aliner34j folded before Flop (didn't bet)
Seat 6: pipinoelbreve9 folded before Flop (didn't bet)



PokerStars Zoom Hand #257561063366:  Hold'em No Limit (€0.01/€0.02) - 2025/08/31 20:49:41 CET [2025/08/31 14:49:41 ET]
Table 'Arneb' 6-max Seat #1 is the button
Seat 1: Penafcp (€0.54 in chips) 
Seat 2: pipinoelbreve9 (€2 in chips) 
Seat 3: spoke_6969 (€1.56 in chips) 
Seat 4: TJDasNeves (€2.28 in chips) 
Seat 5: PolCuenca (€1.93 in chips) 
Seat 6: Izibeaxh (€7.62 in chips) 
pipinoelbreve9: posts small blind €0.01
spoke_6969: posts big blind €0.02
*** HOLE CARDS ***
Dealt to pipinoelbreve9 [3d Kd]
TJDasNeves: folds 
PolCuenca: folds 
Izibeaxh: folds 
Penafcp: raises €0.04 to €0.06
pipinoelbreve9: calls €0.05
spoke_6969: raises €0.18 to €0.24
Penafcp: raises €0.30 to €0.54 and is all-in
pipinoelbreve9: folds 
spoke_6969: calls €0.30
*** FLOP *** [Th Tc 8d]
*** TURN *** [Th Tc 8d] [Ts]
*** RIVER *** [Th Tc 8d Ts] [3c]
*** SHOW DOWN ***
spoke_6969: shows [Jc 7c] (three of a kind, Tens)
Penafcp: shows [Qd Ah] (three of a kind, Tens - Ace kicker)
Penafcp collected €1.08 from pot
*** SUMMARY ***
Total pot €1.14 | Rake €0.06 
Board [Th Tc 8d Ts 3c]
Seat 1: Penafcp (button) showed [Qd Ah] and won (€1.08) with three of a kind, Tens
Seat 2: pipinoelbreve9 (small blind) folded before Flop
Seat 3: spoke_6969 (big blind) showed [Jc 7c] and lost with three of a kind, Tens
Seat 4: TJDasNeves folded before Flop (didn't bet)
Seat 5: PolCuenca folded before Flop (didn't bet)
Seat 6: Izibeaxh folded before Flop (didn't bet)



PokerStars Zoom Hand #257561060298:  Hold'em No Limit (€0.01/€0.02) - 2025/08/31 20:49:31 CET [2025/08/31 14:49:31 ET]
Table 'Arneb' 6-max Seat #1 is the button
Seat 1: kastor59 (€1.99 in chips) 
Seat 2: cris1966564 (€1.37 in chips) 
Seat 3: koka1151 (€2.02 in chips) 
Seat 4: juranibe (€2.66 in chips) 
Seat 5: pipinoelbreve9 (€2 in chips) 
Seat 6: vaker01998 (€2.09 in chips) 
cris1966564: posts small blind €0.01
koka1151: posts big blind €0.02
*** HOLE CARDS ***
Dealt to pipinoelbreve9 [4h Qh]
juranibe: folds 
pipinoelbreve9: folds 
vaker01998: raises €0.04 to €0.06
kastor59: folds 
cris1966564: calls €0.05
koka1151: folds 
*** FLOP *** [Kc 9d Js]
cris1966564: checks 
vaker01998: checks 
*** TURN *** [Kc 9d Js] [Qc]
cris1966564: checks 
vaker01998: checks 
*** RIVER *** [Kc 9d Js Qc] [5d]
cris1966564: checks 
vaker01998: checks 
*** SHOW DOWN ***
cris1966564: shows [Jc 9c] (two pair, Jacks and Nines)
vaker01998: mucks hand 
cris1966564 collected €0.13 from pot
*** SUMMARY ***
Total pot €0.14 | Rake €0.01 
Board [Kc 9d Js Qc 5d]
Seat 1: kastor59 (button) folded before Flop (didn't bet)
Seat 2: cris1966564 (small blind) showed [Jc 9c] and won (€0.13) with two pair, Jacks and Nines
Seat 3: koka1151 (big blind) folded before Flop
Seat 4: juranibe folded before Flop (didn't bet)
Seat 5: pipinoelbreve9 folded before Flop (didn't bet)
Seat 6: vaker01998 mucked [Ah 8h]



PokerStars Zoom Hand #257561072261:  Hold'em No Limit (€0.01/€0.02) - 2025/08/31 20:50:11 CET [2025/08/31 14:50:11 ET]
Table 'Arneb' 6-max Seat #1 is the button
Seat 1: pipinoelbreve9 (€2 in chips) 
Seat 2: washorage52 (€1.15 in chips) 
Seat 3: Cyrille51971 (€1.82 in chips) 
Seat 4: Chichoampuero12 (€2.02 in chips) 
Seat 5: juranibe (€2.63 in chips) 
Seat 6: kastor59 (€2 in chips) 
washorage52: posts small blind €0.01
Cyrille51971: posts big blind €0.02
*** HOLE CARDS ***
Dealt to pipinoelbreve9 [9d 4s]
Chichoampuero12: raises €0.03 to €0.05
juranibe: folds 
kastor59: calls €0.05
pipinoelbreve9: folds 
washorage52: folds 
Cyrille51971: calls €0.03
*** FLOP *** [Kh 7d 4c]
Cyrille51971: checks 
Chichoampuero12: checks 
kastor59: bets €0.08
Cyrille51971: folds 
Chichoampuero12: calls €0.08
*** TURN *** [Kh 7d 4c] [Jc]
Chichoampuero12: checks 
kastor59: checks 
*** RIVER *** [Kh 7d 4c Jc] [8s]
Chichoampuero12: checks 
kastor59: checks 
*** SHOW DOWN ***
Chichoampuero12: shows [Qd Qs] (a pair of Queens)
kastor59: mucks hand 
Chichoampuero12 collected €0.30 from pot
*** SUMMARY ***
Total pot €0.32 | Rake €0.02 
Board [Kh 7d 4c Jc 8s]
Seat 1: pipinoelbreve9 (button) folded before Flop (didn't bet)
Seat 2: washorage52 (small blind) folded before Flop
Seat 3: Cyrille51971 (big blind) folded on the Flop
Seat 4: Chichoampuero12 showed [Qd Qs] and won (€0.30) with a pair of Queens
Seat 5: juranibe folded before Flop (didn't bet)
Seat 6: kastor59 mucked [Td Th]



PokerStars Zoom Hand #257561076950:  Hold'em No Limit (€0.01/€0.02) - 2025/08/31 20:50:28 CET [2025/08/31 14:50:28 ET]
Table 'Arneb' 6-max Seat #1 is the button
Seat 1: mekinho#1 (€0.71 in chips) 
Seat 2: marsatack28 (€1.94 in chips) 
Seat 3: l2orestes (€2 in chips) 
Seat 4: koka1151 (€4.37 in chips) 
Seat 5: pipinoelbreve9 (€2 in chips) 
Seat 6: jvilela007 (€2.05 in chips) 
marsatack28: posts small blind €0.01
l2orestes: posts big blind €0.02
*** HOLE CARDS ***
Dealt to pipinoelbreve9 [6s 8s]
koka1151: folds 
pipinoelbreve9: folds 
jvilela007: folds 
mekinho#1: folds 
marsatack28: folds 
Uncalled bet (€0.01) returned to l2orestes
l2orestes collected €0.02 from pot
l2orestes: doesn't show hand 
*** SUMMARY ***
Total pot €0.02 | Rake €0 
Seat 1: mekinho#1 (button) folded before Flop (didn't bet)
Seat 2: marsatack28 (small blind) folded before Flop
Seat 3: l2orestes (big blind) collected (€0.02)
Seat 4: koka1151 folded before Flop (didn't bet)
Seat 5: pipinoelbreve9 folded before Flop (didn't bet)
Seat 6: jvilela007 folded before Flop (didn't bet)



PokerStars Zoom Hand #257561074528:  Hold'em No Limit (€0.01/€0.02) - 2025/08/31 20:50:19 CET [2025/08/31 14:50:19 ET]
Table 'Arneb' 6-max Seat #1 is the button
Seat 1: Chichoampuero12 (€4.71 in chips) 
Seat 2: chivi71 (€1.53 in chips) 
Seat 3: verdugo2275 (€2.09 in chips) 
Seat 4: kastor59 (€2 in chips) 
Seat 5: Fredkiller800 (€2.17 in chips) 
Seat 6: pipinoelbreve9 (€2 in chips) 
chivi71: posts small blind €0.01
verdugo2275: posts big blind €0.02
*** HOLE CARDS ***
Dealt to pipinoelbreve9 [3s Qh]
kastor59: folds 
Fredkiller800: folds 
pipinoelbreve9: folds 
Chichoampuero12: folds 
chivi71: calls €0.01
verdugo2275: checks 
*** FLOP *** [Tc Ts 9d]
chivi71: bets €0.02
verdugo2275: calls €0.02
*** TURN *** [Tc Ts 9d] [7d]
chivi71: bets €0.02
verdugo2275: calls €0.02
*** RIVER *** [Tc Ts 9d 7d] [7h]
chivi71: bets €0.02
verdugo2275: raises €0.11 to €0.13
chivi71: folds 
Uncalled bet (€0.11) returned to verdugo2275
verdugo2275 collected €0.15 from pot
verdugo2275: doesn't show hand 
*** SUMMARY ***
Total pot €0.16 | Rake €0.01 
Board [Tc Ts 9d 7d 7h]
Seat 1: Chichoampuero12 (button) folded before Flop (didn't bet)
Seat 2: chivi71 (small blind) folded on the River
Seat 3: verdugo2275 (big blind) collected (€0.15)
Seat 4: kastor59 folded before Flop (didn't bet)
Seat 5: Fredkiller800 folded before Flop (didn't bet)
Seat 6: pipinoelbreve9 folded before Flop (didn't bet)



PokerStars Zoom Hand #257561079682:  Hold'em No Limit (€0.01/€0.02) - 2025/08/31 20:50:37 CET [2025/08/31 14:50:37 ET]
Table 'Arneb' 6-max Seat #1 is the button
Seat 1: mekinho#1 (€0.72 in chips) 
Seat 2: Penafcp (€1.11 in chips) 
Seat 3: TEVMONIV (€4.62 in chips) 
Seat 4: pipinoelbreve9 (€2 in chips) 
Seat 5: Izibeaxh (€7.20 in chips) 
Seat 6: geovannyhanna (€2.14 in chips) 
Penafcp: posts small blind €0.01
TEVMONIV: posts big blind €0.02
*** HOLE CARDS ***
Dealt to pipinoelbreve9 [Js Th]
pipinoelbreve9: raises €0.04 to €0.06
Izibeaxh: folds 
geovannyhanna: folds 
mekinho#1: folds 
Penafcp: folds 
TEVMONIV: calls €0.04
*** FLOP *** [4s 4d 7c]
TEVMONIV: checks 
pipinoelbreve9: checks 
*** TURN *** [4s 4d 7c] [Qd]
TEVMONIV: checks 
pipinoelbreve9: checks 
*** RIVER *** [4s 4d 7c Qd] [5s]
TEVMONIV: checks 
pipinoelbreve9: checks 
*** SHOW DOWN ***
TEVMONIV: shows [Jd Kc] (a pair of Fours)
pipinoelbreve9: mucks hand 
TEVMONIV collected €0.12 from pot
*** SUMMARY ***
Total pot €0.13 | Rake €0.01 
Board [4s 4d 7c Qd 5s]
Seat 1: mekinho#1 (button) folded before Flop (didn't bet)
Seat 2: Penafcp (small blind) folded before Flop
Seat 3: TEVMONIV (big blind) showed [Jd Kc] and won (€0.12) with a pair of Fours
Seat 4: pipinoelbreve9 mucked [Js Th]
Seat 5: Izibeaxh folded before Flop (didn't bet)
Seat 6: geovannyhanna folded before Flop (didn't bet)



PokerStars Zoom Hand #257561100430:  Hold'em No Limit (€0.01/€0.02) - 2025/08/31 20:51:49 CET [2025/08/31 14:51:49 ET]
Table 'Arneb' 6-max Seat #1 is the button
Seat 1: verdugo2275 (€2.42 in chips) 
Seat 2: pipinoelbreve9 (€2 in chips) 
Seat 3: joaninha124 (€1.78 in chips) 
Seat 4: PolCuenca (€2.77 in chips) 
Seat 5: masquisiera (€1.14 in chips) 
Seat 6: jvilela007 (€2 in chips) 
pipinoelbreve9: posts small blind €0.01
joaninha124: posts big blind €0.02
*** HOLE CARDS ***
Dealt to pipinoelbreve9 [6d Jh]
PolCuenca: folds 
masquisiera: raises €0.04 to €0.06
jvilela007: calls €0.06
verdugo2275: folds 
pipinoelbreve9: folds 
joaninha124: folds 
*** FLOP *** [9h Kc 8c]
masquisiera: checks 
jvilela007: bets €0.07
masquisiera: calls €0.07
*** TURN *** [9h Kc 8c] [Tc]
masquisiera: checks 
jvilela007: bets €0.20
masquisiera: folds 
Uncalled bet (€0.20) returned to jvilela007
jvilela007 collected €0.28 from pot
jvilela007: doesn't show hand 
*** SUMMARY ***
Total pot €0.29 | Rake €0.01 
Board [9h Kc 8c Tc]
Seat 1: verdugo2275 (button) folded before Flop (didn't bet)
Seat 2: pipinoelbreve9 (small blind) folded before Flop
Seat 3: joaninha124 (big blind) folded before Flop
Seat 4: PolCuenca folded before Flop (didn't bet)
Seat 5: masquisiera folded on the Turn
Seat 6: jvilela007 collected (€0.28)



PokerStars Zoom Hand #257561102923:  Hold'em No Limit (€0.01/€0.02) - 2025/08/31 20:51:57 CET [2025/08/31 14:51:57 ET]
Table 'Arneb' 6-max Seat #1 is the button
Seat 1: TJDasNeves (€2.30 in chips) 
Seat 2: Marguinha04 (€2.05 in chips) 
Seat 3: bdcscstars (€2 in chips) 
Seat 4: pipinoelbreve9 (€2 in chips) 
Seat 5: NikoBzN (€3.09 in chips) 
Seat 6: verdugo2275 (€2.42 in chips) 
Marguinha04: posts small blind €0.01
bdcscstars: posts big blind €0.02
*** HOLE CARDS ***
Dealt to pipinoelbreve9 [8c 4s]
pipinoelbreve9: folds 
NikoBzN: folds 
verdugo2275: raises €0.04 to €0.06
TJDasNeves: folds 
Marguinha04: folds 
bdcscstars: folds 
Uncalled bet (€0.04) returned to verdugo2275
verdugo2275 collected €0.05 from pot
verdugo2275: doesn't show hand 
*** SUMMARY ***
Total pot €0.05 | Rake €0 
Seat 1: TJDasNeves (button) folded before Flop (didn't bet)
Seat 2: Marguinha04 (small blind) folded before Flop
Seat 3: bdcscstars (big blind) folded before Flop
Seat 4: pipinoelbreve9 folded before Flop (didn't bet)
Seat 5: NikoBzN folded before Flop (didn't bet)
Seat 6: verdugo2275 collected (€0.05)



PokerStars Zoom Hand #257561105076:  Hold'em No Limit (€0.01/€0.02) - 2025/08/31 20:52:05 CET [2025/08/31 14:52:05 ET]
Table 'Arneb' 6-max Seat #1 is the button
Seat 1: Lumifer (€2.11 in chips) 
Seat 2: pitjoueur (€0.45 in chips) 
Seat 3: pipinoelbreve9 (€2 in chips) 
Seat 4: l2orestes (€2 in chips) 
Seat 5: TEVMONIV (€1.90 in chips) 
Seat 6: aliner34j (€2.21 in chips) 
pitjoueur: posts small blind €0.01
pipinoelbreve9: posts big blind €0.02
*** HOLE CARDS ***
Dealt to pipinoelbreve9 [Kh 7s]
l2orestes: folds 
TEVMONIV: folds 
aliner34j: calls €0.02
Lumifer: folds 
pitjoueur: raises €0.43 to €0.45 and is all-in
pipinoelbreve9: folds 
aliner34j: calls €0.43
*** FLOP *** [Ad 3s 8s]
*** TURN *** [Ad 3s 8s] [Ah]
*** RIVER *** [Ad 3s 8s Ah] [Th]
*** SHOW DOWN ***
pitjoueur: shows [Jc Td] (two pair, Aces and Tens)
aliner34j: shows [Qh Qc] (two pair, Aces and Queens)
pitjoueur is disconnected 
aliner34j collected €0.87 from pot
*** SUMMARY ***
Total pot €0.92 | Rake €0.05 
Board [Ad 3s 8s Ah Th]
Seat 1: Lumifer (button) folded before Flop (didn't bet)
Seat 2: pitjoueur (small blind) showed [Jc Td] and lost with two pair, Aces and Tens
Seat 3: pipinoelbreve9 (big blind) folded before Flop
Seat 4: l2orestes folded before Flop (didn't bet)
Seat 5: TEVMONIV folded before Flop (didn't bet)
Seat 6: aliner34j showed [Qh Qc] and won (€0.87) with two pair, Aces and Queens



PokerStars Zoom Hand #257561114752:  Hold'em No Limit (€0.01/€0.02) - 2025/08/31 20:52:38 CET [2025/08/31 14:52:38 ET]
Table 'Arneb' 6-max Seat #1 is the button
Seat 1: koka1151 (€2.21 in chips) 
Seat 2: Marguinha04 (€2.04 in chips) 
Seat 3: eric stl 196 (€1.05 in chips) 
Seat 4: Lumifer (€2.19 in chips) 
Seat 5: IKinneas (€2.33 in chips) 
Seat 6: pipinoelbreve9 (€2 in chips) 
Marguinha04: posts small blind €0.01
eric stl 196: posts big blind €0.02
*** HOLE CARDS ***
Dealt to pipinoelbreve9 [4d 6d]
Lumifer: folds 
IKinneas: folds 
pipinoelbreve9: folds 
koka1151: folds 
Marguinha04: raises €0.02 to €0.04
eric stl 196: folds 
Uncalled bet (€0.02) returned to Marguinha04
Marguinha04 collected €0.04 from pot
Marguinha04: doesn't show hand 
*** SUMMARY ***
Total pot €0.04 | Rake €0 
Seat 1: koka1151 (button) folded before Flop (didn't bet)
Seat 2: Marguinha04 (small blind) collected (€0.04)
Seat 3: eric stl 196 (big blind) folded before Flop
Seat 4: Lumifer folded before Flop (didn't bet)
Seat 5: IKinneas folded before Flop (didn't bet)
Seat 6: pipinoelbreve9 folded before Flop (didn't bet)



PokerStars Zoom Hand #257561116414:  Hold'em No Limit (€0.01/€0.02) - 2025/08/31 20:52:45 CET [2025/08/31 14:52:45 ET]
Table 'Arneb' 6-max Seat #1 is the button
Seat 1: kastor59 (€1.99 in chips) 
Seat 2: dragonfly2467 (€2.29 in chips) 
Seat 3: aliner34j (€2.62 in chips) 
Seat 4: pipinoelbreve9 (€2 in chips) 
Seat 5: Lumifer (€2.19 in chips) 
Seat 6: mekinho#1 (€0.66 in chips) 
dragonfly2467: posts small blind €0.01
aliner34j: posts big blind €0.02
*** HOLE CARDS ***
Dealt to pipinoelbreve9 [9c Jd]
pipinoelbreve9: folds 
Lumifer: folds 
mekinho#1: calls €0.02
kastor59: folds 
dragonfly2467: folds 
aliner34j: checks 
*** FLOP *** [4c 2c 2d]
aliner34j: checks 
mekinho#1: bets €0.02
aliner34j: folds 
Uncalled bet (€0.02) returned to mekinho#1
mekinho#1 collected €0.05 from pot
mekinho#1: doesn't show hand 
*** SUMMARY ***
Total pot €0.05 | Rake €0 
Board [4c 2c 2d]
Seat 1: kastor59 (button) folded before Flop (didn't bet)
Seat 2: dragonfly2467 (small blind) folded before Flop
Seat 3: aliner34j (big blind) folded on the Flop
Seat 4: pipinoelbreve9 folded before Flop (didn't bet)
Seat 5: Lumifer folded before Flop (didn't bet)
Seat 6: mekinho#1 collected (€0.05)



PokerStars Zoom Hand #257561111417:  Hold'em No Limit (€0.01/€0.02) - 2025/08/31 20:52:27 CET [2025/08/31 14:52:27 ET]
Table 'Arneb' 6-max Seat #1 is the button
Seat 1: pipinoelbreve9 (€2 in chips) 
Seat 2: l2orestes (€2 in chips) 
Seat 3: kastor59 (€2.02 in chips) 
Seat 4: washorage52 (€1 in chips) 
Seat 5: vaker01998 (€1.75 in chips) 
Seat 6: jvilela007 (€2.15 in chips) 
l2orestes: posts small blind €0.01
kastor59: posts big blind €0.02
*** HOLE CARDS ***
Dealt to pipinoelbreve9 [Qc Th]
washorage52: calls €0.02
vaker01998: raises €0.12 to €0.14
jvilela007: folds 
pipinoelbreve9: folds 
l2orestes: folds 
kastor59: folds 
washorage52: calls €0.12
*** FLOP *** [2d Kc Ts]
washorage52: bets €0.10
vaker01998: calls €0.10
*** TURN *** [2d Kc Ts] [9h]
washorage52: bets €0.18
vaker01998: calls €0.18
*** RIVER *** [2d Kc Ts 9h] [4c]
washorage52: bets €0.58 and is all-in
vaker01998: calls €0.58
*** SHOW DOWN ***
washorage52: shows [As Kh] (a pair of Kings)
vaker01998: shows [3h 3c] (a pair of Threes)
washorage52 collected €1.93 from pot
*** SUMMARY ***
Total pot €2.03 | Rake €0.10 
Board [2d Kc Ts 9h 4c]
Seat 1: pipinoelbreve9 (button) folded before Flop (didn't bet)
Seat 2: l2orestes (small blind) folded before Flop
Seat 3: kastor59 (big blind) folded before Flop
Seat 4: washorage52 showed [As Kh] and won (€1.93) with a pair of Kings
Seat 5: vaker01998 showed [3h 3c] and lost with a pair of Threes
Seat 6: jvilela007 folded before Flop (didn't bet)



PokerStars Zoom Hand #257561118036:  Hold'em No Limit (€0.01/€0.02) - 2025/08/31 20:52:50 CET [2025/08/31 14:52:50 ET]
Table 'Arneb' 6-max Seat #1 is the button
Seat 1: dragonfly2467 (€2.28 in chips) 
Seat 2: jvilela007 (€2.13 in chips) 
Seat 3: pipinoelbreve9 (€2 in chips) 
Seat 4: PolCuenca (€1.82 in chips) 
Seat 5: nyko2a (€3.89 in chips) 
Seat 6: TEVMONIV (€4.65 in chips) 
jvilela007: posts small blind €0.01
pipinoelbreve9: posts big blind €0.02
*** HOLE CARDS ***
Dealt to pipinoelbreve9 [9h Qs]
PolCuenca: folds 
nyko2a: folds 
TEVMONIV: folds 
dragonfly2467: folds 
jvilela007: raises €0.04 to €0.06
pipinoelbreve9: calls €0.04
*** FLOP *** [3h 7h 8c]
jvilela007: checks 
pipinoelbreve9: checks 
*** TURN *** [3h 7h 8c] [7s]
jvilela007: bets €0.08
pipinoelbreve9: folds 
Uncalled bet (€0.08) returned to jvilela007
jvilela007 collected €0.11 from pot
jvilela007: doesn't show hand 
*** SUMMARY ***
Total pot €0.12 | Rake €0.01 
Board [3h 7h 8c 7s]
Seat 1: dragonfly2467 (button) folded before Flop (didn't bet)
Seat 2: jvilela007 (small blind) collected (€0.11)
Seat 3: pipinoelbreve9 (big blind) folded on the Turn
Seat 4: PolCuenca folded before Flop (didn't bet)
Seat 5: nyko2a folded before Flop (didn't bet)
Seat 6: TEVMONIV folded before Flop (didn't bet)



PokerStars Zoom Hand #257561126389:  Hold'em No Limit (€0.01/€0.02) - 2025/08/31 20:53:19 CET [2025/08/31 14:53:19 ET]
Table 'Arneb' 6-max Seat #1 is the button
Seat 1: pipinoelbreve9 (€2 in chips) 
Seat 2: Lumifer (€2.66 in chips) 
Seat 3: Lobedaureille (€2 in chips) 
Seat 4: vaker01998 (€0.75 in chips) 
Seat 5: jvilela007 (€2.18 in chips) 
Seat 6: TEVMONIV (€4.64 in chips) 
Lumifer: posts small blind €0.01
Lobedaureille: posts big blind €0.02
*** HOLE CARDS ***
Dealt to pipinoelbreve9 [Qc 4c]
vaker01998: folds 
jvilela007: folds 
TEVMONIV: raises €0.03 to €0.05
pipinoelbreve9: folds 
Lumifer: folds 
Lobedaureille: calls €0.03
*** FLOP *** [7h 5d 9h]
Lobedaureille: checks 
TEVMONIV: checks 
*** TURN *** [7h 5d 9h] [Jc]
Lobedaureille: checks 
TEVMONIV: checks 
*** RIVER *** [7h 5d 9h Jc] [5s]
Lobedaureille: checks 
TEVMONIV: checks 
*** SHOW DOWN ***
Lobedaureille: shows [Ks Th] (a pair of Fives)
TEVMONIV: shows [Kd Ac] (a pair of Fives - Ace kicker)
TEVMONIV collected €0.10 from pot
*** SUMMARY ***
Total pot €0.11 | Rake €0.01 
Board [7h 5d 9h Jc 5s]
Seat 1: pipinoelbreve9 (button) folded before Flop (didn't bet)
Seat 2: Lumifer (small blind) folded before Flop
Seat 3: Lobedaureille (big blind) showed [Ks Th] and lost with a pair of Fives
Seat 4: vaker01998 folded before Flop (didn't bet)
Seat 5: jvilela007 folded before Flop (didn't bet)
Seat 6: TEVMONIV showed [Kd Ac] and won (€0.10) with a pair of Fives



PokerStars Zoom Hand #257561132235:  Hold'em No Limit (€0.01/€0.02) - 2025/08/31 20:53:39 CET [2025/08/31 14:53:39 ET]
Table 'Arneb' 6-max Seat #1 is the button
Seat 1: marsatack28 (€1.66 in chips) 
Seat 2: Cyrille51971 (€1.92 in chips) 
Seat 3: vaker01998 (€2 in chips) 
Seat 4: l2orestes (€2.30 in chips) 
Seat 5: pipinoelbreve9 (€2 in chips) 
Seat 6: Penafcp (€1.15 in chips) 
Cyrille51971: posts small blind €0.01
vaker01998: posts big blind €0.02
*** HOLE CARDS ***
Dealt to pipinoelbreve9 [Ac 2s]
l2orestes: folds 
pipinoelbreve9: folds 
Penafcp: raises €0.02 to €0.04
marsatack28: raises €1.62 to €1.66 and is all-in
Cyrille51971: folds 
vaker01998: folds 
Penafcp: folds 
Uncalled bet (€1.62) returned to marsatack28
marsatack28 collected €0.11 from pot
marsatack28: doesn't show hand 
*** SUMMARY ***
Total pot €0.11 | Rake €0 
Seat 1: marsatack28 (button) collected (€0.11)
Seat 2: Cyrille51971 (small blind) folded before Flop
Seat 3: vaker01998 (big blind) folded before Flop
Seat 4: l2orestes folded before Flop (didn't bet)
Seat 5: pipinoelbreve9 folded before Flop (didn't bet)
Seat 6: Penafcp folded before Flop



PokerStars Zoom Hand #257561136241:  Hold'em No Limit (€0.01/€0.02) - 2025/08/31 20:53:53 CET [2025/08/31 14:53:53 ET]
Table 'Arneb' 6-max Seat #1 is the button
Seat 1: Capi010 (€1.12 in chips) 
Seat 2: kastor59 (€1.87 in chips) 
Seat 3: bdcscstars (€2.16 in chips) 
Seat 4: Tymoko (€7.09 in chips) 
Seat 5: vaker01998 (€1.98 in chips) 
Seat 6: pipinoelbreve9 (€2 in chips) 
kastor59: posts small blind €0.01
bdcscstars: posts big blind €0.02
*** HOLE CARDS ***
Dealt to pipinoelbreve9 [7d Ah]
Tymoko: folds 
vaker01998: folds 
pipinoelbreve9: folds 
Capi010: raises €0.02 to €0.04
kastor59: folds 
bdcscstars: folds 
Uncalled bet (€0.02) returned to Capi010
Capi010 collected €0.05 from pot
Capi010: doesn't show hand 
*** SUMMARY ***
Total pot €0.05 | Rake €0 
Seat 1: Capi010 (button) collected (€0.05)
Seat 2: kastor59 (small blind) folded before Flop
Seat 3: bdcscstars (big blind) folded before Flop
Seat 4: Tymoko folded before Flop (didn't bet)
Seat 5: vaker01998 folded before Flop (didn't bet)
Seat 6: pipinoelbreve9 folded before Flop (didn't bet)



PokerStars Zoom Hand #257561130563:  Hold'em No Limit (€0.01/€0.02) - 2025/08/31 20:53:33 CET [2025/08/31 14:53:33 ET]
Table 'Arneb' 6-max Seat #1 is the button
Seat 1: Lumifer (€2.14 in chips) 
Seat 2: pipinoelbreve9 (€2 in chips) 
Seat 3: cris1966564 (€1.31 in chips) 
Seat 4: euse383 (€1.48 in chips) 
Seat 5: ColonyStr (€3.17 in chips) 
Seat 6: SrLyrox (€3.14 in chips) 
pipinoelbreve9: posts small blind €0.01
cris1966564: posts big blind €0.02
*** HOLE CARDS ***
Dealt to pipinoelbreve9 [Js 9d]
euse383: folds 
ColonyStr: folds 
SrLyrox: folds 
Lumifer: raises €0.03 to €0.05
pipinoelbreve9: folds 
cris1966564: calls €0.03
*** FLOP *** [3h Td 3s]
cris1966564: checks 
Lumifer: checks 
*** TURN *** [3h Td 3s] [Jd]
cris1966564: checks 
Lumifer: checks 
*** RIVER *** [3h Td 3s Jd] [6s]
cris1966564: checks 
Lumifer: bets €0.08
cris1966564: calls €0.08
*** SHOW DOWN ***
Lumifer: shows [Jc Qs] (two pair, Jacks and Threes)
cris1966564: mucks hand 
Lumifer collected €0.26 from pot
*** SUMMARY ***
Total pot €0.27 | Rake €0.01 
Board [3h Td 3s Jd 6s]
Seat 1: Lumifer (button) showed [Jc Qs] and won (€0.26) with two pair, Jacks and Threes
Seat 2: pipinoelbreve9 (small blind) folded before Flop
Seat 3: cris1966564 (big blind) mucked [8h 8c]
Seat 4: euse383 folded before Flop (didn't bet)
Seat 5: ColonyStr folded before Flop (didn't bet)
Seat 6: SrLyrox folded before Flop (didn't bet)



PokerStars Zoom Hand #257561140693:  Hold'em No Limit (€0.01/€0.02) - 2025/08/31 20:54:09 CET [2025/08/31 14:54:09 ET]
Table 'Arneb' 6-max Seat #1 is the button
Seat 1: euse383 (€1.48 in chips) 
Seat 2: bdcscstars (€1.41 in chips) 
Seat 3: NOROK374 (€1.67 in chips) 
Seat 4: pipinoelbreve9 (€2 in chips) 
Seat 5: IKinneas (€2.30 in chips) 
Seat 6: dragonfly2467 (€2.09 in chips) 
bdcscstars: posts small blind €0.01
NOROK374: posts big blind €0.02
*** HOLE CARDS ***
Dealt to pipinoelbreve9 [Jc 8c]
pipinoelbreve9: folds 
IKinneas: folds 
dragonfly2467: folds 
euse383: folds 
bdcscstars: folds 
Uncalled bet (€0.01) returned to NOROK374
NOROK374 collected €0.02 from pot
NOROK374: doesn't show hand 
*** SUMMARY ***
Total pot €0.02 | Rake €0 
Seat 1: euse383 (button) folded before Flop (didn't bet)
Seat 2: bdcscstars (small blind) folded before Flop
Seat 3: NOROK374 (big blind) collected (€0.02)
Seat 4: pipinoelbreve9 folded before Flop (didn't bet)
Seat 5: IKinneas folded before Flop (didn't bet)
Seat 6: dragonfly2467 folded before Flop (didn't bet)



PokerStars Zoom Hand #257561142450:  Hold'em No Limit (€0.01/€0.02) - 2025/08/31 20:54:15 CET [2025/08/31 14:54:15 ET]
Table 'Arneb' 6-max Seat #1 is the button
Seat 1: Apdwins (€2.75 in chips) 
Seat 2: cris1966564 (€1.18 in chips) 
Seat 3: pipinoelbreve9 (€2 in chips) 
Seat 4: NikoBzN (€2.83 in chips) 
Seat 5: TJDasNeves (€2.06 in chips) 
Seat 6: Lumifer (€2.27 in chips) 
cris1966564: posts small blind €0.01
pipinoelbreve9: posts big blind €0.02
*** HOLE CARDS ***
Dealt to pipinoelbreve9 [9c 7d]
NikoBzN: folds 
TJDasNeves: folds 
Lumifer: folds 
Apdwins: folds 
cris1966564: calls €0.01
pipinoelbreve9: checks 
*** FLOP *** [Tc 9s Ah]
cris1966564: checks 
pipinoelbreve9: bets €0.02
cris1966564: calls €0.02
*** TURN *** [Tc 9s Ah] [2s]
cris1966564: checks 
pipinoelbreve9: bets €0.04
cris1966564: calls €0.04
*** RIVER *** [Tc 9s Ah 2s] [3s]
cris1966564: checks 
pipinoelbreve9: checks 
*** SHOW DOWN ***
cris1966564: shows [Js 9h] (a pair of Nines)
pipinoelbreve9: mucks hand 
cris1966564 collected €0.15 from pot
*** SUMMARY ***
Total pot €0.16 | Rake €0.01 
Board [Tc 9s Ah 2s 3s]
Seat 1: Apdwins (button) folded before Flop (didn't bet)
Seat 2: cris1966564 (small blind) showed [Js 9h] and won (€0.15) with a pair of Nines
Seat 3: pipinoelbreve9 (big blind) mucked [9c 7d]
Seat 4: NikoBzN folded before Flop (didn't bet)
Seat 5: TJDasNeves folded before Flop (didn't bet)
Seat 6: Lumifer folded before Flop (didn't bet)



PokerStars Zoom Hand #257561155462:  Hold'em No Limit (€0.01/€0.02) - 2025/08/31 20:55:00 CET [2025/08/31 14:55:00 ET]
Table 'Arneb' 6-max Seat #1 is the button
Seat 1: Marguinha04 (€1.80 in chips) 
Seat 2: pipinoelbreve9 (€2 in chips) 
Seat 3: TJDasNeves (€2.21 in chips) 
Seat 4: cris1966564 (€1.25 in chips) 
Seat 5: vaker01998 (€2.23 in chips) 
Seat 6: flamencolega (€1.38 in chips) 
pipinoelbreve9: posts small blind €0.01
TJDasNeves: posts big blind €0.02
*** HOLE CARDS ***
Dealt to pipinoelbreve9 [6h Td]
cris1966564: folds 
vaker01998: folds 
flamencolega: folds 
Marguinha04: raises €0.02 to €0.04
pipinoelbreve9: folds 
TJDasNeves: folds 
Uncalled bet (€0.02) returned to Marguinha04
Marguinha04 collected €0.05 from pot
Marguinha04: doesn't show hand 
*** SUMMARY ***
Total pot €0.05 | Rake €0 
Seat 1: Marguinha04 (button) collected (€0.05)
Seat 2: pipinoelbreve9 (small blind) folded before Flop
Seat 3: TJDasNeves (big blind) folded before Flop
Seat 4: cris1966564 folded before Flop (didn't bet)
Seat 5: vaker01998 folded before Flop (didn't bet)
Seat 6: flamencolega folded before Flop (didn't bet)



PokerStars Zoom Hand #257561156951:  Hold'em No Limit (€0.01/€0.02) - 2025/08/31 20:55:05 CET [2025/08/31 14:55:05 ET]
Table 'Arneb' 6-max Seat #1 is the button
Seat 1: pipinoelbreve9 (€2 in chips) 
Seat 2: euse383 (€1.54 in chips) 
Seat 3: Jota_uVe_1 (€2.10 in chips) 
Seat 4: cris1966564 (€1.25 in chips) 
Seat 5: TEVMONIV (€2.18 in chips) 
Seat 6: zemas123123 (€1.39 in chips) 
euse383: posts small blind €0.01
Jota_uVe_1: posts big blind €0.02
*** HOLE CARDS ***
Dealt to pipinoelbreve9 [Ks 6s]
cris1966564: calls €0.02
TEVMONIV: raises €0.06 to €0.08
zemas123123: folds 
pipinoelbreve9: calls €0.08
euse383: folds 
Jota_uVe_1: folds 
cris1966564: calls €0.06
*** FLOP *** [9s Qd Jd]
cris1966564: checks 
TEVMONIV: checks 
pipinoelbreve9: checks 
*** TURN *** [9s Qd Jd] [3d]
cris1966564: checks 
TEVMONIV: checks 
pipinoelbreve9: checks 
*** RIVER *** [9s Qd Jd 3d] [8c]
cris1966564: checks 
TEVMONIV: bets €0.20
pipinoelbreve9: folds 
cris1966564: folds 
Uncalled bet (€0.20) returned to TEVMONIV
TEVMONIV collected €0.26 from pot
TEVMONIV: doesn't show hand 
*** SUMMARY ***
Total pot €0.27 | Rake €0.01 
Board [9s Qd Jd 3d 8c]
Seat 1: pipinoelbreve9 (button) folded on the River
Seat 2: euse383 (small blind) folded before Flop
Seat 3: Jota_uVe_1 (big blind) folded before Flop
Seat 4: cris1966564 folded on the River
Seat 5: TEVMONIV collected (€0.26)
Seat 6: zemas123123 folded before Flop (didn't bet)



PokerStars Zoom Hand #257561168587:  Hold'em No Limit (€0.01/€0.02) - 2025/08/31 20:56:22 CET [2025/08/31 14:56:22 ET]
Table 'Arneb' 6-max Seat #1 is the button
Seat 1: PolCuenca (€2.75 in chips) 
Seat 2: Lumifer (€2 in chips) 
Seat 3: Capi010 (€1.14 in chips) 
Seat 4: masquisiera (€1.07 in chips) 
Seat 5: pipinoelbreve9 (€2 in chips) 
Seat 6: Andres010328 (€0.88 in chips) 
Lumifer: posts small blind €0.01
Capi010: posts big blind €0.02
*** HOLE CARDS ***
Dealt to pipinoelbreve9 [6s Kh]
masquisiera: folds 
pipinoelbreve9: folds 
Andres010328: folds 
PolCuenca: folds 
Lumifer: folds 
Uncalled bet (€0.01) returned to Capi010
Capi010 collected €0.02 from pot
Capi010: doesn't show hand 
*** SUMMARY ***
Total pot €0.02 | Rake €0 
Seat 1: PolCuenca (button) folded before Flop (didn't bet)
Seat 2: Lumifer (small blind) folded before Flop
Seat 3: Capi010 (big blind) collected (€0.02)
Seat 4: masquisiera folded before Flop (didn't bet)
Seat 5: pipinoelbreve9 folded before Flop (didn't bet)
Seat 6: Andres010328 folded before Flop (didn't bet)



PokerStars Zoom Hand #257561169730:  Hold'em No Limit (€0.01/€0.02) - 2025/08/31 20:56:30 CET [2025/08/31 14:56:30 ET]
Table 'Arneb' 6-max Seat #1 is the button
Seat 1: euse383 (€2.36 in chips) 
Seat 2: Lumifer (€2.24 in chips) 
Seat 3: koka1151 (€2 in chips) 
Seat 4: dragonfly2467 (€2.15 in chips) 
Seat 5: Andres010328 (€0.88 in chips) 
Seat 6: pipinoelbreve9 (€2 in chips) 
Lumifer: posts small blind €0.01
koka1151: posts big blind €0.02
*** HOLE CARDS ***
Dealt to pipinoelbreve9 [8h Qh]
dragonfly2467: folds 
Andres010328: folds 
pipinoelbreve9: raises €0.04 to €0.06
euse383: folds 
Lumifer: calls €0.05
koka1151: folds 
*** FLOP *** [7s 2s 7c]
Lumifer: checks 
pipinoelbreve9: checks 
*** TURN *** [7s 2s 7c] [2h]
Lumifer: bets €0.06
pipinoelbreve9: folds 
Uncalled bet (€0.06) returned to Lumifer
Lumifer collected €0.13 from pot
Lumifer: doesn't show hand 
*** SUMMARY ***
Total pot €0.14 | Rake €0.01 
Board [7s 2s 7c 2h]
Seat 1: euse383 (button) folded before Flop (didn't bet)
Seat 2: Lumifer (small blind) collected (€0.13)
Seat 3: koka1151 (big blind) folded before Flop
Seat 4: dragonfly2467 folded before Flop (didn't bet)
Seat 5: Andres010328 folded before Flop (didn't bet)
Seat 6: pipinoelbreve9 folded on the Turn



PokerStars Zoom Hand #257561175874:  Hold'em No Limit (€0.01/€0.02) - 2025/08/31 20:57:11 CET [2025/08/31 14:57:11 ET]
Table 'Arneb' 6-max Seat #1 is the button
Seat 1: zemas123123 (€1.11 in chips) 
Seat 2: Lumifer (€2 in chips) 
Seat 3: NOROK374 (€1.76 in chips) 
Seat 4: elinspectorG (€1.07 in chips) 
Seat 5: pipinoelbreve9 (€2 in chips) 
Seat 6: bdcscstars (€1.81 in chips) 
Lumifer: posts small blind €0.01
NOROK374: posts big blind €0.02
*** HOLE CARDS ***
Dealt to pipinoelbreve9 [8h 9s]
elinspectorG: raises €0.04 to €0.06
pipinoelbreve9: folds 
bdcscstars: folds 
zemas123123: folds 
Lumifer: folds 
NOROK374: folds 
Uncalled bet (€0.04) returned to elinspectorG
elinspectorG collected €0.05 from pot
elinspectorG: doesn't show hand 
*** SUMMARY ***
Total pot €0.05 | Rake €0 
Seat 1: zemas123123 (button) folded before Flop (didn't bet)
Seat 2: Lumifer (small blind) folded before Flop
Seat 3: NOROK374 (big blind) folded before Flop
Seat 4: elinspectorG collected (€0.05)
Seat 5: pipinoelbreve9 folded before Flop (didn't bet)
Seat 6: bdcscstars folded before Flop (didn't bet)



PokerStars Zoom Hand #257561176895:  Hold'em No Limit (€0.01/€0.02) - 2025/08/31 20:57:18 CET [2025/08/31 14:57:18 ET]
Table 'Arneb' 6-max Seat #1 is the button
Seat 1: koka1151 (€2.20 in chips) 
Seat 2: WookySixx (€3.55 in chips) 
Seat 3: mekinho#1 (€0.69 in chips) 
Seat 4: bdcscstars (€2.05 in chips) 
Seat 5: UndertheGun7799 (€3.09 in chips) 
Seat 6: pipinoelbreve9 (€2 in chips) 
WookySixx: posts small blind €0.01
mekinho#1: posts big blind €0.02
*** HOLE CARDS ***
Dealt to pipinoelbreve9 [5s Qs]
bdcscstars: folds 
UndertheGun7799: folds 
pipinoelbreve9: raises €0.04 to €0.06
koka1151: folds 
WookySixx: raises €0.26 to €0.32
mekinho#1: folds 
pipinoelbreve9: folds 
Uncalled bet (€0.26) returned to WookySixx
WookySixx collected €0.14 from pot
WookySixx: doesn't show hand 
*** SUMMARY ***
Total pot €0.14 | Rake €0 
Seat 1: koka1151 (button) folded before Flop (didn't bet)
Seat 2: WookySixx (small blind) collected (€0.14)
Seat 3: mekinho#1 (big blind) folded before Flop
Seat 4: bdcscstars folded before Flop (didn't bet)
Seat 5: UndertheGun7799 folded before Flop (didn't bet)
Seat 6: pipinoelbreve9 folded before Flop



PokerStars Zoom Hand #257561182792:  Hold'em No Limit (€0.01/€0.02) - 2025/08/31 20:57:58 CET [2025/08/31 14:57:58 ET]
Table 'Arneb' 6-max Seat #1 is the button
Seat 1: SrLyrox (€2.90 in chips) 
Seat 2: Lumifer (€2.30 in chips) 
Seat 3: WookySixx (€3.63 in chips) 
Seat 4: pipinoelbreve9 (€2 in chips) 
Seat 5: danireal77 (€1.91 in chips) 
Seat 6: PolCuenca (€1.93 in chips) 
Lumifer: posts small blind €0.01
WookySixx: posts big blind €0.02
*** HOLE CARDS ***
Dealt to pipinoelbreve9 [7h As]
pipinoelbreve9: folds 
danireal77: folds 
PolCuenca: folds 
SrLyrox: folds 
Lumifer: folds 
Uncalled bet (€0.01) returned to WookySixx
WookySixx collected €0.02 from pot
WookySixx: doesn't show hand 
*** SUMMARY ***
Total pot €0.02 | Rake €0 
Seat 1: SrLyrox (button) folded before Flop (didn't bet)
Seat 2: Lumifer (small blind) folded before Flop
Seat 3: WookySixx (big blind) collected (€0.02)
Seat 4: pipinoelbreve9 folded before Flop (didn't bet)
Seat 5: danireal77 folded before Flop (didn't bet)
Seat 6: PolCuenca folded before Flop (didn't bet)



PokerStars Zoom Hand #257561183435:  Hold'em No Limit (€0.01/€0.02) - 2025/08/31 20:58:02 CET [2025/08/31 14:58:02 ET]
Table 'Arneb' 6-max Seat #1 is the button
Seat 1: CHISPITA9 (€0.75 in chips) 
Seat 2: eric stl 196 (€0.74 in chips) 
Seat 3: pipinoelbreve9 (€2 in chips) 
Seat 4: marsatack28 (€1.51 in chips) 
Seat 5: l2orestes (€2.22 in chips) 
Seat 6: bdcscstars (€1.42 in chips) 
eric stl 196: posts small blind €0.01
pipinoelbreve9: posts big blind €0.02
*** HOLE CARDS ***
Dealt to pipinoelbreve9 [9d Ad]
marsatack28: raises €0.05 to €0.07
l2orestes: folds 
bdcscstars: folds 
CHISPITA9: calls €0.07
eric stl 196: folds 
pipinoelbreve9: raises €0.19 to €0.26
marsatack28: raises €1.25 to €1.51 and is all-in
CHISPITA9: calls €0.68 and is all-in
pipinoelbreve9: calls €1.25
*** FLOP *** [9c Jc Ts]
*** TURN *** [9c Jc Ts] [6s]
*** RIVER *** [9c Jc Ts 6s] [5c]
*** SHOW DOWN ***
pipinoelbreve9: shows [9d Ad] (a pair of Nines)
marsatack28: shows [Jd Js] (three of a kind, Jacks)
marsatack28 collected €1.44 from side pot
CHISPITA9: shows [Ac Tc] (a flush, Ace high)
CHISPITA9 collected €2.15 from main pot
*** SUMMARY ***
Total pot €3.78 Main pot €2.15. Side pot €1.44. | Rake €0.19 
Board [9c Jc Ts 6s 5c]
Seat 1: CHISPITA9 (button) showed [Ac Tc] and won (€2.15) with a flush, Ace high
Seat 2: eric stl 196 (small blind) folded before Flop
Seat 3: pipinoelbreve9 (big blind) showed [9d Ad] and lost with a pair of Nines
Seat 4: marsatack28 showed [Jd Js] and won (€1.44) with three of a kind, Jacks
Seat 5: l2orestes folded before Flop (didn't bet)
Seat 6: bdcscstars folded before Flop (didn't bet)



PokerStars Zoom Hand #257561190947:  Hold'em No Limit (€0.01/€0.02) - 2025/08/31 20:58:53 CET [2025/08/31 14:58:53 ET]
Table 'Arneb' 6-max Seat #1 is the button
Seat 1: marsatack28 (€1.44 in chips) 
Seat 2: pipinoelbreve9 (€2 in chips) 
Seat 3: IKinneas (€2.26 in chips) 
Seat 4: Lumifer (€2 in chips) 
Seat 5: NikoBzN (€2.75 in chips) 
Seat 6: CHISPITA9 (€2.15 in chips) 
pipinoelbreve9: posts small blind €0.01
IKinneas: posts big blind €0.02
*** HOLE CARDS ***
Dealt to pipinoelbreve9 [Jc Ah]
Lumifer: raises €0.03 to €0.05
NikoBzN: folds 
CHISPITA9: folds 
marsatack28: calls €0.05
pipinoelbreve9: calls €0.04
IKinneas: calls €0.03
*** FLOP *** [9s 8d 6s]
pipinoelbreve9: checks 
IKinneas: checks 
Lumifer: checks 
marsatack28: checks 
*** TURN *** [9s 8d 6s] [4h]
pipinoelbreve9: checks 
IKinneas: bets €0.06
Lumifer: folds 
marsatack28: folds 
pipinoelbreve9: folds 
Uncalled bet (€0.06) returned to IKinneas
IKinneas collected €0.19 from pot
IKinneas: doesn't show hand 
*** SUMMARY ***
Total pot €0.20 | Rake €0.01 
Board [9s 8d 6s 4h]
Seat 1: marsatack28 (button) folded on the Turn
Seat 2: pipinoelbreve9 (small blind) folded on the Turn
Seat 3: IKinneas (big blind) collected (€0.19)
Seat 4: Lumifer folded on the Turn
Seat 5: NikoBzN folded before Flop (didn't bet)
Seat 6: CHISPITA9 folded before Flop (didn't bet)



PokerStars Zoom Hand #257561197322:  Hold'em No Limit (€0.01/€0.02) - 2025/08/31 20:59:35 CET [2025/08/31 14:59:35 ET]
Table 'Arneb' 6-max Seat #1 is the button
Seat 1: pipinoelbreve9 (€2 in chips) 
Seat 2: Lumifer (€2 in chips) 
Seat 3: bdcscstars (€2.21 in chips) 
Seat 4: pauvj (€3.39 in chips) 
Seat 5: koka1151 (€4.82 in chips) 
Seat 6: Jota_uVe_1 (€2.20 in chips) 
Lumifer: posts small blind €0.01
bdcscstars: posts big blind €0.02
*** HOLE CARDS ***
Dealt to pipinoelbreve9 [5h 6h]
pauvj: folds 
koka1151: folds 
Jota_uVe_1: folds 
pipinoelbreve9: raises €0.04 to €0.06
Lumifer: raises €0.18 to €0.24
bdcscstars: folds 
pipinoelbreve9: calls €0.18
*** FLOP *** [Tc 6s Td]
Lumifer: bets €0.24
pipinoelbreve9: calls €0.24
*** TURN *** [Tc 6s Td] [Ks]
Lumifer: bets €0.46
pipinoelbreve9: folds 
Uncalled bet (€0.46) returned to Lumifer
Lumifer collected €0.93 from pot
Lumifer: doesn't show hand 
*** SUMMARY ***
Total pot €0.98 | Rake €0.05 
Board [Tc 6s Td Ks]
Seat 1: pipinoelbreve9 (button) folded on the Turn
Seat 2: Lumifer (small blind) collected (€0.93)
Seat 3: bdcscstars (big blind) folded before Flop
Seat 4: pauvj folded before Flop (didn't bet)
Seat 5: koka1151 folded before Flop (didn't bet)
Seat 6: Jota_uVe_1 folded before Flop (didn't bet)



PokerStars Zoom Hand #257561208210:  Hold'em No Limit (€0.01/€0.02) - 2025/08/31 21:00:43 CET [2025/08/31 15:00:43 ET]
Table 'Arneb' 6-max Seat #1 is the button
Seat 1: TJDasNeves (€2.10 in chips) 
Seat 2: koka1151 (€4.83 in chips) 
Seat 3: joaninha124 (€1.40 in chips) 
Seat 4: pipinoelbreve9 (€2 in chips) 
Seat 5: l2orestes (€2 in chips) 
Seat 6: Jota_uVe_1 (€2.16 in chips) 
koka1151: posts small blind €0.01
joaninha124: posts big blind €0.02
*** HOLE CARDS ***
Dealt to pipinoelbreve9 [6c Jd]
pipinoelbreve9: folds 
l2orestes: folds 
Jota_uVe_1: folds 
TJDasNeves: folds 
koka1151: folds 
Uncalled bet (€0.01) returned to joaninha124
joaninha124 collected €0.02 from pot
joaninha124: doesn't show hand 
*** SUMMARY ***
Total pot €0.02 | Rake €0 
Seat 1: TJDasNeves (button) folded before Flop (didn't bet)
Seat 2: koka1151 (small blind) folded before Flop
Seat 3: joaninha124 (big blind) collected (€0.02)
Seat 4: pipinoelbreve9 folded before Flop (didn't bet)
Seat 5: l2orestes folded before Flop (didn't bet)
Seat 6: Jota_uVe_1 folded before Flop (didn't bet)



PokerStars Zoom Hand #257561208878:  Hold'em No Limit (€0.01/€0.02) - 2025/08/31 21:00:46 CET [2025/08/31 15:00:46 ET]
Table 'Arneb' 6-max Seat #1 is the button
Seat 1: Lumifer (€2.45 in chips) 
Seat 2: pipinoelbreve9 (€2 in chips) 
Seat 3: Tymoko (€6.82 in chips) 
Seat 4: eric stl 196 (€0.57 in chips) 
Seat 5: kastor59 (€2.37 in chips) 
Seat 6: koka1151 (€4.82 in chips) 
pipinoelbreve9: posts small blind €0.01
Tymoko: posts big blind €0.02
*** HOLE CARDS ***
Dealt to pipinoelbreve9 [8d 6s]
eric stl 196: folds 
kastor59: folds 
koka1151: folds 
Lumifer: raises €0.03 to €0.05
pipinoelbreve9: folds 
Tymoko: folds 
Uncalled bet (€0.03) returned to Lumifer
Lumifer collected €0.05 from pot
Lumifer: doesn't show hand 
*** SUMMARY ***
Total pot €0.05 | Rake €0 
Seat 1: Lumifer (button) collected (€0.05)
Seat 2: pipinoelbreve9 (small blind) folded before Flop
Seat 3: Tymoko (big blind) folded before Flop
Seat 4: eric stl 196 folded before Flop (didn't bet)
Seat 5: kastor59 folded before Flop (didn't bet)
Seat 6: koka1151 folded before Flop (didn't bet)



PokerStars Zoom Hand #257561210112:  Hold'em No Limit (€0.01/€0.02) - 2025/08/31 21:00:54 CET [2025/08/31 15:00:54 ET]
Table 'Arneb' 6-max Seat #1 is the button
Seat 1: l2orestes (€2.41 in chips) 
Seat 2: marsatack28 (€2.04 in chips) 
Seat 3: pipinoelbreve9 (€2 in chips) 
Seat 4: Elons_Mucks (€2 in chips) 
Seat 5: Jota_uVe_1 (€2 in chips) 
Seat 6: UndertheGun7799 (€2.84 in chips) 
marsatack28: posts small blind €0.01
pipinoelbreve9: posts big blind €0.02
*** HOLE CARDS ***
Dealt to pipinoelbreve9 [Ac 8d]
Elons_Mucks: folds 
Jota_uVe_1: folds 
UndertheGun7799: folds 
l2orestes: folds 
marsatack28: folds 
Uncalled bet (€0.01) returned to pipinoelbreve9
pipinoelbreve9 collected €0.02 from pot
pipinoelbreve9: doesn't show hand 
*** SUMMARY ***
Total pot €0.02 | Rake €0 
Seat 1: l2orestes (button) folded before Flop (didn't bet)
Seat 2: marsatack28 (small blind) folded before Flop
Seat 3: pipinoelbreve9 (big blind) collected (€0.02)
Seat 4: Elons_Mucks folded before Flop (didn't bet)
Seat 5: Jota_uVe_1 folded before Flop (didn't bet)
Seat 6: UndertheGun7799 folded before Flop (didn't bet)



PokerStars Zoom Hand #257561217300:  Hold'em No Limit (€0.01/€0.02) - 2025/08/31 21:01:30 CET [2025/08/31 15:01:30 ET]
Table 'Arneb' 6-max Seat #1 is the button
Seat 1: marsatack28 (€1.31 in chips) 
Seat 2: bdcscstars (€1.87 in chips) 
Seat 3: pauvj (€3.48 in chips) 
Seat 4: mekinho#1 (€0.93 in chips) 
Seat 5: Lumifer (€2.46 in chips) 
Seat 6: pipinoelbreve9 (€2.01 in chips) 
bdcscstars: posts small blind €0.01
pauvj: posts big blind €0.02
*** HOLE CARDS ***
Dealt to pipinoelbreve9 [Ad 6d]
mekinho#1: folds 
Lumifer: folds 
pipinoelbreve9: raises €0.04 to €0.06
marsatack28: folds 
bdcscstars: folds 
pauvj: calls €0.04
*** FLOP *** [Jh 9s 7h]
pauvj: bets €0.07
pipinoelbreve9: folds 
Uncalled bet (€0.07) returned to pauvj
pauvj collected €0.12 from pot
pauvj: doesn't show hand 
*** SUMMARY ***
Total pot €0.13 | Rake €0.01 
Board [Jh 9s 7h]
Seat 1: marsatack28 (button) folded before Flop (didn't bet)
Seat 2: bdcscstars (small blind) folded before Flop
Seat 3: pauvj (big blind) collected (€0.12)
Seat 4: mekinho#1 folded before Flop (didn't bet)
Seat 5: Lumifer folded before Flop (didn't bet)
Seat 6: pipinoelbreve9 folded on the Flop



PokerStars Zoom Hand #257561214898:  Hold'em No Limit (€0.01/€0.02) - 2025/08/31 21:01:18 CET [2025/08/31 15:01:18 ET]
Table 'Arneb' 6-max Seat #1 is the button
Seat 1: pipinoelbreve9 (€2.01 in chips) 
Seat 2: Jota_uVe_1 (€2.14 in chips) 
Seat 3: Marguinha04 (€0.87 in chips) 
Seat 4: danireal77 (€1.87 in chips) 
Seat 5: marsatack28 (€1.32 in chips) 
Seat 6: bdcscstars (€2.08 in chips) 
Jota_uVe_1: posts small blind €0.01
Marguinha04: posts big blind €0.02
*** HOLE CARDS ***
Dealt to pipinoelbreve9 [Jh 2h]
danireal77: calls €0.02
marsatack28: folds 
bdcscstars: folds 
pipinoelbreve9: folds 
Jota_uVe_1: folds 
Marguinha04: checks 
*** FLOP *** [6h 9s 7h]
Marguinha04: checks 
danireal77: checks 
*** TURN *** [6h 9s 7h] [As]
Marguinha04: bets €0.02
danireal77: calls €0.02
*** RIVER *** [6h 9s 7h As] [4s]
Marguinha04: bets €0.02
danireal77: raises €0.32 to €0.34
Marguinha04: folds 
Uncalled bet (€0.32) returned to danireal77
danireal77 collected €0.12 from pot
danireal77: doesn't show hand 
*** SUMMARY ***
Total pot €0.13 | Rake €0.01 
Board [6h 9s 7h As 4s]
Seat 1: pipinoelbreve9 (button) folded before Flop (didn't bet)
Seat 2: Jota_uVe_1 (small blind) folded before Flop
Seat 3: Marguinha04 (big blind) folded on the River
Seat 4: danireal77 collected (€0.12)
Seat 5: marsatack28 folded before Flop (didn't bet)
Seat 6: bdcscstars folded before Flop (didn't bet)



PokerStars Zoom Hand #257561216057:  Hold'em No Limit (€0.01/€0.02) - 2025/08/31 21:01:23 CET [2025/08/31 15:01:23 ET]
Table 'Arneb' 6-max Seat #1 is the button
Seat 1: euse383 (€2.24 in chips) 
Seat 2: Andres010328 (€0.89 in chips) 
Seat 3: bdcscstars (€2.54 in chips) 
Seat 4: nyko2a (€3.83 in chips) 
Seat 5: pipinoelbreve9 (€2.01 in chips) 
Seat 6: Lumifer (€2.46 in chips) 
Andres010328: posts small blind €0.01
bdcscstars: posts big blind €0.02
*** HOLE CARDS ***
Dealt to pipinoelbreve9 [8c 6c]
nyko2a: folds 
pipinoelbreve9: folds 
Lumifer: folds 
euse383: folds 
Andres010328: calls €0.01
bdcscstars: raises €0.04 to €0.06
Andres010328: calls €0.04
*** FLOP *** [2d 3s 6h]
Andres010328: bets €0.04
bdcscstars: calls €0.04
*** TURN *** [2d 3s 6h] [Qd]
Andres010328: bets €0.02
bdcscstars: raises €0.08 to €0.10
Andres010328: calls €0.08
*** RIVER *** [2d 3s 6h Qd] [9d]
Andres010328: checks 
bdcscstars: bets €0.25
Andres010328: calls €0.25
*** SHOW DOWN ***
bdcscstars: shows [8d Td] (a flush, Queen high)
Andres010328: mucks hand 
bdcscstars collected €0.86 from pot
*** SUMMARY ***
Total pot €0.90 | Rake €0.04 
Board [2d 3s 6h Qd 9d]
Seat 1: euse383 (button) folded before Flop (didn't bet)
Seat 2: Andres010328 (small blind) mucked [5d 3c]
Seat 3: bdcscstars (big blind) showed [8d Td] and won (€0.86) with a flush, Queen high
Seat 4: nyko2a folded before Flop (didn't bet)
Seat 5: pipinoelbreve9 folded before Flop (didn't bet)
Seat 6: Lumifer folded before Flop (didn't bet)



PokerStars Zoom Hand #257561223219:  Hold'em No Limit (€0.01/€0.02) - 2025/08/31 21:01:57 CET [2025/08/31 15:01:57 ET]
Table 'Arneb' 6-max Seat #1 is the button
Seat 1: cris1966564 (€1.38 in chips) 
Seat 2: kastor59 (€1.95 in chips) 
Seat 3: pipinoelbreve9 (€2 in chips) 
Seat 4: euse383 (€1.98 in chips) 
Seat 5: TEVMONIV (€1.55 in chips) 
Seat 6: pauvj (€3.54 in chips) 
kastor59: posts small blind €0.01
pipinoelbreve9: posts big blind €0.02
*** HOLE CARDS ***
Dealt to pipinoelbreve9 [8h 6s]
euse383: folds 
TEVMONIV: folds 
pauvj: calls €0.02
cris1966564: calls €0.02
kastor59: folds 
pipinoelbreve9: checks 
*** FLOP *** [6c 6h 7d]
pipinoelbreve9: bets €0.04
pauvj is disconnected 
pauvj has timed out while disconnected
pauvj: folds 
cris1966564: folds 
Uncalled bet (€0.04) returned to pipinoelbreve9
pipinoelbreve9 collected €0.07 from pot
pipinoelbreve9: doesn't show hand 
*** SUMMARY ***
Total pot €0.07 | Rake €0 
Board [6c 6h 7d]
Seat 1: cris1966564 (button) folded on the Flop
Seat 2: kastor59 (small blind) folded before Flop
Seat 3: pipinoelbreve9 (big blind) collected (€0.07)
Seat 4: euse383 folded before Flop (didn't bet)
Seat 5: TEVMONIV folded before Flop (didn't bet)
Seat 6: pauvj folded on the Flop



PokerStars Zoom Hand #257561245261:  Hold'em No Limit (€0.01/€0.02) - 2025/08/31 21:03:21 CET [2025/08/31 15:03:21 ET]
Table 'Arneb' 6-max Seat #1 is the button
Seat 1: marsatack28 (€2.10 in chips) 
Seat 2: U k'ray.pt (€1.01 in chips) 
Seat 3: eric stl 196 (€0.99 in chips) 
Seat 4: cris1966564 (€1.08 in chips) 
Seat 5: pipinoelbreve9 (€2.05 in chips) 
Seat 6: euse383 (€2 in chips) 
U k'ray.pt: posts small blind €0.01
eric stl 196: posts big blind €0.02
*** HOLE CARDS ***
Dealt to pipinoelbreve9 [Ks Qs]
cris1966564: folds 
pipinoelbreve9: raises €0.04 to €0.06
euse383: calls €0.06
marsatack28: calls €0.06
U k'ray.pt: calls €0.05
eric stl 196: folds 
*** FLOP *** [7c 2s 4s]
U k'ray.pt: checks 
pipinoelbreve9: checks 
euse383: checks 
marsatack28: checks 
*** TURN *** [7c 2s 4s] [2c]
U k'ray.pt: checks 
pipinoelbreve9: bets €0.17
euse383: folds 
marsatack28: folds 
U k'ray.pt: calls €0.17
*** RIVER *** [7c 2s 4s 2c] [4d]
U k'ray.pt: bets €0.57
pipinoelbreve9: folds 
Uncalled bet (€0.57) returned to U k'ray.pt
U k'ray.pt collected €0.57 from pot
U k'ray.pt: doesn't show hand 
*** SUMMARY ***
Total pot €0.60 | Rake €0.03 
Board [7c 2s 4s 2c 4d]
Seat 1: marsatack28 (button) folded on the Turn
Seat 2: U k'ray.pt (small blind) collected (€0.57)
Seat 3: eric stl 196 (big blind) folded before Flop
Seat 4: cris1966564 folded before Flop (didn't bet)
Seat 5: pipinoelbreve9 folded on the River
Seat 6: euse383 folded on the Turn



PokerStars Zoom Hand #257561271492:  Hold'em No Limit (€0.01/€0.02) - 2025/08/31 21:04:52 CET [2025/08/31 15:04:52 ET]
Table 'Arneb' 6-max Seat #1 is the button
Seat 1: TEVMONIV (€1.51 in chips) 
Seat 2: pipinoelbreve9 (€2 in chips) 
Seat 3: Jota_uVe_1 (€2.05 in chips) 
Seat 4: gregoss054 (€2.03 in chips) 
Seat 5: l2orestes (€2 in chips) 
Seat 6: TJDasNeves (€3.20 in chips) 
pipinoelbreve9: posts small blind €0.01
Jota_uVe_1: posts big blind €0.02
*** HOLE CARDS ***
Dealt to pipinoelbreve9 [3c 7d]
gregoss054: folds 
l2orestes: folds 
TJDasNeves: folds 
TEVMONIV: raises €0.03 to €0.05
pipinoelbreve9: folds 
Jota_uVe_1: folds 
Uncalled bet (€0.03) returned to TEVMONIV
TEVMONIV collected €0.05 from pot
TEVMONIV: doesn't show hand 
*** SUMMARY ***
Total pot €0.05 | Rake €0 
Seat 1: TEVMONIV (button) collected (€0.05)
Seat 2: pipinoelbreve9 (small blind) folded before Flop
Seat 3: Jota_uVe_1 (big blind) folded before Flop
Seat 4: gregoss054 folded before Flop (didn't bet)
Seat 5: l2orestes folded before Flop (didn't bet)
Seat 6: TJDasNeves folded before Flop (didn't bet)



PokerStars Zoom Hand #257561276618:  Hold'em No Limit (€0.01/€0.02) - 2025/08/31 21:05:09 CET [2025/08/31 15:05:09 ET]
Table 'Arneb' 6-max Seat #1 is the button
Seat 1: l2orestes (€2.24 in chips) 
Seat 2: diabloduende (€1.46 in chips) 
Seat 3: elinspectorG (€1.31 in chips) 
Seat 4: CHISPITA9 (€2.63 in chips) 
Seat 5: Cruasan17 (€2.98 in chips) 
Seat 6: pipinoelbreve9 (€2 in chips) 
diabloduende: posts small blind €0.01
elinspectorG: posts big blind €0.02
*** HOLE CARDS ***
Dealt to pipinoelbreve9 [3h Jh]
CHISPITA9: folds 
Cruasan17: folds 
pipinoelbreve9: folds 
l2orestes: folds 
diabloduende: folds 
Uncalled bet (€0.01) returned to elinspectorG
elinspectorG collected €0.02 from pot
elinspectorG: doesn't show hand 
*** SUMMARY ***
Total pot €0.02 | Rake €0 
Seat 1: l2orestes (button) folded before Flop (didn't bet)
Seat 2: diabloduende (small blind) folded before Flop
Seat 3: elinspectorG (big blind) collected (€0.02)
Seat 4: CHISPITA9 folded before Flop (didn't bet)
Seat 5: Cruasan17 folded before Flop (didn't bet)
Seat 6: pipinoelbreve9 folded before Flop (didn't bet)



PokerStars Zoom Hand #257561278531:  Hold'em No Limit (€0.01/€0.02) - 2025/08/31 21:05:15 CET [2025/08/31 15:05:15 ET]
Table 'Arneb' 6-max Seat #1 is the button
Seat 1: TEVMONIV (€2.41 in chips) 
Seat 2: pipinoelbreve9 (€2 in chips) 
Seat 3: flamencolega (€3.10 in chips) 
Seat 4: mekinho#1 (€0.78 in chips) 
Seat 5: Vanderveld1971 (€1.39 in chips) 
Seat 6: PetroniloPT (€0.92 in chips) 
pipinoelbreve9: posts small blind €0.01
flamencolega: posts big blind €0.02
*** HOLE CARDS ***
Dealt to pipinoelbreve9 [2s 4s]
mekinho#1: folds 
Vanderveld1971: raises €0.02 to €0.04
PetroniloPT: calls €0.04
TEVMONIV: raises €0.20 to €0.24
pipinoelbreve9: folds 
flamencolega: folds 
Vanderveld1971: folds 
PetroniloPT: folds 
Uncalled bet (€0.20) returned to TEVMONIV
TEVMONIV collected €0.15 from pot
TEVMONIV: doesn't show hand 
*** SUMMARY ***
Total pot €0.15 | Rake €0 
Seat 1: TEVMONIV (button) collected (€0.15)
Seat 2: pipinoelbreve9 (small blind) folded before Flop
Seat 3: flamencolega (big blind) folded before Flop
Seat 4: mekinho#1 folded before Flop (didn't bet)
Seat 5: Vanderveld1971 folded before Flop
Seat 6: PetroniloPT folded before Flop



PokerStars Zoom Hand #257561274720:  Hold'em No Limit (€0.01/€0.02) - 2025/08/31 21:05:02 CET [2025/08/31 15:05:02 ET]
Table 'Arneb' 6-max Seat #1 is the button
Seat 1: pipinoelbreve9 (€2 in chips) 
Seat 2: mekinho#1 (€0.79 in chips) 
Seat 3: masquisiera (€1 in chips) 
Seat 4: SrLyrox (€3.73 in chips) 
Seat 5: HGrenha (€6.80 in chips) 
Seat 6: danireal77 (€1.76 in chips) 
mekinho#1: posts small blind €0.01
masquisiera: posts big blind €0.02
*** HOLE CARDS ***
Dealt to pipinoelbreve9 [Js 3c]
SrLyrox: folds 
HGrenha: folds 
danireal77: raises €0.06 to €0.08
pipinoelbreve9: folds 
mekinho#1: folds 
masquisiera: calls €0.06
*** FLOP *** [7d Jc 6h]
masquisiera: checks 
danireal77: bets €0.16
masquisiera: calls €0.16
*** TURN *** [7d Jc 6h] [8s]
masquisiera: checks 
danireal77: bets €0.24
masquisiera: raises €0.26 to €0.50
danireal77: calls €0.26
*** RIVER *** [7d Jc 6h 8s] [4h]
masquisiera: bets €0.26 and is all-in
danireal77: calls €0.26
*** SHOW DOWN ***
masquisiera: shows [Ad Jh] (a pair of Jacks)
danireal77: shows [9d 9c] (a pair of Nines)
masquisiera collected €1.91 from pot
*** SUMMARY ***
Total pot €2.01 | Rake €0.10 
Board [7d Jc 6h 8s 4h]
Seat 1: pipinoelbreve9 (button) folded before Flop (didn't bet)
Seat 2: mekinho#1 (small blind) folded before Flop
Seat 3: masquisiera (big blind) showed [Ad Jh] and won (€1.91) with a pair of Jacks
Seat 4: SrLyrox folded before Flop (didn't bet)
Seat 5: HGrenha folded before Flop (didn't bet)
Seat 6: danireal77 showed [9d 9c] and lost with a pair of Nines



PokerStars Zoom Hand #257561279941:  Hold'em No Limit (€0.01/€0.02) - 2025/08/31 21:05:20 CET [2025/08/31 15:05:20 ET]
Table 'Arneb' 6-max Seat #1 is the button
Seat 1: pipinoelbreve9 (€2 in chips) 
Seat 2: SrLyrox (€2.07 in chips) 
Seat 3: diabloduende (€1.45 in chips) 
Seat 4: nyko2a (€2.33 in chips) 
Seat 5: l2orestes (€2 in chips) 
Seat 6: UndertheGun7799 (€2.42 in chips) 
SrLyrox: posts small blind €0.01
diabloduende: posts big blind €0.02
*** HOLE CARDS ***
Dealt to pipinoelbreve9 [Ks Kd]
nyko2a: folds 
l2orestes: folds 
UndertheGun7799: raises €0.04 to €0.06
pipinoelbreve9: raises €0.08 to €0.14
SrLyrox: folds 
diabloduende: folds 
UndertheGun7799: raises €0.08 to €0.22
pipinoelbreve9: raises €1.78 to €2 and is all-in
UndertheGun7799: calls €1.78
*** FLOP *** [4s 9d 4h]
*** TURN *** [4s 9d 4h] [3s]
*** RIVER *** [4s 9d 4h 3s] [Qs]
*** SHOW DOWN ***
UndertheGun7799: shows [Ac Ah] (two pair, Aces and Fours)
pipinoelbreve9: shows [Ks Kd] (two pair, Kings and Fours)
UndertheGun7799 collected €3.83 from pot
*** SUMMARY ***
Total pot €4.03 | Rake €0.20 
Board [4s 9d 4h 3s Qs]
Seat 1: pipinoelbreve9 (button) showed [Ks Kd] and lost with two pair, Kings and Fours
Seat 2: SrLyrox (small blind) folded before Flop
Seat 3: diabloduende (big blind) folded before Flop
Seat 4: nyko2a folded before Flop (didn't bet)
Seat 5: l2orestes folded before Flop (didn't bet)
Seat 6: UndertheGun7799 showed [Ac Ah] and won (€3.83) with two pair, Aces and Fours



PokerStars Zoom Hand #257561268340:  Hold'em No Limit (€0.01/€0.02) - 2025/08/31 21:04:41 CET [2025/08/31 15:04:41 ET]
Table 'Arneb' 6-max Seat #1 is the button
Seat 1: bdcscstars (€2.98 in chips) 
Seat 2: Maori_083 (€0.72 in chips) 
Seat 3: TJDasNeves (€2 in chips) 
Seat 4: pipinoelbreve9 (€2 in chips) 
Seat 5: danywoo (€1.47 in chips) 
Seat 6: U k'ray.pt (€1.35 in chips) 
Maori_083: posts small blind €0.01
TJDasNeves: posts big blind €0.02
*** HOLE CARDS ***
Dealt to pipinoelbreve9 [8s 3s]
pipinoelbreve9: folds 
danywoo: calls €0.02
U k'ray.pt: calls €0.02
bdcscstars: raises €0.09 to €0.11
Maori_083: folds 
TJDasNeves: folds 
danywoo: calls €0.09
U k'ray.pt: calls €0.09
*** FLOP *** [Qd Kc Kd]
danywoo: checks 
U k'ray.pt: bets €0.17
bdcscstars: folds 
danywoo: calls €0.17
*** TURN *** [Qd Kc Kd] [3d]
danywoo: checks 
U k'ray.pt: checks 
*** RIVER *** [Qd Kc Kd 3d] [Ah]
danywoo: bets €0.66
U k'ray.pt: raises €0.41 to €1.07 and is all-in
danywoo: calls €0.41
*** SHOW DOWN ***
U k'ray.pt: shows [Kh Jd] (three of a kind, Kings)
danywoo: shows [Ad 4d] (a flush, Ace high)
danywoo collected €2.70 from pot
*** SUMMARY ***
Total pot €2.84 | Rake €0.14 
Board [Qd Kc Kd 3d Ah]
Seat 1: bdcscstars (button) folded on the Flop
Seat 2: Maori_083 (small blind) folded before Flop
Seat 3: TJDasNeves (big blind) folded before Flop
Seat 4: pipinoelbreve9 folded before Flop (didn't bet)
Seat 5: danywoo showed [Ad 4d] and won (€2.70) with a flush, Ace high
Seat 6: U k'ray.pt showed [Kh Jd] and lost with three of a kind, Kings



PokerStars Zoom Hand #257561288308:  Hold'em No Limit (€0.01/€0.02) - 2025/08/31 21:05:48 CET [2025/08/31 15:05:48 ET]
Table 'Arneb' 6-max Seat #1 is the button
Seat 1: l2orestes (€2 in chips) 
Seat 2: PetroniloPT (€0.88 in chips) 
Seat 3: pipinoelbreve9 (€2 in chips) 
Seat 4: danireal77 (€0.76 in chips) 
Seat 5: UndertheGun7799 (€4.25 in chips) 
Seat 6: bdcscstars (€2.13 in chips) 
PetroniloPT: posts small blind €0.01
pipinoelbreve9: posts big blind €0.02
*** HOLE CARDS ***
Dealt to pipinoelbreve9 [9c 5c]
danireal77: raises €0.74 to €0.76 and is all-in
UndertheGun7799: folds 
bdcscstars: calls €0.76
l2orestes: folds 
PetroniloPT: folds 
pipinoelbreve9: folds 
*** FLOP *** [9h Qd Qs]
*** TURN *** [9h Qd Qs] [Ah]
*** RIVER *** [9h Qd Qs Ah] [Th]
*** SHOW DOWN ***
danireal77: shows [Tc Kh] (two pair, Queens and Tens)
bdcscstars: shows [Js Jh] (two pair, Queens and Jacks)
bdcscstars collected €1.47 from pot
*** SUMMARY ***
Total pot €1.55 | Rake €0.08 
Board [9h Qd Qs Ah Th]
Seat 1: l2orestes (button) folded before Flop (didn't bet)
Seat 2: PetroniloPT (small blind) folded before Flop
Seat 3: pipinoelbreve9 (big blind) folded before Flop
Seat 4: danireal77 showed [Tc Kh] and lost with two pair, Queens and Tens
Seat 5: UndertheGun7799 folded before Flop (didn't bet)
Seat 6: bdcscstars showed [Js Jh] and won (€1.47) with two pair, Queens and Jacks



PokerStars Zoom Hand #257561290471:  Hold'em No Limit (€0.01/€0.02) - 2025/08/31 21:05:55 CET [2025/08/31 15:05:55 ET]
Table 'Arneb' 6-max Seat #1 is the button
Seat 1: HGrenha (€6.62 in chips) 
Seat 2: nyko2a (€2.34 in chips) 
Seat 3: TEVMONIV (€1.75 in chips) 
Seat 4: TJDasNeves (€2.04 in chips) 
Seat 5: l2orestes (€2 in chips) 
Seat 6: pipinoelbreve9 (€2 in chips) 
nyko2a: posts small blind €0.01
TEVMONIV: posts big blind €0.02
*** HOLE CARDS ***
Dealt to pipinoelbreve9 [7d 8c]
TJDasNeves: folds 
l2orestes: folds 
pipinoelbreve9: folds 
HGrenha: raises €0.16 to €0.18
nyko2a: folds 
TEVMONIV: folds 
Uncalled bet (€0.16) returned to HGrenha
HGrenha collected €0.05 from pot
HGrenha: doesn't show hand 
*** SUMMARY ***
Total pot €0.05 | Rake €0 
Seat 1: HGrenha (button) collected (€0.05)
Seat 2: nyko2a (small blind) folded before Flop
Seat 3: TEVMONIV (big blind) folded before Flop
Seat 4: TJDasNeves folded before Flop (didn't bet)
Seat 5: l2orestes folded before Flop (didn't bet)
Seat 6: pipinoelbreve9 folded before Flop (didn't bet)



PokerStars Zoom Hand #257561292258:  Hold'em No Limit (€0.01/€0.02) - 2025/08/31 21:06:01 CET [2025/08/31 15:06:01 ET]
Table 'Arneb' 6-max Seat #1 is the button
Seat 1: UndertheGun7799 (€4.25 in chips) 
Seat 2: mekinho#1 (€0.52 in chips) 
Seat 3: PetroniloPT (€0.87 in chips) 
Seat 4: masquisiera (€1.07 in chips) 
Seat 5: pipinoelbreve9 (€2 in chips) 
Seat 6: zemas123123 (€2.58 in chips) 
mekinho#1: posts small blind €0.01
PetroniloPT: posts big blind €0.02
*** HOLE CARDS ***
Dealt to pipinoelbreve9 [Qc 9s]
masquisiera: raises €0.04 to €0.06
pipinoelbreve9: folds 
zemas123123: folds 
UndertheGun7799 is disconnected 
UndertheGun7799 has timed out while disconnected
UndertheGun7799: folds 
mekinho#1: folds 
PetroniloPT: folds 
Uncalled bet (€0.04) returned to masquisiera
masquisiera collected €0.05 from pot
masquisiera: doesn't show hand 
*** SUMMARY ***
Total pot €0.05 | Rake €0 
Seat 1: UndertheGun7799 (button) folded before Flop (didn't bet)
Seat 2: mekinho#1 (small blind) folded before Flop
Seat 3: PetroniloPT (big blind) folded before Flop
Seat 4: masquisiera collected (€0.05)
Seat 5: pipinoelbreve9 folded before Flop (didn't bet)
Seat 6: zemas123123 folded before Flop (didn't bet)



PokerStars Zoom Hand #257561295683:  Hold'em No Limit (€0.01/€0.02) - 2025/08/31 21:06:12 CET [2025/08/31 15:06:12 ET]
Table 'Arneb' 6-max Seat #1 is the button
Seat 1: Tymoko (€6.66 in chips) 
Seat 2: PolCuenca (€3 in chips) 
Seat 3: TJDasNeves (€2 in chips) 
Seat 4: pipinoelbreve9 (€2 in chips) 
Seat 5: SrLyrox (€2.06 in chips) 
Seat 6: mekinho#1 (€0.51 in chips) 
PolCuenca: posts small blind €0.01
TJDasNeves: posts big blind €0.02
*** HOLE CARDS ***
Dealt to pipinoelbreve9 [Ac Th]
pipinoelbreve9: raises €0.04 to €0.06
SrLyrox: folds 
mekinho#1: folds 
Tymoko: folds 
PolCuenca: folds 
TJDasNeves: folds 
Uncalled bet (€0.04) returned to pipinoelbreve9
pipinoelbreve9 collected €0.05 from pot
pipinoelbreve9: doesn't show hand 
*** SUMMARY ***
Total pot €0.05 | Rake €0 
Seat 1: Tymoko (button) folded before Flop (didn't bet)
Seat 2: PolCuenca (small blind) folded before Flop
Seat 3: TJDasNeves (big blind) folded before Flop
Seat 4: pipinoelbreve9 collected (€0.05)
Seat 5: SrLyrox folded before Flop (didn't bet)
Seat 6: mekinho#1 folded before Flop (didn't bet)



PokerStars Zoom Hand #257561294085:  Hold'em No Limit (€0.01/€0.02) - 2025/08/31 21:06:07 CET [2025/08/31 15:06:07 ET]
Table 'Arneb' 6-max Seat #1 is the button
Seat 1: PetroniloPT (€0.85 in chips) 
Seat 2: diabloduende (€1.44 in chips) 
Seat 3: TJDasNeves (€2.04 in chips) 
Seat 4: Phenon33 (€1.57 in chips) 
Seat 5: pipinoelbreve9 (€2 in chips) 
Seat 6: PolCuenca (€1.91 in chips) 
diabloduende: posts small blind €0.01
TJDasNeves: posts big blind €0.02
*** HOLE CARDS ***
Dealt to pipinoelbreve9 [4d Jh]
Phenon33: calls €0.02
pipinoelbreve9: folds 
PolCuenca: folds 
PetroniloPT: folds 
diabloduende: folds 
TJDasNeves: checks 
*** FLOP *** [8d Ts Tc]
TJDasNeves: checks 
Phenon33: checks 
*** TURN *** [8d Ts Tc] [3d]
TJDasNeves: checks 
Phenon33: checks 
*** RIVER *** [8d Ts Tc 3d] [8s]
TJDasNeves: checks 
Phenon33: checks 
*** SHOW DOWN ***
TJDasNeves: shows [2s 4h] (two pair, Tens and Eights)
Phenon33: shows [Qc Ks] (two pair, Tens and Eights - King kicker)
Phenon33 collected €0.05 from pot
*** SUMMARY ***
Total pot €0.05 | Rake €0 
Board [8d Ts Tc 3d 8s]
Seat 1: PetroniloPT (button) folded before Flop (didn't bet)
Seat 2: diabloduende (small blind) folded before Flop
Seat 3: TJDasNeves (big blind) showed [2s 4h] and lost with two pair, Tens and Eights
Seat 4: Phenon33 showed [Qc Ks] and won (€0.05) with two pair, Tens and Eights
Seat 5: pipinoelbreve9 folded before Flop (didn't bet)
Seat 6: PolCuenca folded before Flop (didn't bet)



PokerStars Zoom Hand #257561300316:  Hold'em No Limit (€0.01/€0.02) - 2025/08/31 21:06:28 CET [2025/08/31 15:06:28 ET]
Table 'Arneb' 6-max Seat #1 is the button
Seat 1: SrLyrox (€3.49 in chips) 
Seat 2: pipinoelbreve9 (€2.03 in chips) 
Seat 3: TJDasNeves (€2.82 in chips) 
Seat 4: diabloduende (€1.42 in chips) 
Seat 5: 350ZJHN (€2 in chips) 
Seat 6: Apdwins (€3.21 in chips) 
pipinoelbreve9: posts small blind €0.01
TJDasNeves: posts big blind €0.02
*** HOLE CARDS ***
Dealt to pipinoelbreve9 [Th 6h]
diabloduende: folds 
350ZJHN: raises €0.04 to €0.06
Apdwins: folds 
SrLyrox: folds 
pipinoelbreve9: folds 
TJDasNeves: folds 
Uncalled bet (€0.04) returned to 350ZJHN
350ZJHN collected €0.05 from pot
350ZJHN: doesn't show hand 
*** SUMMARY ***
Total pot €0.05 | Rake €0 
Seat 1: SrLyrox (button) folded before Flop (didn't bet)
Seat 2: pipinoelbreve9 (small blind) folded before Flop
Seat 3: TJDasNeves (big blind) folded before Flop
Seat 4: diabloduende folded before Flop (didn't bet)
Seat 5: 350ZJHN collected (€0.05)
Seat 6: Apdwins folded before Flop (didn't bet)



PokerStars Zoom Hand #257561305000:  Hold'em No Limit (€0.01/€0.02) - 2025/08/31 21:06:43 CET [2025/08/31 15:06:43 ET]
Table 'Arneb' 6-max Seat #1 is the button
Seat 1: TJDasNeves (€2.01 in chips) 
Seat 2: Lumifer (€2.13 in chips) 
Seat 3: pipinoelbreve9 (€2.02 in chips) 
Seat 4: U k'ray.pt (€1.57 in chips) 
Seat 5: mekinho#1 (€0.78 in chips) 
Seat 6: PolCuenca (€1.42 in chips) 
Lumifer: posts small blind €0.01
pipinoelbreve9: posts big blind €0.02
*** HOLE CARDS ***
Dealt to pipinoelbreve9 [Ac 9s]
U k'ray.pt: folds 
mekinho#1: folds 
PolCuenca: folds 
TJDasNeves: folds 
Lumifer: folds 
Uncalled bet (€0.01) returned to pipinoelbreve9
pipinoelbreve9 collected €0.02 from pot
pipinoelbreve9: doesn't show hand 
*** SUMMARY ***
Total pot €0.02 | Rake €0 
Seat 1: TJDasNeves (button) folded before Flop (didn't bet)
Seat 2: Lumifer (small blind) folded before Flop
Seat 3: pipinoelbreve9 (big blind) collected (€0.02)
Seat 4: U k'ray.pt folded before Flop (didn't bet)
Seat 5: mekinho#1 folded before Flop (didn't bet)
Seat 6: PolCuenca folded before Flop (didn't bet)



PokerStars Zoom Hand #257561308164:  Hold'em No Limit (€0.01/€0.02) - 2025/08/31 21:06:54 CET [2025/08/31 15:06:54 ET]
Table 'Arneb' 6-max Seat #1 is the button
Seat 1: zemas123123 (€2.57 in chips) 
Seat 2: Cruasan17 (€2.91 in chips) 
Seat 3: Marguinha04 (€0.85 in chips) 
Seat 4: pipinoelbreve9 (€2.03 in chips) 
Seat 5: Lumifer (€2.12 in chips) 
Seat 6: U k'ray.pt (€1.57 in chips) 
Cruasan17: posts small blind €0.01
Marguinha04: posts big blind €0.02
*** HOLE CARDS ***
Dealt to pipinoelbreve9 [3h 7c]
pipinoelbreve9: folds 
Lumifer: folds 
U k'ray.pt: calls €0.02
zemas123123: folds 
Cruasan17: folds 
Marguinha04: checks 
*** FLOP *** [8c Js 5s]
Marguinha04: checks 
U k'ray.pt: checks 
*** TURN *** [8c Js 5s] [Qd]
Marguinha04: bets €0.02
U k'ray.pt: calls €0.02
*** RIVER *** [8c Js 5s Qd] [2d]
Marguinha04: bets €0.06
U k'ray.pt: raises €0.06 to €0.12
Marguinha04: calls €0.06
*** SHOW DOWN ***
U k'ray.pt: shows [Kd Kh] (a pair of Kings)
Marguinha04: mucks hand 
U k'ray.pt collected €0.31 from pot
*** SUMMARY ***
Total pot €0.33 | Rake €0.02 
Board [8c Js 5s Qd 2d]
Seat 1: zemas123123 (button) folded before Flop (didn't bet)
Seat 2: Cruasan17 (small blind) folded before Flop
Seat 3: Marguinha04 (big blind) mucked [Jc 9s]
Seat 4: pipinoelbreve9 folded before Flop (didn't bet)
Seat 5: Lumifer folded before Flop (didn't bet)
Seat 6: U k'ray.pt showed [Kd Kh] and won (€0.31) with a pair of Kings



PokerStars Zoom Hand #257561309679:  Hold'em No Limit (€0.01/€0.02) - 2025/08/31 21:06:59 CET [2025/08/31 15:06:59 ET]
Table 'Arneb' 6-max Seat #1 is the button
Seat 1: Elons_Mucks (€2 in chips) 
Seat 2: TJDasNeves (€2.80 in chips) 
Seat 3: mekinho#1 (€0.50 in chips) 
Seat 4: l2orestes (€2 in chips) 
Seat 5: TEVMONIV (€1.80 in chips) 
Seat 6: pipinoelbreve9 (€2.03 in chips) 
TJDasNeves: posts small blind €0.01
mekinho#1: posts big blind €0.02
*** HOLE CARDS ***
Dealt to pipinoelbreve9 [Th Jd]
l2orestes: folds 
TEVMONIV: folds 
pipinoelbreve9: raises €0.04 to €0.06
Elons_Mucks: raises €0.12 to €0.18
TJDasNeves: folds 
mekinho#1: folds 
pipinoelbreve9: folds 
Uncalled bet (€0.12) returned to Elons_Mucks
Elons_Mucks collected €0.15 from pot
Elons_Mucks: doesn't show hand 
*** SUMMARY ***
Total pot €0.15 | Rake €0 
Seat 1: Elons_Mucks (button) collected (€0.15)
Seat 2: TJDasNeves (small blind) folded before Flop
Seat 3: mekinho#1 (big blind) folded before Flop
Seat 4: l2orestes folded before Flop (didn't bet)
Seat 5: TEVMONIV folded before Flop (didn't bet)
Seat 6: pipinoelbreve9 folded before Flop



PokerStars Zoom Hand #257561319404:  Hold'em No Limit (€0.01/€0.02) - 2025/08/31 21:07:32 CET [2025/08/31 15:07:32 ET]
Table 'Arneb' 6-max Seat #1 is the button
Seat 1: pipinoelbreve9 (€2 in chips) 
Seat 2: mekinho#1 (€0.80 in chips) 
Seat 3: TJDasNeves (€2 in chips) 
Seat 4: CHISPITA9 (€2.33 in chips) 
Seat 5: PolCuenca (€2.94 in chips) 
Seat 6: WookySixx (€3.82 in chips) 
mekinho#1: posts small blind €0.01
TJDasNeves: posts big blind €0.02
*** HOLE CARDS ***
Dealt to pipinoelbreve9 [Ac 5c]
CHISPITA9: calls €0.02
PolCuenca: raises €0.03 to €0.05
WookySixx: folds 
pipinoelbreve9: raises €0.25 to €0.30
mekinho#1: folds 
TJDasNeves: folds 
CHISPITA9: folds 
PolCuenca: folds 
Uncalled bet (€0.25) returned to pipinoelbreve9
pipinoelbreve9 collected €0.15 from pot
pipinoelbreve9: doesn't show hand 
*** SUMMARY ***
Total pot €0.15 | Rake €0 
Seat 1: pipinoelbreve9 (button) collected (€0.15)
Seat 2: mekinho#1 (small blind) folded before Flop
Seat 3: TJDasNeves (big blind) folded before Flop
Seat 4: CHISPITA9 folded before Flop
Seat 5: PolCuenca folded before Flop
Seat 6: WookySixx folded before Flop (didn't bet)



PokerStars Zoom Hand #257561329188:  Hold'em No Limit (€0.01/€0.02) - 2025/08/31 21:08:05 CET [2025/08/31 15:08:05 ET]
Table 'Arneb' 6-max Seat #1 is the button
Seat 1: mekinho#1 (€0.45 in chips) 
Seat 2: koka1151 (€2.75 in chips) 
Seat 3: Tymoko (€7.78 in chips) 
Seat 4: verdugo2275 (€2.15 in chips) 
Seat 5: pipinoelbreve9 (€2.10 in chips) 
Seat 6: U k'ray.pt (€1.67 in chips) 
koka1151: posts small blind €0.01
Tymoko: posts big blind €0.02
*** HOLE CARDS ***
Dealt to pipinoelbreve9 [4c 9s]
verdugo2275: folds 
pipinoelbreve9: folds 
U k'ray.pt: raises €0.02 to €0.04
mekinho#1 has timed out
mekinho#1: folds 
koka1151: raises €0.06 to €0.10
Tymoko: folds 
U k'ray.pt: calls €0.06
*** FLOP *** [7d 5d Kd]
koka1151: bets €0.16
U k'ray.pt: calls €0.16
*** TURN *** [7d 5d Kd] [Qd]
koka1151: checks 
U k'ray.pt: bets €0.26
koka1151: folds 
Uncalled bet (€0.26) returned to U k'ray.pt
U k'ray.pt collected €0.51 from pot
U k'ray.pt: doesn't show hand 
*** SUMMARY ***
Total pot €0.54 | Rake €0.03 
Board [7d 5d Kd Qd]
Seat 1: mekinho#1 (button) folded before Flop (didn't bet)
Seat 2: koka1151 (small blind) folded on the Turn
Seat 3: Tymoko (big blind) folded before Flop
Seat 4: verdugo2275 folded before Flop (didn't bet)
Seat 5: pipinoelbreve9 folded before Flop (didn't bet)
Seat 6: U k'ray.pt collected (€0.51)



PokerStars Zoom Hand #257561331381:  Hold'em No Limit (€0.01/€0.02) - 2025/08/31 21:08:13 CET [2025/08/31 15:08:13 ET]
Table 'Arneb' 6-max Seat #1 is the button
Seat 1: kastor59 (€2.03 in chips) 
Seat 2: Tymoko (€7.76 in chips) 
Seat 3: 350ZJHN (€2 in chips) 
Seat 4: pipinoelbreve9 (€2.10 in chips) 
Seat 5: TJDasNeves (€2.77 in chips) 
Seat 6: TEVMONIV (€1.80 in chips) 
Tymoko: posts small blind €0.01
350ZJHN: posts big blind €0.02
*** HOLE CARDS ***
Dealt to pipinoelbreve9 [Td Ts]
pipinoelbreve9: raises €0.04 to €0.06
TJDasNeves: folds 
TEVMONIV: folds 
kastor59: raises €0.15 to €0.21
Tymoko: folds 
350ZJHN: folds 
pipinoelbreve9: calls €0.15
*** FLOP *** [Jh Ks 3d]
pipinoelbreve9: checks 
kastor59: checks 
*** TURN *** [Jh Ks 3d] [Ad]
pipinoelbreve9: bets €0.22
kastor59: calls €0.22
*** RIVER *** [Jh Ks 3d Ad] [6s]
pipinoelbreve9: checks 
kastor59: bets €1.19
pipinoelbreve9: folds 
Uncalled bet (€1.19) returned to kastor59
kastor59 collected €0.85 from pot
kastor59: doesn't show hand 
*** SUMMARY ***
Total pot €0.89 | Rake €0.04 
Board [Jh Ks 3d Ad 6s]
Seat 1: kastor59 (button) collected (€0.85)
Seat 2: Tymoko (small blind) folded before Flop
Seat 3: 350ZJHN (big blind) folded before Flop
Seat 4: pipinoelbreve9 folded on the River
Seat 5: TJDasNeves folded before Flop (didn't bet)
Seat 6: TEVMONIV folded before Flop (didn't bet)



PokerStars Zoom Hand #257561346423:  Hold'em No Limit (€0.01/€0.02) - 2025/08/31 21:09:03 CET [2025/08/31 15:09:03 ET]
Table 'Arneb' 6-max Seat #1 is the button
Seat 1: charlyleon92 (€1.92 in chips) 
Seat 2: pipinoelbreve9 (€2 in chips) 
Seat 3: l2orestes (€2.92 in chips) 
Seat 4: TJDasNeves (€2.03 in chips) 
Seat 5: koka1151 (€3.44 in chips) 
Seat 6: kastor59 (€2.45 in chips) 
pipinoelbreve9: posts small blind €0.01
l2orestes: posts big blind €0.02
*** HOLE CARDS ***
Dealt to pipinoelbreve9 [8d Jd]
TJDasNeves: raises €0.03 to €0.05
koka1151: calls €0.05
kastor59: folds 
charlyleon92: folds 
pipinoelbreve9: calls €0.04
l2orestes: folds 
*** FLOP *** [6h 9h Th]
pipinoelbreve9: checks 
TJDasNeves: checks 
koka1151 is disconnected 
koka1151: checks 
*** TURN *** [6h 9h Th] [4c]
pipinoelbreve9: checks 
TJDasNeves: checks 
koka1151: checks 
*** RIVER *** [6h 9h Th 4c] [Kc]
pipinoelbreve9: checks 
TJDasNeves: checks 
koka1151: checks 
*** SHOW DOWN ***
pipinoelbreve9: shows [8d Jd] (high card King)
TJDasNeves: shows [As Qd] (high card Ace)
koka1151: shows [7h 7d] (a pair of Sevens)
koka1151 collected €0.16 from pot
*** SUMMARY ***
Total pot €0.17 | Rake €0.01 
Board [6h 9h Th 4c Kc]
Seat 1: charlyleon92 (button) folded before Flop (didn't bet)
Seat 2: pipinoelbreve9 (small blind) showed [8d Jd] and lost with high card King
Seat 3: l2orestes (big blind) folded before Flop
Seat 4: TJDasNeves showed [As Qd] and lost with high card Ace
Seat 5: koka1151 showed [7h 7d] and won (€0.16) with a pair of Sevens
Seat 6: kastor59 folded before Flop (didn't bet)



PokerStars Zoom Hand #257561368342:  Hold'em No Limit (€0.01/€0.02) - 2025/08/31 21:10:16 CET [2025/08/31 15:10:16 ET]
Table 'Arneb' 6-max Seat #1 is the button
Seat 1: PolCuenca (€2.87 in chips) 
Seat 2: HGrenha (€6.88 in chips) 
Seat 3: calou100 (€1.62 in chips) 
Seat 4: pipinoelbreve9 (€2 in chips) 
Seat 5: TJDasNeves (€2.07 in chips) 
Seat 6: 350ZJHN (€2.02 in chips) 
HGrenha: posts small blind €0.01
calou100: posts big blind €0.02
*** HOLE CARDS ***
Dealt to pipinoelbreve9 [7s Jc]
pipinoelbreve9: folds 
TJDasNeves: folds 
350ZJHN: folds 
PolCuenca: raises €0.02 to €0.04
HGrenha: folds 
calou100: calls €0.02
*** FLOP *** [5c 4d 2h]
calou100: checks 
PolCuenca: bets €0.05
calou100: calls €0.05
*** TURN *** [5c 4d 2h] [8c]
calou100: checks 
PolCuenca: bets €0.12
calou100: folds 
Uncalled bet (€0.12) returned to PolCuenca
PolCuenca collected €0.18 from pot
PolCuenca: doesn't show hand 
*** SUMMARY ***
Total pot €0.19 | Rake €0.01 
Board [5c 4d 2h 8c]
Seat 1: PolCuenca (button) collected (€0.18)
Seat 2: HGrenha (small blind) folded before Flop
Seat 3: calou100 (big blind) folded on the Turn
Seat 4: pipinoelbreve9 folded before Flop (didn't bet)
Seat 5: TJDasNeves folded before Flop (didn't bet)
Seat 6: 350ZJHN folded before Flop (didn't bet)



PokerStars Zoom Hand #257561369873:  Hold'em No Limit (€0.01/€0.02) - 2025/08/31 21:10:21 CET [2025/08/31 15:10:21 ET]
Table 'Arneb' 6-max Seat #1 is the button
Seat 1: Maori_083 (€0.63 in chips) 
Seat 2: mekinho#1 (€0.74 in chips) 
Seat 3: pipinoelbreve9 (€2 in chips) 
Seat 4: joaninha124 (€0.82 in chips) 
Seat 5: 350ZJHN (€2.02 in chips) 
Seat 6: zemas123123 (€0.88 in chips) 
mekinho#1: posts small blind €0.01
pipinoelbreve9: posts big blind €0.02
*** HOLE CARDS ***
Dealt to pipinoelbreve9 [9s Js]
joaninha124: folds 
350ZJHN: folds 
zemas123123: raises €0.02 to €0.04
Maori_083: calls €0.04
mekinho#1: folds 
pipinoelbreve9: calls €0.02
*** FLOP *** [Ac Qc Qs]
pipinoelbreve9: checks 
zemas123123: bets €0.06
Maori_083: calls €0.06
pipinoelbreve9: calls €0.06
*** TURN *** [Ac Qc Qs] [6d]
pipinoelbreve9: checks 
zemas123123: bets €0.78 and is all-in
Maori_083: folds 
pipinoelbreve9: folds 
Uncalled bet (€0.78) returned to zemas123123
zemas123123 collected €0.29 from pot
zemas123123: doesn't show hand 
*** SUMMARY ***
Total pot €0.31 | Rake €0.02 
Board [Ac Qc Qs 6d]
Seat 1: Maori_083 (button) folded on the Turn
Seat 2: mekinho#1 (small blind) folded before Flop
Seat 3: pipinoelbreve9 (big blind) folded on the Turn
Seat 4: joaninha124 folded before Flop (didn't bet)
Seat 5: 350ZJHN folded before Flop (didn't bet)
Seat 6: zemas123123 collected (€0.29)



PokerStars Zoom Hand #257561387221:  Hold'em No Limit (€0.01/€0.02) - 2025/08/31 21:11:20 CET [2025/08/31 15:11:20 ET]
Table 'Arneb' 6-max Seat #1 is the button
Seat 1: pipinoelbreve9 (€2 in chips) 
Seat 2: verdugo2275 (€2.01 in chips) 
Seat 3: Lumifer (€2 in chips) 
Seat 4: WookySixx (€1.76 in chips) 
Seat 5: OMaisPesado1 (€2 in chips) 
Seat 6: TJDasNeves (€4.44 in chips) 
verdugo2275: posts small blind €0.01
Lumifer: posts big blind €0.02
*** HOLE CARDS ***
Dealt to pipinoelbreve9 [8d 2s]
WookySixx is disconnected 
WookySixx has timed out while disconnected
WookySixx: folds 
OMaisPesado1: folds 
TJDasNeves: folds 
pipinoelbreve9: folds 
verdugo2275: folds 
Uncalled bet (€0.01) returned to Lumifer
Lumifer collected €0.02 from pot
Lumifer: doesn't show hand 
*** SUMMARY ***
Total pot €0.02 | Rake €0 
Seat 1: pipinoelbreve9 (button) folded before Flop (didn't bet)
Seat 2: verdugo2275 (small blind) folded before Flop
Seat 3: Lumifer (big blind) collected (€0.02)
Seat 4: WookySixx folded before Flop (didn't bet)
Seat 5: OMaisPesado1 folded before Flop (didn't bet)
Seat 6: TJDasNeves folded before Flop (didn't bet)



PokerStars Zoom Hand #257561395080:  Hold'em No Limit (€0.01/€0.02) - 2025/08/31 21:11:46 CET [2025/08/31 15:11:46 ET]
Table 'Arneb' 6-max Seat #1 is the button
Seat 1: cris1966564 (€0.78 in chips) 
Seat 2: pipinoelbreve9 (€2 in chips) 
Seat 3: zemas123123 (€1.07 in chips) 
Seat 4: TEVMONIV (€4.50 in chips) 
Seat 5: Lumifer (€2.21 in chips) 
Seat 6: mekinho#1 (€0.38 in chips) 
pipinoelbreve9: posts small blind €0.01
zemas123123: posts big blind €0.02
*** HOLE CARDS ***
Dealt to pipinoelbreve9 [6c Jh]
TEVMONIV: raises €0.02 to €0.04
Lumifer: folds 
mekinho#1: folds 
cris1966564: calls €0.04
pipinoelbreve9: folds 
zemas123123: raises €0.02 to €0.06
TEVMONIV: calls €0.02
cris1966564: calls €0.02
*** FLOP *** [6h 7c Tc]
zemas123123: checks 
TEVMONIV: bets €0.05
cris1966564: calls €0.05
zemas123123: raises €0.09 to €0.14
TEVMONIV: calls €0.09
cris1966564: folds 
*** TURN *** [6h 7c Tc] [Qs]
zemas123123: bets €0.10
TEVMONIV: calls €0.10
*** RIVER *** [6h 7c Tc Qs] [Kh]
zemas123123: bets €0.20
TEVMONIV: raises €0.81 to €1.01
zemas123123: calls €0.57 and is all-in
Uncalled bet (€0.24) returned to TEVMONIV
*** SHOW DOWN ***
TEVMONIV: shows [Ts Kd] (two pair, Kings and Tens)
zemas123123: shows [Ah Ac] (a pair of Aces)
TEVMONIV collected €2.15 from pot
*** SUMMARY ***
Total pot €2.26 | Rake €0.11 
Board [6h 7c Tc Qs Kh]
Seat 1: cris1966564 (button) folded on the Flop
Seat 2: pipinoelbreve9 (small blind) folded before Flop
Seat 3: zemas123123 (big blind) showed [Ah Ac] and lost with a pair of Aces
Seat 4: TEVMONIV showed [Ts Kd] and won (€2.15) with two pair, Kings and Tens
Seat 5: Lumifer folded before Flop (didn't bet)
Seat 6: mekinho#1 folded before Flop (didn't bet)



PokerStars Zoom Hand #257561391141:  Hold'em No Limit (€0.01/€0.02) - 2025/08/31 21:11:33 CET [2025/08/31 15:11:33 ET]
Table 'Arneb' 6-max Seat #1 is the button
Seat 1: charlyleon92 (€2.22 in chips) 
Seat 2: joaninha124 (€0.78 in chips) 
Seat 3: Elons_Mucks (€2 in chips) 
Seat 4: Lobedaureille (€2.37 in chips) 
Seat 5: mekinho#1 (€0.39 in chips) 
Seat 6: pipinoelbreve9 (€2 in chips) 
joaninha124: posts small blind €0.01
Elons_Mucks: posts big blind €0.02
*** HOLE CARDS ***
Dealt to pipinoelbreve9 [2d Js]
Lobedaureille: folds 
mekinho#1: folds 
pipinoelbreve9: folds 
charlyleon92: raises €0.04 to €0.06
joaninha124: folds 
Elons_Mucks: raises €0.18 to €0.24
charlyleon92: calls €0.18
*** FLOP *** [9c 7d Kc]
Elons_Mucks: bets €0.16
charlyleon92: calls €0.16
*** TURN *** [9c 7d Kc] [2s]
Elons_Mucks: bets €0.54
charlyleon92: calls €0.54
*** RIVER *** [9c 7d Kc 2s] [3d]
Elons_Mucks: bets €1.06 and is all-in
charlyleon92: calls €1.06
*** SHOW DOWN ***
Elons_Mucks: shows [Ac Ks] (a pair of Kings)
charlyleon92: shows [Kh Qs] (a pair of Kings - lower kicker)
Elons_Mucks collected €3.81 from pot
*** SUMMARY ***
Total pot €4.01 | Rake €0.20 
Board [9c 7d Kc 2s 3d]
Seat 1: charlyleon92 (button) showed [Kh Qs] and lost with a pair of Kings
Seat 2: joaninha124 (small blind) folded before Flop
Seat 3: Elons_Mucks (big blind) showed [Ac Ks] and won (€3.81) with a pair of Kings
Seat 4: Lobedaureille folded before Flop (didn't bet)
Seat 5: mekinho#1 folded before Flop (didn't bet)
Seat 6: pipinoelbreve9 folded before Flop (didn't bet)



PokerStars Zoom Hand #257561396586:  Hold'em No Limit (€0.01/€0.02) - 2025/08/31 21:11:51 CET [2025/08/31 15:11:51 ET]
Table 'Arneb' 6-max Seat #1 is the button
Seat 1: KillVerlaine (€1.68 in chips) 
Seat 2: verdugo2275 (€2.42 in chips) 
Seat 3: geovannyhanna (€2.08 in chips) 
Seat 4: DidieliPoker (€1.20 in chips) 
Seat 5: pipinoelbreve9 (€2 in chips) 
Seat 6: flamencolega (€2.99 in chips) 
verdugo2275: posts small blind €0.01
geovannyhanna: posts big blind €0.02
*** HOLE CARDS ***
Dealt to pipinoelbreve9 [Td Qs]
DidieliPoker: folds 
pipinoelbreve9: raises €0.04 to €0.06
flamencolega: folds 
KillVerlaine: calls €0.06
verdugo2275: folds 
geovannyhanna: folds 
*** FLOP *** [2c 8s 2s]
pipinoelbreve9: checks 
KillVerlaine: checks 
*** TURN *** [2c 8s 2s] [6d]
pipinoelbreve9: checks 
KillVerlaine: bets €0.09
pipinoelbreve9: folds 
Uncalled bet (€0.09) returned to KillVerlaine
KillVerlaine collected €0.14 from pot
KillVerlaine: doesn't show hand 
*** SUMMARY ***
Total pot €0.15 | Rake €0.01 
Board [2c 8s 2s 6d]
Seat 1: KillVerlaine (button) collected (€0.14)
Seat 2: verdugo2275 (small blind) folded before Flop
Seat 3: geovannyhanna (big blind) folded before Flop
Seat 4: DidieliPoker folded before Flop (didn't bet)
Seat 5: pipinoelbreve9 folded on the Turn
Seat 6: flamencolega folded before Flop (didn't bet)



PokerStars Zoom Hand #257562399552:  Hold'em No Limit (€0.01/€0.02) - 2025/08/31 22:10:41 CET [2025/08/31 16:10:41 ET]
Table 'Arneb' 6-max Seat #1 is the button
Seat 1: Izibeaxh (€9.03 in chips) 
Seat 2: marcdevil (€2.38 in chips) 
Seat 3: pipinoelbreve9 (€2 in chips) 
Seat 4: ocsur (€1.69 in chips) 
Seat 5: Lucian Morel (€0.97 in chips) 
Seat 6: Lumifer (€2.02 in chips) 
marcdevil: posts small blind €0.01
pipinoelbreve9: posts big blind €0.02
*** HOLE CARDS ***
Dealt to pipinoelbreve9 [Js 4h]
ocsur: folds 
Lucian Morel: folds 
Lumifer: folds 
Izibeaxh: raises €0.03 to €0.05
marcdevil: folds 
pipinoelbreve9: folds 
Uncalled bet (€0.03) returned to Izibeaxh
Izibeaxh collected €0.05 from pot
Izibeaxh: doesn't show hand 
*** SUMMARY ***
Total pot €0.05 | Rake €0 
Seat 1: Izibeaxh (button) collected (€0.05)
Seat 2: marcdevil (small blind) folded before Flop
Seat 3: pipinoelbreve9 (big blind) folded before Flop
Seat 4: ocsur folded before Flop (didn't bet)
Seat 5: Lucian Morel folded before Flop (didn't bet)
Seat 6: Lumifer folded before Flop (didn't bet)



PokerStars Zoom Hand #257562403461:  Hold'em No Limit (€0.01/€0.02) - 2025/08/31 22:10:53 CET [2025/08/31 16:10:53 ET]
Table 'Arneb' 6-max Seat #1 is the button
Seat 1: Fr@nkys (€2 in chips) 
Seat 2: pipinoelbreve9 (€2 in chips) 
Seat 3: CASCALE$ (€1.44 in chips) 
Seat 4: MiguelMJ96 (€0.97 in chips) 
Seat 5: javiguardiol (€2.19 in chips) 
Seat 6: aufildelo (€1.04 in chips) 
pipinoelbreve9: posts small blind €0.01
CASCALE$: posts big blind €0.02
*** HOLE CARDS ***
Dealt to pipinoelbreve9 [Kc Ac]
MiguelMJ96: folds 
javiguardiol: folds 
aufildelo: raises €0.04 to €0.06
Fr@nkys: folds 
pipinoelbreve9: raises €0.12 to €0.18
CASCALE$: folds 
aufildelo: raises €0.86 to €1.04 and is all-in
pipinoelbreve9: calls €0.86
*** FLOP *** [Tc Ks 7d]
*** TURN *** [Tc Ks 7d] [Jc]
*** RIVER *** [Tc Ks 7d Jc] [3h]
*** SHOW DOWN ***
pipinoelbreve9: shows [Kc Ac] (a pair of Kings)
aufildelo: shows [Td Qs] (a pair of Tens)
pipinoelbreve9 collected €2 from pot
*** SUMMARY ***
Total pot €2.10 | Rake €0.10 
Board [Tc Ks 7d Jc 3h]
Seat 1: Fr@nkys (button) folded before Flop (didn't bet)
Seat 2: pipinoelbreve9 (small blind) showed [Kc Ac] and won (€2) with a pair of Kings
Seat 3: CASCALE$ (big blind) folded before Flop
Seat 4: MiguelMJ96 folded before Flop (didn't bet)
Seat 5: javiguardiol folded before Flop (didn't bet)
Seat 6: aufildelo showed [Td Qs] and lost with a pair of Tens



PokerStars Zoom Hand #257562422792:  Hold'em No Limit (€0.01/€0.02) - 2025/08/31 22:11:55 CET [2025/08/31 16:11:55 ET]
Table 'Arneb' 6-max Seat #1 is the button
Seat 1: pipinoelbreve9 (€2.96 in chips) 
Seat 2: wilbor123 (€2.82 in chips) 
Seat 3: sambupkr (€2 in chips) 
Seat 4: Eucalypter (€1.94 in chips) 
Seat 5: Ujfalusi87 (€2 in chips) 
Seat 6: CASCALE$ (€1.42 in chips) 
wilbor123: posts small blind €0.01
sambupkr: posts big blind €0.02
*** HOLE CARDS ***
Dealt to pipinoelbreve9 [6h 2c]
Eucalypter: folds 
Ujfalusi87: folds 
CASCALE$: folds 
pipinoelbreve9: folds 
wilbor123: raises €0.04 to €0.06
sambupkr: folds 
Uncalled bet (€0.04) returned to wilbor123
wilbor123 collected €0.04 from pot
wilbor123: doesn't show hand 
*** SUMMARY ***
Total pot €0.04 | Rake €0 
Seat 1: pipinoelbreve9 (button) folded before Flop (didn't bet)
Seat 2: wilbor123 (small blind) collected (€0.04)
Seat 3: sambupkr (big blind) folded before Flop
Seat 4: Eucalypter folded before Flop (didn't bet)
Seat 5: Ujfalusi87 folded before Flop (didn't bet)
Seat 6: CASCALE$ folded before Flop (didn't bet)



PokerStars Zoom Hand #257562425611:  Hold'em No Limit (€0.01/€0.02) - 2025/08/31 22:12:04 CET [2025/08/31 16:12:04 ET]
Table 'Arneb' 6-max Seat #1 is the button
Seat 1: Izibeaxh (€9.04 in chips) 
Seat 2: Chichoampuero12 (€3.52 in chips) 
Seat 3: felgas1968 (€2.42 in chips) 
Seat 4: Ujfalusi87 (€2.12 in chips) 
Seat 5: pipinoelbreve9 (€2.96 in chips) 
Seat 6: POÇAOMAGICA (€2 in chips) 
Chichoampuero12: posts small blind €0.01
felgas1968: posts big blind €0.02
*** HOLE CARDS ***
Dealt to pipinoelbreve9 [Qs 8c]
Ujfalusi87: folds 
pipinoelbreve9: folds 
POÇAOMAGICA: folds 
Izibeaxh: folds 
Chichoampuero12: folds 
Uncalled bet (€0.01) returned to felgas1968
felgas1968 collected €0.02 from pot
felgas1968: doesn't show hand 
*** SUMMARY ***
Total pot €0.02 | Rake €0 
Seat 1: Izibeaxh (button) folded before Flop (didn't bet)
Seat 2: Chichoampuero12 (small blind) folded before Flop
Seat 3: felgas1968 (big blind) collected (€0.02)
Seat 4: Ujfalusi87 folded before Flop (didn't bet)
Seat 5: pipinoelbreve9 folded before Flop (didn't bet)
Seat 6: POÇAOMAGICA folded before Flop (didn't bet)



PokerStars Zoom Hand #257562429052:  Hold'em No Limit (€0.01/€0.02) - 2025/08/31 22:12:15 CET [2025/08/31 16:12:15 ET]
Table 'Arneb' 6-max Seat #1 is the button
Seat 1: marcdevil (€2.73 in chips) 
Seat 2: nyko2a (€3.05 in chips) 
Seat 3: TJDasNeves (€5.30 in chips) 
Seat 4: Fr@nkys (€2 in chips) 
Seat 5: KillVerlaine (€3.06 in chips) 
Seat 6: pipinoelbreve9 (€2.96 in chips) 
nyko2a: posts small blind €0.01
TJDasNeves: posts big blind €0.02
*** HOLE CARDS ***
Dealt to pipinoelbreve9 [7c Jd]
Fr@nkys: folds 
KillVerlaine: folds 
pipinoelbreve9: folds 
marcdevil: folds 
nyko2a: raises €0.04 to €0.06
TJDasNeves: folds 
Uncalled bet (€0.04) returned to nyko2a
nyko2a collected €0.04 from pot
nyko2a: doesn't show hand 
*** SUMMARY ***
Total pot €0.04 | Rake €0 
Seat 1: marcdevil (button) folded before Flop (didn't bet)
Seat 2: nyko2a (small blind) collected (€0.04)
Seat 3: TJDasNeves (big blind) folded before Flop
Seat 4: Fr@nkys folded before Flop (didn't bet)
Seat 5: KillVerlaine folded before Flop (didn't bet)
Seat 6: pipinoelbreve9 folded before Flop (didn't bet)



PokerStars Zoom Hand #257562432919:  Hold'em No Limit (€0.01/€0.02) - 2025/08/31 22:12:27 CET [2025/08/31 16:12:27 ET]
Table 'Arneb' 6-max Seat #1 is the button
Seat 1: sambupkr (€2.47 in chips) 
Seat 2: Ujfalusi87 (€2 in chips) 
Seat 3: NikoBzN (€2.59 in chips) 
Seat 4: pipinoelbreve9 (€2.96 in chips) 
Seat 5: marcdevil (€2.73 in chips) 
Seat 6: arielmm21 (€3.51 in chips) 
Ujfalusi87: posts small blind €0.01
NikoBzN: posts big blind €0.02
*** HOLE CARDS ***
Dealt to pipinoelbreve9 [8c Ad]
pipinoelbreve9: folds 
marcdevil: folds 
arielmm21: raises €0.02 to €0.04
sambupkr: folds 
Ujfalusi87: folds 
NikoBzN: folds 
Uncalled bet (€0.02) returned to arielmm21
arielmm21 collected €0.05 from pot
arielmm21: doesn't show hand 
*** SUMMARY ***
Total pot €0.05 | Rake €0 
Seat 1: sambupkr (button) folded before Flop (didn't bet)
Seat 2: Ujfalusi87 (small blind) folded before Flop
Seat 3: NikoBzN (big blind) folded before Flop
Seat 4: pipinoelbreve9 folded before Flop (didn't bet)
Seat 5: marcdevil folded before Flop (didn't bet)
Seat 6: arielmm21 collected (€0.05)



PokerStars Zoom Hand #257562434949:  Hold'em No Limit (€0.01/€0.02) - 2025/08/31 22:12:34 CET [2025/08/31 16:12:34 ET]
Table 'Arneb' 6-max Seat #1 is the button
Seat 1: Fredkiller800 (€1.71 in chips) 
Seat 2: Lucian Morel (€0.84 in chips) 
Seat 3: pipinoelbreve9 (€2.96 in chips) 
Seat 4: wilbor123 (€2.85 in chips) 
Seat 5: QUIQUE JONES (€0.85 in chips) 
Seat 6: sambupkr (€2 in chips) 
Lucian Morel: posts small blind €0.01
pipinoelbreve9: posts big blind €0.02
*** HOLE CARDS ***
Dealt to pipinoelbreve9 [Ad 7h]
wilbor123: folds 
QUIQUE JONES: folds 
sambupkr: folds 
Fredkiller800: folds 
Lucian Morel: folds 
Uncalled bet (€0.01) returned to pipinoelbreve9
pipinoelbreve9 collected €0.02 from pot
pipinoelbreve9: doesn't show hand 
*** SUMMARY ***
Total pot €0.02 | Rake €0 
Seat 1: Fredkiller800 (button) folded before Flop (didn't bet)
Seat 2: Lucian Morel (small blind) folded before Flop
Seat 3: pipinoelbreve9 (big blind) collected (€0.02)
Seat 4: wilbor123 folded before Flop (didn't bet)
Seat 5: QUIQUE JONES folded before Flop (didn't bet)
Seat 6: sambupkr folded before Flop (didn't bet)



PokerStars Zoom Hand #257562438774:  Hold'em No Limit (€0.01/€0.02) - 2025/08/31 22:12:46 CET [2025/08/31 16:12:46 ET]
Table 'Arneb' 6-max Seat #1 is the button
Seat 1: pipinoelbreve9 (€2.97 in chips) 
Seat 2: NikoBzN (€2.57 in chips) 
Seat 3: fa-soares95 (€1.79 in chips) 
Seat 4: top101 (€2.79 in chips) 
Seat 5: ocsur (€1.71 in chips) 
Seat 6: Ujfalusi87 (€2 in chips) 
NikoBzN: posts small blind €0.01
fa-soares95: posts big blind €0.02
*** HOLE CARDS ***
Dealt to pipinoelbreve9 [8h 7d]
top101: folds 
ocsur: folds 
Ujfalusi87: folds 
pipinoelbreve9: folds 
NikoBzN: folds 
Uncalled bet (€0.01) returned to fa-soares95
fa-soares95 collected €0.02 from pot
fa-soares95: doesn't show hand 
*** SUMMARY ***
Total pot €0.02 | Rake €0 
Seat 1: pipinoelbreve9 (button) folded before Flop (didn't bet)
Seat 2: NikoBzN (small blind) folded before Flop
Seat 3: fa-soares95 (big blind) collected (€0.02)
Seat 4: top101 folded before Flop (didn't bet)
Seat 5: ocsur folded before Flop (didn't bet)
Seat 6: Ujfalusi87 folded before Flop (didn't bet)



PokerStars Zoom Hand #257562440380:  Hold'em No Limit (€0.01/€0.02) - 2025/08/31 22:12:51 CET [2025/08/31 16:12:51 ET]
Table 'Arneb' 6-max Seat #1 is the button
Seat 1: PolCuenca (€3.36 in chips) 
Seat 2: arielmm21 (€3.54 in chips) 
Seat 3: ernest384 (€2.60 in chips) 
Seat 4: NEMOXYX (€3.75 in chips) 
Seat 5: 34pluto (€1.58 in chips) 
Seat 6: pipinoelbreve9 (€2.97 in chips) 
arielmm21: posts small blind €0.01
ernest384: posts big blind €0.02
*** HOLE CARDS ***
Dealt to pipinoelbreve9 [4s 9d]
NEMOXYX: folds 
34pluto: raises €0.02 to €0.04
pipinoelbreve9: folds 
PolCuenca: folds 
arielmm21: calls €0.03
ernest384: raises €0.02 to €0.06
34pluto: calls €0.02
arielmm21: calls €0.02
*** FLOP *** [3s Ks 8h]
arielmm21: checks 
ernest384: bets €0.02
34pluto: folds 
arielmm21: folds 
Uncalled bet (€0.02) returned to ernest384
ernest384 collected €0.17 from pot
ernest384: doesn't show hand 
*** SUMMARY ***
Total pot €0.18 | Rake €0.01 
Board [3s Ks 8h]
Seat 1: PolCuenca (button) folded before Flop (didn't bet)
Seat 2: arielmm21 (small blind) folded on the Flop
Seat 3: ernest384 (big blind) collected (€0.17)
Seat 4: NEMOXYX folded before Flop (didn't bet)
Seat 5: 34pluto folded on the Flop
Seat 6: pipinoelbreve9 folded before Flop (didn't bet)



PokerStars Zoom Hand #257562441854:  Hold'em No Limit (€0.01/€0.02) - 2025/08/31 22:12:55 CET [2025/08/31 16:12:55 ET]
Table 'Arneb' 6-max Seat #1 is the button
Seat 1: TJDasNeves (€2 in chips) 
Seat 2: pipinoelbreve9 (€2.97 in chips) 
Seat 3: javiguardiol (€2.09 in chips) 
Seat 4: Fredkiller800 (€1.71 in chips) 
Seat 5: sambupkr (€2 in chips) 
Seat 6: POÇAOMAGICA (€2 in chips) 
pipinoelbreve9: posts small blind €0.01
javiguardiol: posts big blind €0.02
*** HOLE CARDS ***
Dealt to pipinoelbreve9 [Kd Qc]
Fredkiller800: calls €0.02
sambupkr: folds 
POÇAOMAGICA: calls €0.02
TJDasNeves: folds 
pipinoelbreve9: raises €0.08 to €0.10
javiguardiol: folds 
Fredkiller800: calls €0.08
POÇAOMAGICA: calls €0.08
*** FLOP *** [6h 6s Kc]
pipinoelbreve9: bets €0.09
Fredkiller800: calls €0.09
POÇAOMAGICA: calls €0.09
*** TURN *** [6h 6s Kc] [6c]
pipinoelbreve9: checks 
Fredkiller800: checks 
POÇAOMAGICA: checks 
*** RIVER *** [6h 6s Kc 6c] [9d]
pipinoelbreve9: bets €0.36
Fredkiller800: folds 
POÇAOMAGICA: folds 
Uncalled bet (€0.36) returned to pipinoelbreve9
pipinoelbreve9 collected €0.56 from pot
pipinoelbreve9: doesn't show hand 
*** SUMMARY ***
Total pot €0.59 | Rake €0.03 
Board [6h 6s Kc 6c 9d]
Seat 1: TJDasNeves (button) folded before Flop (didn't bet)
Seat 2: pipinoelbreve9 (small blind) collected (€0.56)
Seat 3: javiguardiol (big blind) folded before Flop
Seat 4: Fredkiller800 folded on the River
Seat 5: sambupkr folded before Flop (didn't bet)
Seat 6: POÇAOMAGICA folded on the River



PokerStars Zoom Hand #257562460687:  Hold'em No Limit (€0.01/€0.02) - 2025/08/31 22:13:55 CET [2025/08/31 16:13:55 ET]
Table 'Arneb' 6-max Seat #1 is the button
Seat 1: Fr@nkys (€2 in chips) 
Seat 2: Chicogas7 (€0.74 in chips) 
Seat 3: fa-soares95 (€1.84 in chips) 
Seat 4: pipinoelbreve9 (€3.34 in chips) 
Seat 5: bokanegraa (€0.87 in chips) 
Seat 6: javiguardiol (€2.58 in chips) 
Chicogas7: posts small blind €0.01
fa-soares95: posts big blind €0.02
*** HOLE CARDS ***
Dealt to pipinoelbreve9 [9s Ks]
pipinoelbreve9: raises €0.04 to €0.06
bokanegraa: calls €0.06
javiguardiol: folds 
Fr@nkys: folds 
Chicogas7: calls €0.05
fa-soares95: calls €0.04
*** FLOP *** [9c 5d 5c]
Chicogas7: checks 
fa-soares95: checks 
pipinoelbreve9: bets €0.16
bokanegraa: folds 
Chicogas7: folds 
fa-soares95: folds 
Uncalled bet (€0.16) returned to pipinoelbreve9
pipinoelbreve9 collected €0.23 from pot
pipinoelbreve9: doesn't show hand 
*** SUMMARY ***
Total pot €0.24 | Rake €0.01 
Board [9c 5d 5c]
Seat 1: Fr@nkys (button) folded before Flop (didn't bet)
Seat 2: Chicogas7 (small blind) folded on the Flop
Seat 3: fa-soares95 (big blind) folded on the Flop
Seat 4: pipinoelbreve9 collected (€0.23)
Seat 5: bokanegraa folded on the Flop
Seat 6: javiguardiol folded before Flop (didn't bet)



PokerStars Zoom Hand #257562479651:  Hold'em No Limit (€0.01/€0.02) - 2025/08/31 22:14:55 CET [2025/08/31 16:14:55 ET]
Table 'Arneb' 6-max Seat #1 is the button
Seat 1: TJDasNeves (€4.15 in chips) 
Seat 2: Eucalypter (€2.25 in chips) 
Seat 3: pipinoelbreve9 (€3.51 in chips) 
Seat 4: sambupkr (€2 in chips) 
Seat 5: PkBcN15 (€2 in chips) 
Seat 6: marcdevil (€2.15 in chips) 
Eucalypter: posts small blind €0.01
pipinoelbreve9: posts big blind €0.02
*** HOLE CARDS ***
Dealt to pipinoelbreve9 [3s Kh]
sambupkr: folds 
PkBcN15: folds 
marcdevil: folds 
TJDasNeves: folds 
Eucalypter: folds 
Uncalled bet (€0.01) returned to pipinoelbreve9
pipinoelbreve9 collected €0.02 from pot
pipinoelbreve9: doesn't show hand 
*** SUMMARY ***
Total pot €0.02 | Rake €0 
Seat 1: TJDasNeves (button) folded before Flop (didn't bet)
Seat 2: Eucalypter (small blind) folded before Flop
Seat 3: pipinoelbreve9 (big blind) collected (€0.02)
Seat 4: sambupkr folded before Flop (didn't bet)
Seat 5: PkBcN15 folded before Flop (didn't bet)
Seat 6: marcdevil folded before Flop (didn't bet)



PokerStars Zoom Hand #257562458694:  Hold'em No Limit (€0.01/€0.02) - 2025/08/31 22:13:49 CET [2025/08/31 16:13:49 ET]
Table 'Arneb' 6-max Seat #1 is the button
Seat 1: rare12345 (€2 in chips) 
Seat 2: NEMOXYX (€3.70 in chips) 
Seat 3: TJDasNeves (€4.14 in chips) 
Seat 4: sambupkr (€2 in chips) 
Seat 5: pipinoelbreve9 (€3.34 in chips) 
Seat 6: marcdevil (€2.18 in chips) 
NEMOXYX: posts small blind €0.01
TJDasNeves: posts big blind €0.02
*** HOLE CARDS ***
Dealt to pipinoelbreve9 [Kh 4d]
sambupkr: folds 
pipinoelbreve9: folds 
marcdevil: folds 
rare12345: raises €0.03 to €0.05
NEMOXYX: raises €0.19 to €0.24
TJDasNeves: folds 
rare12345: raises €0.36 to €0.60
NEMOXYX: calls €0.36
*** FLOP *** [7h 8s Th]
NEMOXYX: checks 
rare12345: checks 
*** TURN *** [7h 8s Th] [6h]
NEMOXYX: bets €0.81
rare12345: calls €0.81
*** RIVER *** [7h 8s Th 6h] [8h]
NEMOXYX: bets €2.29 and is all-in
rare12345: calls €0.59 and is all-in
Uncalled bet (€1.70) returned to NEMOXYX
*** SHOW DOWN ***
NEMOXYX: shows [8d 8c] (four of a kind, Eights)
rare12345: shows [Ac 7s] (two pair, Eights and Sevens)
NEMOXYX collected €3.82 from pot
*** SUMMARY ***
Total pot €4.02 | Rake €0.20 
Board [7h 8s Th 6h 8h]
Seat 1: rare12345 (button) showed [Ac 7s] and lost with two pair, Eights and Sevens
Seat 2: NEMOXYX (small blind) showed [8d 8c] and won (€3.82) with four of a kind, Eights
Seat 3: TJDasNeves (big blind) folded before Flop
Seat 4: sambupkr folded before Flop (didn't bet)
Seat 5: pipinoelbreve9 folded before Flop (didn't bet)
Seat 6: marcdevil folded before Flop (didn't bet)



PokerStars Zoom Hand #257562487175:  Hold'em No Limit (€0.01/€0.02) - 2025/08/31 22:15:19 CET [2025/08/31 16:15:19 ET]
Table 'Arneb' 6-max Seat #1 is the button
Seat 1: POÇAOMAGICA (€2 in chips) 
Seat 2: sambupkr (€2.09 in chips) 
Seat 3: ana paula900 (€1.56 in chips) 
Seat 4: pipinoelbreve9 (€3.51 in chips) 
Seat 5: Chicogas7 (€0.69 in chips) 
Seat 6: myrtus9 (€1.69 in chips) 
sambupkr: posts small blind €0.01
ana paula900: posts big blind €0.02
*** HOLE CARDS ***
Dealt to pipinoelbreve9 [5s 6d]
pipinoelbreve9: folds 
Chicogas7: raises €0.04 to €0.06
myrtus9: folds 
POÇAOMAGICA: folds 
sambupkr: folds 
ana paula900: folds 
Uncalled bet (€0.04) returned to Chicogas7
Chicogas7 collected €0.05 from pot
Chicogas7: doesn't show hand 
*** SUMMARY ***
Total pot €0.05 | Rake €0 
Seat 1: POÇAOMAGICA (button) folded before Flop (didn't bet)
Seat 2: sambupkr (small blind) folded before Flop
Seat 3: ana paula900 (big blind) folded before Flop
Seat 4: pipinoelbreve9 folded before Flop (didn't bet)
Seat 5: Chicogas7 collected (€0.05)
Seat 6: myrtus9 folded before Flop (didn't bet)



PokerStars Zoom Hand #257562490657:  Hold'em No Limit (€0.01/€0.02) - 2025/08/31 22:15:30 CET [2025/08/31 16:15:30 ET]
Table 'Arneb' 6-max Seat #1 is the button
Seat 1: wilbor123 (€2.50 in chips) 
Seat 2: ana paula900 (€1.54 in chips) 
Seat 3: fa-soares95 (€1.74 in chips) 
Seat 4: mandru80 (€1.16 in chips) 
Seat 5: marcdevil (€2.67 in chips) 
Seat 6: pipinoelbreve9 (€3.51 in chips) 
ana paula900: posts small blind €0.01
fa-soares95: posts big blind €0.02
*** HOLE CARDS ***
Dealt to pipinoelbreve9 [6d Qc]
mandru80: folds 
marcdevil: folds 
pipinoelbreve9: folds 
wilbor123: raises €0.04 to €0.06
ana paula900: folds 
fa-soares95: folds 
Uncalled bet (€0.04) returned to wilbor123
wilbor123 collected €0.05 from pot
wilbor123: doesn't show hand 
*** SUMMARY ***
Total pot €0.05 | Rake €0 
Seat 1: wilbor123 (button) collected (€0.05)
Seat 2: ana paula900 (small blind) folded before Flop
Seat 3: fa-soares95 (big blind) folded before Flop
Seat 4: mandru80 folded before Flop (didn't bet)
Seat 5: marcdevil folded before Flop (didn't bet)
Seat 6: pipinoelbreve9 folded before Flop (didn't bet)



PokerStars Zoom Hand #257562489146:  Hold'em No Limit (€0.01/€0.02) - 2025/08/31 22:15:25 CET [2025/08/31 16:15:25 ET]
Table 'Arneb' 6-max Seat #1 is the button
Seat 1: pipinoelbreve9 (€3.51 in chips) 
Seat 2: Chichoampuero12 (€3.49 in chips) 
Seat 3: Izibeaxh (€9.33 in chips) 
Seat 4: Lumifer (€2.20 in chips) 
Seat 5: mandru80 (€1.16 in chips) 
Seat 6: QUIQUE JONES (€0.55 in chips) 
Chichoampuero12: posts small blind €0.01
Izibeaxh: posts big blind €0.02
*** HOLE CARDS ***
Dealt to pipinoelbreve9 [3s 7s]
Lumifer: folds 
mandru80: folds 
QUIQUE JONES: folds 
pipinoelbreve9: folds 
Chichoampuero12: raises €0.05 to €0.07
Izibeaxh: folds 
Uncalled bet (€0.05) returned to Chichoampuero12
Chichoampuero12 collected €0.04 from pot
Chichoampuero12: doesn't show hand 
*** SUMMARY ***
Total pot €0.04 | Rake €0 
Seat 1: pipinoelbreve9 (button) folded before Flop (didn't bet)
Seat 2: Chichoampuero12 (small blind) collected (€0.04)
Seat 3: Izibeaxh (big blind) folded before Flop
Seat 4: Lumifer folded before Flop (didn't bet)
Seat 5: mandru80 folded before Flop (didn't bet)
Seat 6: QUIQUE JONES folded before Flop (didn't bet)



PokerStars Zoom Hand #257562484195:  Hold'em No Limit (€0.01/€0.02) - 2025/08/31 22:15:09 CET [2025/08/31 16:15:09 ET]
Table 'Arneb' 6-max Seat #1 is the button
Seat 1: kurikutela53 (€0.90 in chips) 
Seat 2: pipinoelbreve9 (€3.52 in chips) 
Seat 3: POÇAOMAGICA (€2.03 in chips) 
Seat 4: top101 (€2.75 in chips) 
Seat 5: Aureussp (€0.26 in chips) 
Seat 6: TJDasNeves (€2 in chips) 
pipinoelbreve9: posts small blind €0.01
POÇAOMAGICA: posts big blind €0.02
*** HOLE CARDS ***
Dealt to pipinoelbreve9 [4h Js]
top101: raises €0.02 to €0.04
Aureussp: folds 
TJDasNeves: calls €0.04
kurikutela53: folds 
pipinoelbreve9: folds 
POÇAOMAGICA: folds 
*** FLOP *** [7s Td Qc]
top101: bets €0.05
TJDasNeves: folds 
Uncalled bet (€0.05) returned to top101
top101 collected €0.10 from pot
top101: doesn't show hand 
*** SUMMARY ***
Total pot €0.11 | Rake €0.01 
Board [7s Td Qc]
Seat 1: kurikutela53 (button) folded before Flop (didn't bet)
Seat 2: pipinoelbreve9 (small blind) folded before Flop
Seat 3: POÇAOMAGICA (big blind) folded before Flop
Seat 4: top101 collected (€0.10)
Seat 5: Aureussp folded before Flop (didn't bet)
Seat 6: TJDasNeves folded on the Flop



PokerStars Zoom Hand #257562492644:  Hold'em No Limit (€0.01/€0.02) - 2025/08/31 22:15:37 CET [2025/08/31 16:15:37 ET]
Table 'Arneb' 6-max Seat #1 is the button
Seat 1: Ujfalusi87 (€2.11 in chips) 
Seat 2: pipinoelbreve9 (€3.51 in chips) 
Seat 3: marcdevil (€2.67 in chips) 
Seat 4: Chicogas7 (€0.72 in chips) 
Seat 5: Pepita71 (€2.14 in chips) 
Seat 6: poteaarte (€2.18 in chips) 
pipinoelbreve9: posts small blind €0.01
marcdevil: posts big blind €0.02
*** HOLE CARDS ***
Dealt to pipinoelbreve9 [Ac 7s]
Chicogas7: folds 
Pepita71: raises €0.02 to €0.04
poteaarte: folds 
Ujfalusi87: folds 
pipinoelbreve9: calls €0.03
marcdevil: calls €0.02
*** FLOP *** [2h Qs As]
pipinoelbreve9: bets €0.06
marcdevil: folds 
Pepita71: raises €0.12 to €0.18
pipinoelbreve9: calls €0.12
*** TURN *** [2h Qs As] [8h]
pipinoelbreve9: checks 
Pepita71: bets €0.23
pipinoelbreve9: calls €0.23
*** RIVER *** [2h Qs As 8h] [9c]
pipinoelbreve9: checks 
Pepita71: bets €0.71
pipinoelbreve9: calls €0.71
*** SHOW DOWN ***
Pepita71: shows [Qc Ah] (two pair, Aces and Queens)
pipinoelbreve9: mucks hand 
Pepita71 collected €2.24 from pot
*** SUMMARY ***
Total pot €2.36 | Rake €0.12 
Board [2h Qs As 8h 9c]
Seat 1: Ujfalusi87 (button) folded before Flop (didn't bet)
Seat 2: pipinoelbreve9 (small blind) mucked [Ac 7s]
Seat 3: marcdevil (big blind) folded on the Flop
Seat 4: Chicogas7 folded before Flop (didn't bet)
Seat 5: Pepita71 showed [Qc Ah] and won (€2.24) with two pair, Aces and Queens
Seat 6: poteaarte folded before Flop (didn't bet)



PokerStars Zoom Hand #257562524291:  Hold'em No Limit (€0.01/€0.02) - 2025/08/31 22:17:16 CET [2025/08/31 16:17:16 ET]
Table 'Arneb' 6-max Seat #1 is the button
Seat 1: Fr@nkys (€2.14 in chips) 
Seat 2: Chichoampuero12 (€3.46 in chips) 
Seat 3: pipinoelbreve9 (€2.35 in chips) 
Seat 4: Pepita71 (€3.22 in chips) 
Seat 5: POÇAOMAGICA (€2.15 in chips) 
Seat 6: rare12345 (€2 in chips) 
Chichoampuero12: posts small blind €0.01
pipinoelbreve9: posts big blind €0.02
*** HOLE CARDS ***
Dealt to pipinoelbreve9 [5h Ah]
Pepita71: folds 
POÇAOMAGICA: folds 
rare12345: folds 
Fr@nkys: folds 
Chichoampuero12: raises €0.04 to €0.06
pipinoelbreve9: raises €0.14 to €0.20
Chichoampuero12: folds 
Uncalled bet (€0.14) returned to pipinoelbreve9
pipinoelbreve9 collected €0.12 from pot
pipinoelbreve9: doesn't show hand 
*** SUMMARY ***
Total pot €0.12 | Rake €0 
Seat 1: Fr@nkys (button) folded before Flop (didn't bet)
Seat 2: Chichoampuero12 (small blind) folded before Flop
Seat 3: pipinoelbreve9 (big blind) collected (€0.12)
Seat 4: Pepita71 folded before Flop (didn't bet)
Seat 5: POÇAOMAGICA folded before Flop (didn't bet)
Seat 6: rare12345 folded before Flop (didn't bet)



PokerStars Zoom Hand #257562535772:  Hold'em No Limit (€0.01/€0.02) - 2025/08/31 22:17:52 CET [2025/08/31 16:17:52 ET]
Table 'Arneb' 6-max Seat #1 is the button
Seat 1: fa-soares95 (€2.48 in chips) 
Seat 2: Xoseanro510 (€2 in chips) 
Seat 3: Chichoampuero12 (€3.40 in chips) 
Seat 4: pipinoelbreve9 (€2.41 in chips) 
Seat 5: rare12345 (€2 in chips) 
Seat 6: finfin13205 (€0.14 in chips) 
Xoseanro510: posts small blind €0.01
Chichoampuero12: posts big blind €0.02
*** HOLE CARDS ***
Dealt to pipinoelbreve9 [4d 9c]
pipinoelbreve9: folds 
rare12345: raises €0.03 to €0.05
finfin13205: raises €0.05 to €0.10
fa-soares95: folds 
Xoseanro510: folds 
Chichoampuero12: folds 
rare12345: raises €0.16 to €0.26
finfin13205: calls €0.04 and is all-in
Uncalled bet (€0.12) returned to rare12345
*** FLOP *** [2h 8h Kd]
*** TURN *** [2h 8h Kd] [4c]
*** RIVER *** [2h 8h Kd 4c] [3d]
*** SHOW DOWN ***
rare12345: shows [Jc Ah] (high card Ace)
finfin13205: shows [6d Jd] (high card King)
rare12345 collected €0.29 from pot
*** SUMMARY ***
Total pot €0.31 | Rake €0.02 
Board [2h 8h Kd 4c 3d]
Seat 1: fa-soares95 (button) folded before Flop (didn't bet)
Seat 2: Xoseanro510 (small blind) folded before Flop
Seat 3: Chichoampuero12 (big blind) folded before Flop
Seat 4: pipinoelbreve9 folded before Flop (didn't bet)
Seat 5: rare12345 showed [Jc Ah] and won (€0.29) with high card Ace
Seat 6: finfin13205 showed [6d Jd] and lost with high card King



PokerStars Zoom Hand #257562540971:  Hold'em No Limit (€0.01/€0.02) - 2025/08/31 22:18:08 CET [2025/08/31 16:18:08 ET]
Table 'Arneb' 6-max Seat #1 is the button
Seat 1: pipinoelbreve9 (€2.41 in chips) 
Seat 2: top101 (€2.87 in chips) 
Seat 3: ana paula900 (€1.55 in chips) 
Seat 4: aliner34j (€2.64 in chips) 
Seat 5: rare12345 (€2 in chips) 
Seat 6: Lumifer (€2.34 in chips) 
top101: posts small blind €0.01
ana paula900: posts big blind €0.02
*** HOLE CARDS ***
Dealt to pipinoelbreve9 [Th 9s]
aliner34j: folds 
rare12345: folds 
Lumifer: folds 
pipinoelbreve9: folds 
top101: raises €0.02 to €0.04
ana paula900: folds 
Uncalled bet (€0.02) returned to top101
top101 collected €0.04 from pot
top101: doesn't show hand 
*** SUMMARY ***
Total pot €0.04 | Rake €0 
Seat 1: pipinoelbreve9 (button) folded before Flop (didn't bet)
Seat 2: top101 (small blind) collected (€0.04)
Seat 3: ana paula900 (big blind) folded before Flop
Seat 4: aliner34j folded before Flop (didn't bet)
Seat 5: rare12345 folded before Flop (didn't bet)
Seat 6: Lumifer folded before Flop (didn't bet)



PokerStars Zoom Hand #257562542291:  Hold'em No Limit (€0.01/€0.02) - 2025/08/31 22:18:12 CET [2025/08/31 16:18:12 ET]
Table 'Arneb' 6-max Seat #1 is the button
Seat 1: cris1966564 (€1.57 in chips) 
Seat 2: POÇAOMAGICA (€2.04 in chips) 
Seat 3: CASCALE$ (€1.68 in chips) 
Seat 4: Fr@nkys (€2.22 in chips) 
Seat 5: Lumifer (€2.34 in chips) 
Seat 6: pipinoelbreve9 (€2.41 in chips) 
POÇAOMAGICA: posts small blind €0.01
CASCALE$: posts big blind €0.02
*** HOLE CARDS ***
Dealt to pipinoelbreve9 [8s 3s]
Fr@nkys: folds 
Lumifer: folds 
pipinoelbreve9: folds 
cris1966564: folds 
POÇAOMAGICA: folds 
Uncalled bet (€0.01) returned to CASCALE$
CASCALE$ collected €0.02 from pot
CASCALE$: doesn't show hand 
*** SUMMARY ***
Total pot €0.02 | Rake €0 
Seat 1: cris1966564 (button) folded before Flop (didn't bet)
Seat 2: POÇAOMAGICA (small blind) folded before Flop
Seat 3: CASCALE$ (big blind) collected (€0.02)
Seat 4: Fr@nkys folded before Flop (didn't bet)
Seat 5: Lumifer folded before Flop (didn't bet)
Seat 6: pipinoelbreve9 folded before Flop (didn't bet)



PokerStars Zoom Hand #257562544016:  Hold'em No Limit (€0.01/€0.02) - 2025/08/31 22:18:17 CET [2025/08/31 16:18:17 ET]
Table 'Arneb' 6-max Seat #1 is the button
Seat 1: sambupkr (€2 in chips) 
Seat 2: cris1966564 (€1.57 in chips) 
Seat 3: pipinoelbreve9 (€2.41 in chips) 
Seat 4: javiguardiol (€2.60 in chips) 
Seat 5: marcdevil (€2.35 in chips) 
Seat 6: RCSA2 (€2.01 in chips) 
cris1966564: posts small blind €0.01
pipinoelbreve9: posts big blind €0.02
*** HOLE CARDS ***
Dealt to pipinoelbreve9 [5d 4c]
javiguardiol: folds 
marcdevil: folds 
RCSA2: calls €0.02
sambupkr: folds 
cris1966564: folds 
pipinoelbreve9: checks 
*** FLOP *** [Tc 2h 5c]
pipinoelbreve9: bets €0.03
RCSA2: folds 
Uncalled bet (€0.03) returned to pipinoelbreve9
pipinoelbreve9 collected €0.05 from pot
pipinoelbreve9: doesn't show hand 
*** SUMMARY ***
Total pot €0.05 | Rake €0 
Board [Tc 2h 5c]
Seat 1: sambupkr (button) folded before Flop (didn't bet)
Seat 2: cris1966564 (small blind) folded before Flop
Seat 3: pipinoelbreve9 (big blind) collected (€0.05)
Seat 4: javiguardiol folded before Flop (didn't bet)
Seat 5: marcdevil folded before Flop (didn't bet)
Seat 6: RCSA2 folded on the Flop



PokerStars Zoom Hand #257562537366:  Hold'em No Limit (€0.01/€0.02) - 2025/08/31 22:17:57 CET [2025/08/31 16:17:57 ET]
Table 'Arneb' 6-max Seat #1 is the button
Seat 1: Ismael 77751 (€1.84 in chips) 
Seat 2: ocsur (€1.79 in chips) 
Seat 3: POÇAOMAGICA (€2.12 in chips) 
Seat 4: 34pluto (€1.44 in chips) 
Seat 5: pipinoelbreve9 (€2.41 in chips) 
Seat 6: Fr@nkys (€2 in chips) 
ocsur: posts small blind €0.01
POÇAOMAGICA: posts big blind €0.02
*** HOLE CARDS ***
Dealt to pipinoelbreve9 [7s 5h]
34pluto: raises €0.02 to €0.04
pipinoelbreve9: folds 
Fr@nkys: folds 
Ismael 77751: calls €0.04
ocsur: folds 
POÇAOMAGICA: folds 
*** FLOP *** [2s Qh Th]
34pluto: checks 
Ismael 77751: bets €0.16
34pluto: folds 
Uncalled bet (€0.16) returned to Ismael 77751
Ismael 77751 collected €0.10 from pot
Ismael 77751: doesn't show hand 
*** SUMMARY ***
Total pot €0.11 | Rake €0.01 
Board [2s Qh Th]
Seat 1: Ismael 77751 (button) collected (€0.10)
Seat 2: ocsur (small blind) folded before Flop
Seat 3: POÇAOMAGICA (big blind) folded before Flop
Seat 4: 34pluto folded on the Flop
Seat 5: pipinoelbreve9 folded before Flop (didn't bet)
Seat 6: Fr@nkys folded before Flop (didn't bet)



PokerStars Zoom Hand #257562550687:  Hold'em No Limit (€0.01/€0.02) - 2025/08/31 22:18:39 CET [2025/08/31 16:18:39 ET]
Table 'Arneb' 6-max Seat #1 is the button
Seat 1: Izibeaxh (€2.07 in chips) 
Seat 2: pipinoelbreve9 (€2.44 in chips) 
Seat 3: rare12345 (€2.54 in chips) 
Seat 4: myrtus9 (€1.59 in chips) 
Seat 5: RCSA2 (€1.99 in chips) 
Seat 6: fa-soares95 (€2.47 in chips) 
pipinoelbreve9: posts small blind €0.01
rare12345: posts big blind €0.02
*** HOLE CARDS ***
Dealt to pipinoelbreve9 [5d 5h]
myrtus9: folds 
RCSA2: calls €0.02
fa-soares95: folds 
Izibeaxh: folds 
pipinoelbreve9: raises €0.08 to €0.10
rare12345: folds 
RCSA2: calls €0.08
*** FLOP *** [2h Qs 9s]
pipinoelbreve9: checks 
RCSA2: checks 
*** TURN *** [2h Qs 9s] [5c]
pipinoelbreve9: checks 
RCSA2: bets €0.10
pipinoelbreve9: calls €0.10
*** RIVER *** [2h Qs 9s 5c] [4s]
pipinoelbreve9: checks 
RCSA2: checks 
*** SHOW DOWN ***
pipinoelbreve9: shows [5d 5h] (three of a kind, Fives)
RCSA2: mucks hand 
pipinoelbreve9 collected €0.40 from pot
*** SUMMARY ***
Total pot €0.42 | Rake €0.02 
Board [2h Qs 9s 5c 4s]
Seat 1: Izibeaxh (button) folded before Flop (didn't bet)
Seat 2: pipinoelbreve9 (small blind) showed [5d 5h] and won (€0.40) with three of a kind, Fives
Seat 3: rare12345 (big blind) folded before Flop
Seat 4: myrtus9 folded before Flop (didn't bet)
Seat 5: RCSA2 mucked [2c 3c]
Seat 6: fa-soares95 folded before Flop (didn't bet)



PokerStars Zoom Hand #257562567579:  Hold'em No Limit (€0.01/€0.02) - 2025/08/31 22:19:31 CET [2025/08/31 16:19:31 ET]
Table 'Arneb' 6-max Seat #1 is the button
Seat 1: RCSA2 (€1.79 in chips) 
Seat 2: Fr@nkys (€2.23 in chips) 
Seat 3: fa-soares95 (€2.54 in chips) 
Seat 4: PkBcN15 (€2.04 in chips) 
Seat 5: pipinoelbreve9 (€2.64 in chips) 
Seat 6: Chicogas7 (€0.60 in chips) 
Fr@nkys: posts small blind €0.01
fa-soares95: posts big blind €0.02
*** HOLE CARDS ***
Dealt to pipinoelbreve9 [5s Tc]
PkBcN15: folds 
pipinoelbreve9: folds 
Chicogas7: folds 
RCSA2: folds 
Fr@nkys: folds 
Uncalled bet (€0.01) returned to fa-soares95
fa-soares95 collected €0.02 from pot
fa-soares95: doesn't show hand 
*** SUMMARY ***
Total pot €0.02 | Rake €0 
Seat 1: RCSA2 (button) folded before Flop (didn't bet)
Seat 2: Fr@nkys (small blind) folded before Flop
Seat 3: fa-soares95 (big blind) collected (€0.02)
Seat 4: PkBcN15 folded before Flop (didn't bet)
Seat 5: pipinoelbreve9 folded before Flop (didn't bet)
Seat 6: Chicogas7 folded before Flop (didn't bet)



PokerStars Zoom Hand #257562577017:  Hold'em No Limit (€0.01/€0.02) - 2025/08/31 22:20:01 CET [2025/08/31 16:20:01 ET]
Table 'Arneb' 6-max Seat #1 is the button
Seat 1: marcdevil (€2.26 in chips) 
Seat 2: rare12345 (€2.01 in chips) 
Seat 3: wilbor123 (€4.82 in chips) 
Seat 4: pipinoelbreve9 (€2.64 in chips) 
Seat 5: Phamtom123 (€1.17 in chips) 
Seat 6: CASCALE$ (€1.64 in chips) 
rare12345: posts small blind €0.01
wilbor123: posts big blind €0.02
*** HOLE CARDS ***
Dealt to pipinoelbreve9 [4c 3s]
pipinoelbreve9: folds 
Phamtom123: folds 
CASCALE$: raises €0.02 to €0.04
marcdevil: folds 
rare12345: folds 
wilbor123: folds 
Uncalled bet (€0.02) returned to CASCALE$
CASCALE$ collected €0.05 from pot
CASCALE$: doesn't show hand 
*** SUMMARY ***
Total pot €0.05 | Rake €0 
Seat 1: marcdevil (button) folded before Flop (didn't bet)
Seat 2: rare12345 (small blind) folded before Flop
Seat 3: wilbor123 (big blind) folded before Flop
Seat 4: pipinoelbreve9 folded before Flop (didn't bet)
Seat 5: Phamtom123 folded before Flop (didn't bet)
Seat 6: CASCALE$ collected (€0.05)



PokerStars Zoom Hand #257562573359:  Hold'em No Limit (€0.01/€0.02) - 2025/08/31 22:19:49 CET [2025/08/31 16:19:49 ET]
Table 'Arneb' 6-max Seat #1 is the button
Seat 1: Chichoampuero12 (€2 in chips) 
Seat 2: Fr@nkys (€2 in chips) 
Seat 3: 34pluto (€1.88 in chips) 
Seat 4: Lumifer (€2.42 in chips) 
Seat 5: POÇAOMAGICA (€3.98 in chips) 
Seat 6: pipinoelbreve9 (€2.64 in chips) 
Fr@nkys: posts small blind €0.01
34pluto: posts big blind €0.02
*** HOLE CARDS ***
Dealt to pipinoelbreve9 [9h As]
Lumifer: folds 
POÇAOMAGICA: calls €0.02
pipinoelbreve9: folds 
Chichoampuero12: folds 
Fr@nkys: folds 
34pluto: checks 
*** FLOP *** [Kd 9s Jd]
34pluto: bets €0.03
POÇAOMAGICA: calls €0.03
*** TURN *** [Kd 9s Jd] [3h]
34pluto: bets €0.06
POÇAOMAGICA: folds 
Uncalled bet (€0.06) returned to 34pluto
34pluto collected €0.10 from pot
34pluto: doesn't show hand 
*** SUMMARY ***
Total pot €0.11 | Rake €0.01 
Board [Kd 9s Jd 3h]
Seat 1: Chichoampuero12 (button) folded before Flop (didn't bet)
Seat 2: Fr@nkys (small blind) folded before Flop
Seat 3: 34pluto (big blind) collected (€0.10)
Seat 4: Lumifer folded before Flop (didn't bet)
Seat 5: POÇAOMAGICA folded on the Turn
Seat 6: pipinoelbreve9 folded before Flop (didn't bet)



PokerStars Zoom Hand #257562571424:  Hold'em No Limit (€0.01/€0.02) - 2025/08/31 22:19:43 CET [2025/08/31 16:19:43 ET]
Table 'Arneb' 6-max Seat #1 is the button
Seat 1: pipinoelbreve9 (€2.64 in chips) 
Seat 2: Pepita71 (€3.17 in chips) 
Seat 3: sambupkr (€2.15 in chips) 
Seat 4: PkBcN15 (€2.03 in chips) 
Seat 5: marcdevil (€2.68 in chips) 
Seat 6: POÇAOMAGICA (€2.10 in chips) 
Pepita71: posts small blind €0.01
sambupkr: posts big blind €0.02
*** HOLE CARDS ***
Dealt to pipinoelbreve9 [Td 3d]
PkBcN15: folds 
marcdevil: raises €0.04 to €0.06
POÇAOMAGICA: folds 
pipinoelbreve9: folds 
Pepita71: folds 
sambupkr: calls €0.04
*** FLOP *** [Ah 3c Qs]
sambupkr: checks 
marcdevil: bets €0.06
sambupkr: calls €0.06
*** TURN *** [Ah 3c Qs] [2c]
sambupkr: bets €0.12
marcdevil: raises €0.24 to €0.36
sambupkr: calls €0.24
*** RIVER *** [Ah 3c Qs 2c] [9d]
sambupkr: checks 
marcdevil: bets €0.92
sambupkr: folds 
Uncalled bet (€0.92) returned to marcdevil
marcdevil collected €0.92 from pot
marcdevil: doesn't show hand 
*** SUMMARY ***
Total pot €0.97 | Rake €0.05 
Board [Ah 3c Qs 2c 9d]
Seat 1: pipinoelbreve9 (button) folded before Flop (didn't bet)
Seat 2: Pepita71 (small blind) folded before Flop
Seat 3: sambupkr (big blind) folded on the River
Seat 4: PkBcN15 folded before Flop (didn't bet)
Seat 5: marcdevil collected (€0.92)
Seat 6: POÇAOMAGICA folded before Flop (didn't bet)



PokerStars Zoom Hand #257562578757:  Hold'em No Limit (€0.01/€0.02) - 2025/08/31 22:20:06 CET [2025/08/31 16:20:06 ET]
Table 'Arneb' 6-max Seat #1 is the button
Seat 1: Phamtom123 (€1.17 in chips) 
Seat 2: Ismael 77751 (€2.23 in chips) 
Seat 3: joelini001 (€0.82 in chips) 
Seat 4: pipinoelbreve9 (€2.64 in chips) 
Seat 5: NikoBzN (€2 in chips) 
Seat 6: Fr@nkys (€2.22 in chips) 
Ismael 77751: posts small blind €0.01
joelini001: posts big blind €0.02
*** HOLE CARDS ***
Dealt to pipinoelbreve9 [Kd Jd]
pipinoelbreve9: raises €0.04 to €0.06
NikoBzN: calls €0.06
Fr@nkys: folds 
Phamtom123: folds 
Ismael 77751: calls €0.05
joelini001: calls €0.04
*** FLOP *** [9c 2c 6d]
Ismael 77751: checks 
joelini001: bets €0.02
pipinoelbreve9: calls €0.02
NikoBzN: calls €0.02
Ismael 77751: calls €0.02
*** TURN *** [9c 2c 6d] [7d]
Ismael 77751: checks 
joelini001: bets €0.02
pipinoelbreve9: raises €0.17 to €0.19
NikoBzN: folds 
Ismael 77751: folds 
joelini001: calls €0.17
*** RIVER *** [9c 2c 6d 7d] [6s]
joelini001: bets €0.33
pipinoelbreve9: folds 
Uncalled bet (€0.33) returned to joelini001
joelini001 collected €0.66 from pot
joelini001: doesn't show hand 
*** SUMMARY ***
Total pot €0.70 | Rake €0.04 
Board [9c 2c 6d 7d 6s]
Seat 1: Phamtom123 (button) folded before Flop (didn't bet)
Seat 2: Ismael 77751 (small blind) folded on the Turn
Seat 3: joelini001 (big blind) collected (€0.66)
Seat 4: pipinoelbreve9 folded on the River
Seat 5: NikoBzN folded on the Turn
Seat 6: Fr@nkys folded before Flop (didn't bet)



PokerStars Zoom Hand #257562606823:  Hold'em No Limit (€0.01/€0.02) - 2025/08/31 22:21:34 CET [2025/08/31 16:21:34 ET]
Table 'Arneb' 6-max Seat #1 is the button
Seat 1: joelini001 (€1.21 in chips) 
Seat 2: Jebahon (€1.56 in chips) 
Seat 3: pipinoelbreve9 (€2.37 in chips) 
Seat 4: sambupkr (€2 in chips) 
Seat 5: felgas1968 (€1.79 in chips) 
Seat 6: Lumifer (€2 in chips) 
Jebahon: posts small blind €0.01
pipinoelbreve9: posts big blind €0.02
*** HOLE CARDS ***
Dealt to pipinoelbreve9 [2h Jd]
sambupkr: folds 
felgas1968: folds 
Lumifer: folds 
joelini001: calls €0.02
Jebahon: calls €0.01
pipinoelbreve9: checks 
*** FLOP *** [9s 5s 3h]
Jebahon: checks 
pipinoelbreve9: checks 
joelini001: checks 
*** TURN *** [9s 5s 3h] [Qd]
Jebahon: checks 
pipinoelbreve9: checks 
joelini001: bets €0.02
Jebahon: folds 
pipinoelbreve9: folds 
Uncalled bet (€0.02) returned to joelini001
joelini001 collected €0.06 from pot
joelini001: doesn't show hand 
*** SUMMARY ***
Total pot €0.06 | Rake €0 
Board [9s 5s 3h Qd]
Seat 1: joelini001 (button) collected (€0.06)
Seat 2: Jebahon (small blind) folded on the Turn
Seat 3: pipinoelbreve9 (big blind) folded on the Turn
Seat 4: sambupkr folded before Flop (didn't bet)
Seat 5: felgas1968 folded before Flop (didn't bet)
Seat 6: Lumifer folded before Flop (didn't bet)



PokerStars Zoom Hand #257562622537:  Hold'em No Limit (€0.01/€0.02) - 2025/08/31 22:22:23 CET [2025/08/31 16:22:23 ET]
Table 'Arneb' 6-max Seat #1 is the button
Seat 1: ana paula900 (€1.62 in chips) 
Seat 2: pipinoelbreve9 (€2.35 in chips) 
Seat 3: sambupkr (€2.35 in chips) 
Seat 4: felgas1968 (€2.32 in chips) 
Seat 5: 34pluto (€1.08 in chips) 
Seat 6: rare12345 (€2.37 in chips) 
pipinoelbreve9: posts small blind €0.01
sambupkr: posts big blind €0.02
*** HOLE CARDS ***
Dealt to pipinoelbreve9 [4c Jc]
felgas1968: folds 
34pluto: folds 
rare12345: folds 
ana paula900: folds 
pipinoelbreve9: raises €0.04 to €0.06
sambupkr: folds 
Uncalled bet (€0.04) returned to pipinoelbreve9
pipinoelbreve9 collected €0.04 from pot
pipinoelbreve9: doesn't show hand 
*** SUMMARY ***
Total pot €0.04 | Rake €0 
Seat 1: ana paula900 (button) folded before Flop (didn't bet)
Seat 2: pipinoelbreve9 (small blind) collected (€0.04)
Seat 3: sambupkr (big blind) folded before Flop
Seat 4: felgas1968 folded before Flop (didn't bet)
Seat 5: 34pluto folded before Flop (didn't bet)
Seat 6: rare12345 folded before Flop (didn't bet)



PokerStars Zoom Hand #257562619988:  Hold'em No Limit (€0.01/€0.02) - 2025/08/31 22:22:15 CET [2025/08/31 16:22:15 ET]
Table 'Arneb' 6-max Seat #1 is the button
Seat 1: 34pluto (€1.08 in chips) 
Seat 2: Dazumen (€2 in chips) 
Seat 3: tanoun1 (€2.10 in chips) 
Seat 4: Fr@nkys (€2.10 in chips) 
Seat 5: marcdevil (€2.46 in chips) 
Seat 6: pipinoelbreve9 (€2.35 in chips) 
Dazumen: posts small blind €0.01
tanoun1: posts big blind €0.02
*** HOLE CARDS ***
Dealt to pipinoelbreve9 [Th 5h]
Dazumen is disconnected 
Fr@nkys: raises €0.03 to €0.05
marcdevil: folds 
pipinoelbreve9: folds 
34pluto: folds 
Dazumen has timed out while disconnected
Dazumen: folds 
tanoun1: folds 
Uncalled bet (€0.03) returned to Fr@nkys
Fr@nkys collected €0.05 from pot
Fr@nkys: doesn't show hand 
*** SUMMARY ***
Total pot €0.05 | Rake €0 
Seat 1: 34pluto (button) folded before Flop (didn't bet)
Seat 2: Dazumen (small blind) folded before Flop
Seat 3: tanoun1 (big blind) folded before Flop
Seat 4: Fr@nkys collected (€0.05)
Seat 5: marcdevil folded before Flop (didn't bet)
Seat 6: pipinoelbreve9 folded before Flop (didn't bet)



PokerStars Zoom Hand #257562626608:  Hold'em No Limit (€0.01/€0.02) - 2025/08/31 22:22:36 CET [2025/08/31 16:22:36 ET]
Table 'Arneb' 6-max Seat #1 is the button
Seat 1: pipinoelbreve9 (€2.37 in chips) 
Seat 2: marcdevil (€2.29 in chips) 
Seat 3: WJSP (€2 in chips) 
Seat 4: sambupkr (€2.33 in chips) 
Seat 5: tanoun1 (€2.08 in chips) 
Seat 6: PkBcN15 (€2 in chips) 
marcdevil: posts small blind €0.01
WJSP: posts big blind €0.02
*** HOLE CARDS ***
Dealt to pipinoelbreve9 [7c Qs]
sambupkr: folds 
tanoun1: raises €0.03 to €0.05
PkBcN15: folds 
pipinoelbreve9: folds 
marcdevil: folds 
WJSP: folds 
Uncalled bet (€0.03) returned to tanoun1
tanoun1 collected €0.05 from pot
tanoun1: doesn't show hand 
*** SUMMARY ***
Total pot €0.05 | Rake €0 
Seat 1: pipinoelbreve9 (button) folded before Flop (didn't bet)
Seat 2: marcdevil (small blind) folded before Flop
Seat 3: WJSP (big blind) folded before Flop
Seat 4: sambupkr folded before Flop (didn't bet)
Seat 5: tanoun1 collected (€0.05)
Seat 6: PkBcN15 folded before Flop (didn't bet)



PokerStars Zoom Hand #257562629572:  Hold'em No Limit (€0.01/€0.02) - 2025/08/31 22:22:45 CET [2025/08/31 16:22:45 ET]
Table 'Arneb' 6-max Seat #1 is the button
Seat 1: Fr@nkys (€2 in chips) 
Seat 2: felgas1968 (€1.76 in chips) 
Seat 3: nyko2a (€3.21 in chips) 
Seat 4: pipinoelbreve9 (€2.37 in chips) 
Seat 5: rare12345 (€2.36 in chips) 
Seat 6: POÇAOMAGICA (€2.96 in chips) 
felgas1968: posts small blind €0.01
nyko2a: posts big blind €0.02
*** HOLE CARDS ***
Dealt to pipinoelbreve9 [Ts 6h]
pipinoelbreve9: folds 
rare12345: raises €0.03 to €0.05
POÇAOMAGICA: folds 
Fr@nkys: folds 
felgas1968: folds 
nyko2a: folds 
Uncalled bet (€0.03) returned to rare12345
rare12345 collected €0.05 from pot
rare12345: doesn't show hand 
*** SUMMARY ***
Total pot €0.05 | Rake €0 
Seat 1: Fr@nkys (button) folded before Flop (didn't bet)
Seat 2: felgas1968 (small blind) folded before Flop
Seat 3: nyko2a (big blind) folded before Flop
Seat 4: pipinoelbreve9 folded before Flop (didn't bet)
Seat 5: rare12345 collected (€0.05)
Seat 6: POÇAOMAGICA folded before Flop (didn't bet)



PokerStars Zoom Hand #257562630562:  Hold'em No Limit (€0.01/€0.02) - 2025/08/31 22:22:48 CET [2025/08/31 16:22:48 ET]
Table 'Arneb' 6-max Seat #1 is the button
Seat 1: Fr@nkys (€2.13 in chips) 
Seat 2: WJSP (€2 in chips) 
Seat 3: tanoun1 (€2 in chips) 
Seat 4: ernest384 (€2.09 in chips) 
Seat 5: pipinoelbreve9 (€2.37 in chips) 
Seat 6: sambupkr (€2.32 in chips) 
WJSP: posts small blind €0.01
tanoun1: posts big blind €0.02
*** HOLE CARDS ***
Dealt to pipinoelbreve9 [Qh 2c]
ernest384: calls €0.02
pipinoelbreve9: folds 
sambupkr: raises €0.04 to €0.06
Fr@nkys: folds 
WJSP: folds 
tanoun1: folds 
ernest384: calls €0.04
*** FLOP *** [Td 6c Qs]
ernest384: bets €0.06
sambupkr: raises €0.13 to €0.19
ernest384: calls €0.13
*** TURN *** [Td 6c Qs] [8c]
ernest384: checks 
sambupkr: bets €0.25
ernest384: folds 
Uncalled bet (€0.25) returned to sambupkr
sambupkr collected €0.50 from pot
sambupkr: doesn't show hand 
*** SUMMARY ***
Total pot €0.53 | Rake €0.03 
Board [Td 6c Qs 8c]
Seat 1: Fr@nkys (button) folded before Flop (didn't bet)
Seat 2: WJSP (small blind) folded before Flop
Seat 3: tanoun1 (big blind) folded before Flop
Seat 4: ernest384 folded on the Turn
Seat 5: pipinoelbreve9 folded before Flop (didn't bet)
Seat 6: sambupkr collected (€0.50)



PokerStars Zoom Hand #257562632453:  Hold'em No Limit (€0.01/€0.02) - 2025/08/31 22:22:54 CET [2025/08/31 16:22:54 ET]
Table 'Arneb' 6-max Seat #1 is the button
Seat 1: Lucasdechaux17 (€2.27 in chips) 
Seat 2: top101 (€2.81 in chips) 
Seat 3: pipinoelbreve9 (€2.37 in chips) 
Seat 4: PkBcN15 (€2.04 in chips) 
Seat 5: kremmel91 (€0.63 in chips) 
Seat 6: Jebahon (€1.48 in chips) 
top101: posts small blind €0.01
pipinoelbreve9: posts big blind €0.02
*** HOLE CARDS ***
Dealt to pipinoelbreve9 [5h 2h]
PkBcN15: folds 
kremmel91: folds 
Jebahon: raises €0.02 to €0.04
Lucasdechaux17: folds 
top101: calls €0.03
pipinoelbreve9: folds 
*** FLOP *** [Jh 3c Qd]
top101: checks 
Jebahon: bets €0.04
top101: calls €0.04
*** TURN *** [Jh 3c Qd] [7h]
top101: checks 
Jebahon: bets €0.06
top101: calls €0.06
*** RIVER *** [Jh 3c Qd 7h] [Th]
top101: checks 
Jebahon: checks 
*** SHOW DOWN ***
top101: shows [Td Ah] (a pair of Tens)
Jebahon: shows [As Js] (a pair of Jacks)
Jebahon collected €0.28 from pot
*** SUMMARY ***
Total pot €0.30 | Rake €0.02 
Board [Jh 3c Qd 7h Th]
Seat 1: Lucasdechaux17 (button) folded before Flop (didn't bet)
Seat 2: top101 (small blind) showed [Td Ah] and lost with a pair of Tens
Seat 3: pipinoelbreve9 (big blind) folded before Flop
Seat 4: PkBcN15 folded before Flop (didn't bet)
Seat 5: kremmel91 folded before Flop (didn't bet)
Seat 6: Jebahon showed [As Js] and won (€0.28) with a pair of Jacks



PokerStars Zoom Hand #257562638454:  Hold'em No Limit (€0.01/€0.02) - 2025/08/31 22:23:13 CET [2025/08/31 16:23:13 ET]
Table 'Arneb' 6-max Seat #1 is the button
Seat 1: POÇAOMAGICA (€2.14 in chips) 
Seat 2: pipinoelbreve9 (€2.35 in chips) 
Seat 3: eres_tontito (€2 in chips) 
Seat 4: tanoun1 (€2.10 in chips) 
Seat 5: NEMOXYX (€5.57 in chips) 
Seat 6: hyperion570 (€0.97 in chips) 
pipinoelbreve9: posts small blind €0.01
eres_tontito: posts big blind €0.02
*** HOLE CARDS ***
Dealt to pipinoelbreve9 [Qd Ah]
tanoun1: folds 
NEMOXYX: raises €0.04 to €0.06
hyperion570: folds 
POÇAOMAGICA: folds 
pipinoelbreve9: raises €0.14 to €0.20
eres_tontito: folds 
NEMOXYX: folds 
Uncalled bet (€0.14) returned to pipinoelbreve9
pipinoelbreve9 collected €0.14 from pot
pipinoelbreve9: doesn't show hand 
*** SUMMARY ***
Total pot €0.14 | Rake €0 
Seat 1: POÇAOMAGICA (button) folded before Flop (didn't bet)
Seat 2: pipinoelbreve9 (small blind) collected (€0.14)
Seat 3: eres_tontito (big blind) folded before Flop
Seat 4: tanoun1 folded before Flop (didn't bet)
Seat 5: NEMOXYX folded before Flop
Seat 6: hyperion570 folded before Flop (didn't bet)



PokerStars Zoom Hand #257562636599:  Hold'em No Limit (€0.01/€0.02) - 2025/08/31 22:23:07 CET [2025/08/31 16:23:07 ET]
Table 'Arneb' 6-max Seat #1 is the button
Seat 1: WJSP (€2 in chips) 
Seat 2: Chichoampuero12 (€5.27 in chips) 
Seat 3: eres_tontito (€2 in chips) 
Seat 4: pipinoelbreve9 (€2.35 in chips) 
Seat 5: Fr@nkys (€2.25 in chips) 
Seat 6: felgas1968 (€3.10 in chips) 
Chichoampuero12: posts small blind €0.01
eres_tontito: posts big blind €0.02
*** HOLE CARDS ***
Dealt to pipinoelbreve9 [6c Ts]
pipinoelbreve9: folds 
Fr@nkys: folds 
felgas1968: folds 
WJSP: folds 
Chichoampuero12: raises €0.04 to €0.06
eres_tontito: calls €0.04
*** FLOP *** [Js Ks 9h]
Chichoampuero12: checks 
eres_tontito: bets €0.09
Chichoampuero12: folds 
Uncalled bet (€0.09) returned to eres_tontito
eres_tontito collected €0.11 from pot
eres_tontito: doesn't show hand 
*** SUMMARY ***
Total pot €0.12 | Rake €0.01 
Board [Js Ks 9h]
Seat 1: WJSP (button) folded before Flop (didn't bet)
Seat 2: Chichoampuero12 (small blind) folded on the Flop
Seat 3: eres_tontito (big blind) collected (€0.11)
Seat 4: pipinoelbreve9 folded before Flop (didn't bet)
Seat 5: Fr@nkys folded before Flop (didn't bet)
Seat 6: felgas1968 folded before Flop (didn't bet)



PokerStars Zoom Hand #257562628306:  Hold'em No Limit (€0.01/€0.02) - 2025/08/31 22:22:41 CET [2025/08/31 16:22:41 ET]
Table 'Arneb' 6-max Seat #1 is the button
Seat 1: PkBcN15 (€2 in chips) 
Seat 2: CASCALE$ (€1.72 in chips) 
Seat 3: Xoseanro510 (€2 in chips) 
Seat 4: rare12345 (€2.36 in chips) 
Seat 5: pipinoelbreve9 (€2.37 in chips) 
Seat 6: kurtconlei14 (€2 in chips) 
CASCALE$: posts small blind €0.01
Xoseanro510: posts big blind €0.02
*** HOLE CARDS ***
Dealt to pipinoelbreve9 [5s 7h]
rare12345: folds 
pipinoelbreve9: folds 
kurtconlei14: raises €0.04 to €0.06
PkBcN15: folds 
CASCALE$: calls €0.05
Xoseanro510: calls €0.04
*** FLOP *** [8h 9h Qc]
CASCALE$: checks 
Xoseanro510: checks 
kurtconlei14: bets €0.09
CASCALE$: folds 
Xoseanro510: folds 
Uncalled bet (€0.09) returned to kurtconlei14
kurtconlei14 collected €0.17 from pot
kurtconlei14: doesn't show hand 
*** SUMMARY ***
Total pot €0.18 | Rake €0.01 
Board [8h 9h Qc]
Seat 1: PkBcN15 (button) folded before Flop (didn't bet)
Seat 2: CASCALE$ (small blind) folded on the Flop
Seat 3: Xoseanro510 (big blind) folded on the Flop
Seat 4: rare12345 folded before Flop (didn't bet)
Seat 5: pipinoelbreve9 folded before Flop (didn't bet)
Seat 6: kurtconlei14 collected (€0.17)



PokerStars Zoom Hand #257562646481:  Hold'em No Limit (€0.01/€0.02) - 2025/08/31 22:23:39 CET [2025/08/31 16:23:39 ET]
Table 'Arneb' 6-max Seat #1 is the button
Seat 1: top101 (€2.67 in chips) 
Seat 2: WJSP (€2 in chips) 
Seat 3: 34pluto (€1.83 in chips) 
Seat 4: marcdevil (€2.54 in chips) 
Seat 5: felgas1968 (€3.09 in chips) 
Seat 6: pipinoelbreve9 (€2.43 in chips) 
WJSP: posts small blind €0.01
34pluto: posts big blind €0.02
*** HOLE CARDS ***
Dealt to pipinoelbreve9 [5h Ad]
marcdevil: folds 
felgas1968: folds 
pipinoelbreve9: folds 
top101: folds 
WJSP: folds 
Uncalled bet (€0.01) returned to 34pluto
34pluto collected €0.02 from pot
34pluto: doesn't show hand 
*** SUMMARY ***
Total pot €0.02 | Rake €0 
Seat 1: top101 (button) folded before Flop (didn't bet)
Seat 2: WJSP (small blind) folded before Flop
Seat 3: 34pluto (big blind) collected (€0.02)
Seat 4: marcdevil folded before Flop (didn't bet)
Seat 5: felgas1968 folded before Flop (didn't bet)
Seat 6: pipinoelbreve9 folded before Flop (didn't bet)



PokerStars Zoom Hand #257562649680:  Hold'em No Limit (€0.01/€0.02) - 2025/08/31 22:23:49 CET [2025/08/31 16:23:49 ET]
Table 'Arneb' 6-max Seat #1 is the button
Seat 1: pipinoelbreve9 (€2.43 in chips) 
Seat 2: felgas1968 (€2.24 in chips) 
Seat 3: tanoun1 (€2 in chips) 
Seat 4: POÇAOMAGICA (€3.88 in chips) 
Seat 5: top101 (€2.67 in chips) 
Seat 6: ecuinas (€1.67 in chips) 
felgas1968: posts small blind €0.01
tanoun1: posts big blind €0.02
*** HOLE CARDS ***
Dealt to pipinoelbreve9 [Jd As]
POÇAOMAGICA: folds 
top101: raises €0.02 to €0.04
ecuinas: folds 
pipinoelbreve9: raises €0.12 to €0.16
felgas1968: folds 
tanoun1: folds 
top101: calls €0.12
*** FLOP *** [5h Qd Js]
top101: checks 
pipinoelbreve9: bets €0.17
top101: folds 
Uncalled bet (€0.17) returned to pipinoelbreve9
pipinoelbreve9 collected €0.33 from pot
pipinoelbreve9: doesn't show hand 
*** SUMMARY ***
Total pot €0.35 | Rake €0.02 
Board [5h Qd Js]
Seat 1: pipinoelbreve9 (button) collected (€0.33)
Seat 2: felgas1968 (small blind) folded before Flop
Seat 3: tanoun1 (big blind) folded before Flop
Seat 4: POÇAOMAGICA folded before Flop (didn't bet)
Seat 5: top101 folded on the Flop
Seat 6: ecuinas folded before Flop (didn't bet)



PokerStars Zoom Hand #257562659581:  Hold'em No Limit (€0.01/€0.02) - 2025/08/31 22:24:20 CET [2025/08/31 16:24:20 ET]
Table 'Arneb' 6-max Seat #1 is the button
Seat 1: sambupkr (€2.54 in chips) 
Seat 2: NEMOXYX (€5.52 in chips) 
Seat 3: Lumifer (€2.42 in chips) 
Seat 4: pipinoelbreve9 (€2.60 in chips) 
Seat 5: WJSP (€2.01 in chips) 
Seat 6: 34pluto (€1.13 in chips) 
NEMOXYX: posts small blind €0.01
Lumifer: posts big blind €0.02
*** HOLE CARDS ***
Dealt to pipinoelbreve9 [9d Ts]
pipinoelbreve9: folds 
WJSP: folds 
34pluto: folds 
sambupkr: raises €0.04 to €0.06
NEMOXYX: raises €0.14 to €0.20
Lumifer: folds 
sambupkr: folds 
Uncalled bet (€0.14) returned to NEMOXYX
NEMOXYX collected €0.14 from pot
NEMOXYX: doesn't show hand 
*** SUMMARY ***
Total pot €0.14 | Rake €0 
Seat 1: sambupkr (button) folded before Flop
Seat 2: NEMOXYX (small blind) collected (€0.14)
Seat 3: Lumifer (big blind) folded before Flop
Seat 4: pipinoelbreve9 folded before Flop (didn't bet)
Seat 5: WJSP folded before Flop (didn't bet)
Seat 6: 34pluto folded before Flop (didn't bet)



PokerStars Zoom Hand #257562661913:  Hold'em No Limit (€0.01/€0.02) - 2025/08/31 22:24:27 CET [2025/08/31 16:24:27 ET]
Table 'Arneb' 6-max Seat #1 is the button
Seat 1: Chicogas7 (€0.44 in chips) 
Seat 2: top101 (€2.51 in chips) 
Seat 3: pipinoelbreve9 (€2.60 in chips) 
Seat 4: WJSP (€2.01 in chips) 
Seat 5: ecuinas (€1.65 in chips) 
Seat 6: nyko2a (€3.11 in chips) 
top101: posts small blind €0.01
pipinoelbreve9: posts big blind €0.02
*** HOLE CARDS ***
Dealt to pipinoelbreve9 [7d 3d]
WJSP: folds 
ecuinas: folds 
nyko2a: folds 
Chicogas7: raises €0.04 to €0.06
top101: calls €0.05
pipinoelbreve9: folds 
*** FLOP *** [Jd 7h 9d]
top101: checks 
Chicogas7: bets €0.02
top101: folds 
Uncalled bet (€0.02) returned to Chicogas7
Chicogas7 collected €0.13 from pot
Chicogas7: doesn't show hand 
*** SUMMARY ***
Total pot €0.14 | Rake €0.01 
Board [Jd 7h 9d]
Seat 1: Chicogas7 (button) collected (€0.13)
Seat 2: top101 (small blind) folded on the Flop
Seat 3: pipinoelbreve9 (big blind) folded before Flop
Seat 4: WJSP folded before Flop (didn't bet)
Seat 5: ecuinas folded before Flop (didn't bet)
Seat 6: nyko2a folded before Flop (didn't bet)



PokerStars Zoom Hand #257562667054:  Hold'em No Limit (€0.01/€0.02) - 2025/08/31 22:24:43 CET [2025/08/31 16:24:43 ET]
Table 'Arneb' 6-max Seat #1 is the button
Seat 1: pipinoelbreve9 (€2.57 in chips) 
Seat 2: Chichoampuero12 (€2 in chips) 
Seat 3: ana paula900 (€1.44 in chips) 
Seat 4: 34pluto (€1.22 in chips) 
Seat 5: NEMOXYX (€5.60 in chips) 
Seat 6: felgas1968 (€1.65 in chips) 
Chichoampuero12: posts small blind €0.01
ana paula900: posts big blind €0.02
*** HOLE CARDS ***
Dealt to pipinoelbreve9 [Ks 2h]
34pluto: folds 
NEMOXYX: folds 
felgas1968: folds 
pipinoelbreve9: folds 
Chichoampuero12: folds 
Uncalled bet (€0.01) returned to ana paula900
ana paula900 collected €0.02 from pot
ana paula900: doesn't show hand 
*** SUMMARY ***
Total pot €0.02 | Rake €0 
Seat 1: pipinoelbreve9 (button) folded before Flop (didn't bet)
Seat 2: Chichoampuero12 (small blind) folded before Flop
Seat 3: ana paula900 (big blind) collected (€0.02)
Seat 4: 34pluto folded before Flop (didn't bet)
Seat 5: NEMOXYX folded before Flop (didn't bet)
Seat 6: felgas1968 folded before Flop (didn't bet)



PokerStars Zoom Hand #257562668516:  Hold'em No Limit (€0.01/€0.02) - 2025/08/31 22:24:47 CET [2025/08/31 16:24:47 ET]
Table 'Arneb' 6-max Seat #1 is the button
Seat 1: CASCALE$ (€1.63 in chips) 
Seat 2: MiguelMJ96 (€0.58 in chips) 
Seat 3: Ujfalusi87 (€3.05 in chips) 
Seat 4: ernest384 (€1.95 in chips) 
Seat 5: pipinoelbreve9 (€2.57 in chips) 
Seat 6: Chichoampuero12 (€2 in chips) 
MiguelMJ96: posts small blind €0.01
Ujfalusi87: posts big blind €0.02
*** HOLE CARDS ***
Dealt to pipinoelbreve9 [6c 2h]
ernest384: folds 
pipinoelbreve9: folds 
Chichoampuero12: raises €0.03 to €0.05
CASCALE$: folds 
MiguelMJ96: raises €0.03 to €0.08
Ujfalusi87: folds 
Chichoampuero12: calls €0.03
*** FLOP *** [3c 3d 9h]
MiguelMJ96: bets €0.50 and is all-in
Chichoampuero12: folds 
Uncalled bet (€0.50) returned to MiguelMJ96
MiguelMJ96 collected €0.17 from pot
MiguelMJ96: doesn't show hand 
*** SUMMARY ***
Total pot €0.18 | Rake €0.01 
Board [3c 3d 9h]
Seat 1: CASCALE$ (button) folded before Flop (didn't bet)
Seat 2: MiguelMJ96 (small blind) collected (€0.17)
Seat 3: Ujfalusi87 (big blind) folded before Flop
Seat 4: ernest384 folded before Flop (didn't bet)
Seat 5: pipinoelbreve9 folded before Flop (didn't bet)
Seat 6: Chichoampuero12 folded on the Flop



PokerStars Zoom Hand #257562665420:  Hold'em No Limit (€0.01/€0.02) - 2025/08/31 22:24:38 CET [2025/08/31 16:24:38 ET]
Table 'Arneb' 6-max Seat #1 is the button
Seat 1: WJSP (€2 in chips) 
Seat 2: pipinoelbreve9 (€2.58 in chips) 
Seat 3: maximus_powah (€2 in chips) 
Seat 4: PkBcN15 (€2 in chips) 
Seat 5: Fr@nkys (€2.53 in chips) 
Seat 6: ana paula900 (€1.44 in chips) 
pipinoelbreve9: posts small blind €0.01
maximus_powah: posts big blind €0.02
*** HOLE CARDS ***
Dealt to pipinoelbreve9 [Tc 7h]
PkBcN15: folds 
Fr@nkys: folds 
ana paula900: folds 
WJSP: raises €0.02 to €0.04
pipinoelbreve9: folds 
maximus_powah: calls €0.02
*** FLOP *** [Td 9s Qs]
maximus_powah: checks 
WJSP: checks 
*** TURN *** [Td 9s Qs] [8s]
maximus_powah: checks 
WJSP: checks 
*** RIVER *** [Td 9s Qs 8s] [Qc]
maximus_powah: checks 
WJSP: checks 
*** SHOW DOWN ***
maximus_powah: shows [5h 5c] (two pair, Queens and Fives)
WJSP: shows [6h 6d] (two pair, Queens and Sixes)
WJSP collected €0.09 from pot
*** SUMMARY ***
Total pot €0.09 | Rake €0 
Board [Td 9s Qs 8s Qc]
Seat 1: WJSP (button) showed [6h 6d] and won (€0.09) with two pair, Queens and Sixes
Seat 2: pipinoelbreve9 (small blind) folded before Flop
Seat 3: maximus_powah (big blind) showed [5h 5c] and lost with two pair, Queens and Fives
Seat 4: PkBcN15 folded before Flop (didn't bet)
Seat 5: Fr@nkys folded before Flop (didn't bet)
Seat 6: ana paula900 folded before Flop (didn't bet)



PokerStars Zoom Hand #257562671805:  Hold'em No Limit (€0.01/€0.02) - 2025/08/31 22:24:58 CET [2025/08/31 16:24:58 ET]
Table 'Arneb' 6-max Seat #1 is the button
Seat 1: ana paula900 (€1.45 in chips) 
Seat 2: Ujfalusi87 (€3.03 in chips) 
Seat 3: pipinoelbreve9 (€2.57 in chips) 
Seat 4: MeRorschach (€2.04 in chips) 
Seat 5: Chicogas7 (€0.51 in chips) 
Seat 6: sonnyblaks (€1.46 in chips) 
Ujfalusi87: posts small blind €0.01
pipinoelbreve9: posts big blind €0.02
*** HOLE CARDS ***
Dealt to pipinoelbreve9 [9d Ac]
MeRorschach: folds 
Chicogas7: folds 
sonnyblaks: calls €0.02
ana paula900: folds 
Ujfalusi87: calls €0.01
pipinoelbreve9: checks 
*** FLOP *** [4d 2h Th]
Ujfalusi87: checks 
pipinoelbreve9: checks 
sonnyblaks: checks 
*** TURN *** [4d 2h Th] [Qs]
Ujfalusi87: checks 
pipinoelbreve9: checks 
sonnyblaks: bets €1.44 and is all-in
Ujfalusi87: folds 
pipinoelbreve9: folds 
Uncalled bet (€1.44) returned to sonnyblaks
sonnyblaks collected €0.06 from pot
sonnyblaks: doesn't show hand 
*** SUMMARY ***
Total pot €0.06 | Rake €0 
Board [4d 2h Th Qs]
Seat 1: ana paula900 (button) folded before Flop (didn't bet)
Seat 2: Ujfalusi87 (small blind) folded on the Turn
Seat 3: pipinoelbreve9 (big blind) folded on the Turn
Seat 4: MeRorschach folded before Flop (didn't bet)
Seat 5: Chicogas7 folded before Flop (didn't bet)
Seat 6: sonnyblaks collected (€0.06)



PokerStars Zoom Hand #257562688870:  Hold'em No Limit (€0.01/€0.02) - 2025/08/31 22:25:52 CET [2025/08/31 16:25:52 ET]
Table 'Arneb' 6-max Seat #1 is the button
Seat 1: Lumifer (€2.84 in chips) 
Seat 2: sambupkr (€2.36 in chips) 
Seat 3: galispin (€2.61 in chips) 
Seat 4: RCSA2 (€2.14 in chips) 
Seat 5: sanpistakio (€1.88 in chips) 
Seat 6: pipinoelbreve9 (€2.55 in chips) 
sambupkr: posts small blind €0.01
galispin: posts big blind €0.02
*** HOLE CARDS ***
Dealt to pipinoelbreve9 [8d 7h]
RCSA2: raises €0.14 to €0.16
sanpistakio: calls €0.16
pipinoelbreve9: folds 
Lumifer: folds 
sambupkr: folds 
galispin: folds 
*** FLOP *** [Ad 5d 5s]
RCSA2: bets €0.17
sanpistakio: folds 
Uncalled bet (€0.17) returned to RCSA2
RCSA2 collected €0.33 from pot
RCSA2: doesn't show hand 
*** SUMMARY ***
Total pot €0.35 | Rake €0.02 
Board [Ad 5d 5s]
Seat 1: Lumifer (button) folded before Flop (didn't bet)
Seat 2: sambupkr (small blind) folded before Flop
Seat 3: galispin (big blind) folded before Flop
Seat 4: RCSA2 collected (€0.33)
Seat 5: sanpistakio folded on the Flop
Seat 6: pipinoelbreve9 folded before Flop (didn't bet)



PokerStars Zoom Hand #257562693099:  Hold'em No Limit (€0.01/€0.02) - 2025/08/31 22:26:05 CET [2025/08/31 16:26:05 ET]
Table 'Arneb' 6-max Seat #1 is the button
Seat 1: sambupkr (€2.48 in chips) 
Seat 2: Chichoampuero12 (€2 in chips) 
Seat 3: POÇAOMAGICA (€2 in chips) 
Seat 4: pipinoelbreve9 (€2.55 in chips) 
Seat 5: Bestiote (€0.92 in chips) 
Seat 6: AleactaEst21 (€2.13 in chips) 
Chichoampuero12: posts small blind €0.01
POÇAOMAGICA: posts big blind €0.02
*** HOLE CARDS ***
Dealt to pipinoelbreve9 [Ts Qh]
pipinoelbreve9: folds 
Bestiote: folds 
AleactaEst21: folds 
sambupkr: folds 
Chichoampuero12: folds 
Uncalled bet (€0.01) returned to POÇAOMAGICA
POÇAOMAGICA collected €0.02 from pot
POÇAOMAGICA: doesn't show hand 
*** SUMMARY ***
Total pot €0.02 | Rake €0 
Seat 1: sambupkr (button) folded before Flop (didn't bet)
Seat 2: Chichoampuero12 (small blind) folded before Flop
Seat 3: POÇAOMAGICA (big blind) collected (€0.02)
Seat 4: pipinoelbreve9 folded before Flop (didn't bet)
Seat 5: Bestiote folded before Flop (didn't bet)
Seat 6: AleactaEst21 folded before Flop (didn't bet)



PokerStars Zoom Hand #257562694706:  Hold'em No Limit (€0.01/€0.02) - 2025/08/31 22:26:10 CET [2025/08/31 16:26:10 ET]
Table 'Arneb' 6-max Seat #1 is the button
Seat 1: felgas1968 (€2.45 in chips) 
Seat 2: castiego2 (€2.11 in chips) 
Seat 3: Ujfalusi87 (€3.04 in chips) 
Seat 4: Lucasdechaux17 (€2.48 in chips) 
Seat 5: pipinoelbreve9 (€2.55 in chips) 
Seat 6: NEMOXYX (€3.30 in chips) 
castiego2: posts small blind €0.01
Ujfalusi87: posts big blind €0.02
*** HOLE CARDS ***
Dealt to pipinoelbreve9 [8c Ad]
Lucasdechaux17: folds 
pipinoelbreve9: folds 
NEMOXYX: raises €0.04 to €0.06
felgas1968: calls €0.06
castiego2: folds 
Ujfalusi87: folds 
*** FLOP *** [Kd 7s Th]
NEMOXYX: checks 
felgas1968: bets €0.07
NEMOXYX: folds 
Uncalled bet (€0.07) returned to felgas1968
felgas1968 collected €0.14 from pot
felgas1968: doesn't show hand 
*** SUMMARY ***
Total pot €0.15 | Rake €0.01 
Board [Kd 7s Th]
Seat 1: felgas1968 (button) collected (€0.14)
Seat 2: castiego2 (small blind) folded before Flop
Seat 3: Ujfalusi87 (big blind) folded before Flop
Seat 4: Lucasdechaux17 folded before Flop (didn't bet)
Seat 5: pipinoelbreve9 folded before Flop (didn't bet)
Seat 6: NEMOXYX folded on the Flop



PokerStars Zoom Hand #257562696923:  Hold'em No Limit (€0.01/€0.02) - 2025/08/31 22:26:17 CET [2025/08/31 16:26:17 ET]
Table 'Arneb' 6-max Seat #1 is the button
Seat 1: RCSA2 (€2.24 in chips) 
Seat 2: pipinoelbreve9 (€2.55 in chips) 
Seat 3: 34pluto (€1.07 in chips) 
Seat 4: rare12345 (€2.18 in chips) 
Seat 5: sanpistakio (€1.72 in chips) 
Seat 6: galispin (€2.58 in chips) 
pipinoelbreve9: posts small blind €0.01
34pluto: posts big blind €0.02
*** HOLE CARDS ***
Dealt to pipinoelbreve9 [Th 7h]
rare12345: folds 
sanpistakio: calls €0.02
galispin: folds 
RCSA2: folds 
pipinoelbreve9: calls €0.01
34pluto: checks 
*** FLOP *** [8h Ts 3s]
pipinoelbreve9: bets €0.03
34pluto: folds 
sanpistakio: folds 
Uncalled bet (€0.03) returned to pipinoelbreve9
pipinoelbreve9 collected €0.06 from pot
pipinoelbreve9: doesn't show hand 
*** SUMMARY ***
Total pot €0.06 | Rake €0 
Board [8h Ts 3s]
Seat 1: RCSA2 (button) folded before Flop (didn't bet)
Seat 2: pipinoelbreve9 (small blind) collected (€0.06)
Seat 3: 34pluto (big blind) folded on the Flop
Seat 4: rare12345 folded before Flop (didn't bet)
Seat 5: sanpistakio folded on the Flop
Seat 6: galispin folded before Flop (didn't bet)



PokerStars Zoom Hand #257562709366:  Hold'em No Limit (€0.01/€0.02) - 2025/08/31 22:26:56 CET [2025/08/31 16:26:56 ET]
Table 'Arneb' 6-max Seat #1 is the button
Seat 1: pipinoelbreve9 (€2.59 in chips) 
Seat 2: wilbor123 (€4.59 in chips) 
Seat 3: sanpistakio (€1.70 in chips) 
Seat 4: NEMOXYX (€3.27 in chips) 
Seat 5: castiego2 (€2.10 in chips) 
Seat 6: bokanegraa (€0.54 in chips) 
wilbor123: posts small blind €0.01
sanpistakio: posts big blind €0.02
*** HOLE CARDS ***
Dealt to pipinoelbreve9 [4s 5d]
NEMOXYX: raises €0.04 to €0.06
castiego2: folds 
bokanegraa: folds 
pipinoelbreve9: folds 
wilbor123: folds 
sanpistakio: folds 
Uncalled bet (€0.04) returned to NEMOXYX
NEMOXYX collected €0.05 from pot
NEMOXYX: doesn't show hand 
*** SUMMARY ***
Total pot €0.05 | Rake €0 
Seat 1: pipinoelbreve9 (button) folded before Flop (didn't bet)
Seat 2: wilbor123 (small blind) folded before Flop
Seat 3: sanpistakio (big blind) folded before Flop
Seat 4: NEMOXYX collected (€0.05)
Seat 5: castiego2 folded before Flop (didn't bet)
Seat 6: bokanegraa folded before Flop (didn't bet)



PokerStars Zoom Hand #257562712913:  Hold'em No Limit (€0.01/€0.02) - 2025/08/31 22:27:07 CET [2025/08/31 16:27:07 ET]
Table 'Arneb' 6-max Seat #1 is the button
Seat 1: sanpistakio (€1.67 in chips) 
Seat 2: 34pluto (€1.05 in chips) 
Seat 3: pipinoelbreve9 (€2.59 in chips) 
Seat 4: Pepita71 (€4.86 in chips) 
Seat 5: wilbor123 (€4.58 in chips) 
Seat 6: kurtconlei14 (€1.79 in chips) 
34pluto: posts small blind €0.01
pipinoelbreve9: posts big blind €0.02
*** HOLE CARDS ***
Dealt to pipinoelbreve9 [7c Jd]
Pepita71: raises €0.02 to €0.04
wilbor123: folds 
kurtconlei14: folds 
sanpistakio: folds 
34pluto: folds 
pipinoelbreve9: folds 
Uncalled bet (€0.02) returned to Pepita71
Pepita71 collected €0.05 from pot
Pepita71: doesn't show hand 
*** SUMMARY ***
Total pot €0.05 | Rake €0 
Seat 1: sanpistakio (button) folded before Flop (didn't bet)
Seat 2: 34pluto (small blind) folded before Flop
Seat 3: pipinoelbreve9 (big blind) folded before Flop
Seat 4: Pepita71 collected (€0.05)
Seat 5: wilbor123 folded before Flop (didn't bet)
Seat 6: kurtconlei14 folded before Flop (didn't bet)



PokerStars Zoom Hand #257562717733:  Hold'em No Limit (€0.01/€0.02) - 2025/08/31 22:27:22 CET [2025/08/31 16:27:22 ET]
Table 'Arneb' 6-max Seat #1 is the button
Seat 1: castiego2 (€2.02 in chips) 
Seat 2: WJSP (€2.16 in chips) 
Seat 3: kurtconlei14 (€1.78 in chips) 
Seat 4: PkBcN15 (€2 in chips) 
Seat 5: Arrantzale46 (€2.36 in chips) 
Seat 6: pipinoelbreve9 (€2.57 in chips) 
WJSP: posts small blind €0.01
kurtconlei14: posts big blind €0.02
*** HOLE CARDS ***
Dealt to pipinoelbreve9 [2s Ks]
PkBcN15: folds 
Arrantzale46: folds 
pipinoelbreve9: folds 
castiego2: raises €0.02 to €0.04
WJSP: folds 
kurtconlei14: folds 
Uncalled bet (€0.02) returned to castiego2
castiego2 collected €0.05 from pot
castiego2: doesn't show hand 
*** SUMMARY ***
Total pot €0.05 | Rake €0 
Seat 1: castiego2 (button) collected (€0.05)
Seat 2: WJSP (small blind) folded before Flop
Seat 3: kurtconlei14 (big blind) folded before Flop
Seat 4: PkBcN15 folded before Flop (didn't bet)
Seat 5: Arrantzale46 folded before Flop (didn't bet)
Seat 6: pipinoelbreve9 folded before Flop (didn't bet)



PokerStars Zoom Hand #257562711296:  Hold'em No Limit (€0.01/€0.02) - 2025/08/31 22:27:02 CET [2025/08/31 16:27:02 ET]
Table 'Arneb' 6-max Seat #1 is the button
Seat 1: Chichoampuero12 (€2 in chips) 
Seat 2: felgas1968 (€1.84 in chips) 
Seat 3: KillVerlaine (€2.15 in chips) 
Seat 4: pipinoelbreve9 (€2.59 in chips) 
Seat 5: MiguelMJ96 (€0.16 in chips) 
Seat 6: 34pluto (€1.16 in chips) 
felgas1968: posts small blind €0.01
KillVerlaine: posts big blind €0.02
*** HOLE CARDS ***
Dealt to pipinoelbreve9 [9d Jc]
pipinoelbreve9: folds 
MiguelMJ96: folds 
34pluto: folds 
Chichoampuero12: raises €0.04 to €0.06
felgas1968: calls €0.05
KillVerlaine: calls €0.04
*** FLOP *** [Ts 2h 6d]
felgas1968: checks 
KillVerlaine: bets €0.12
Chichoampuero12: folds 
felgas1968: folds 
Uncalled bet (€0.12) returned to KillVerlaine
KillVerlaine collected €0.17 from pot
KillVerlaine: doesn't show hand 
*** SUMMARY ***
Total pot €0.18 | Rake €0.01 
Board [Ts 2h 6d]
Seat 1: Chichoampuero12 (button) folded on the Flop
Seat 2: felgas1968 (small blind) folded on the Flop
Seat 3: KillVerlaine (big blind) collected (€0.17)
Seat 4: pipinoelbreve9 folded before Flop (didn't bet)
Seat 5: MiguelMJ96 folded before Flop (didn't bet)
Seat 6: 34pluto folded before Flop (didn't bet)



PokerStars Zoom Hand #257562721871:  Hold'em No Limit (€0.01/€0.02) - 2025/08/31 22:27:36 CET [2025/08/31 16:27:36 ET]
Table 'Arneb' 6-max Seat #1 is the button
Seat 1: ana paula900 (€1.78 in chips) 
Seat 2: NEMOXYX (€5.31 in chips) 
Seat 3: POÇAOMAGICA (€2.76 in chips) 
Seat 4: WJSP (€2 in chips) 
Seat 5: pipinoelbreve9 (€2.57 in chips) 
Seat 6: castiego2 (€1.76 in chips) 
NEMOXYX: posts small blind €0.01
POÇAOMAGICA: posts big blind €0.02
*** HOLE CARDS ***
Dealt to pipinoelbreve9 [9s Ad]
WJSP: folds 
pipinoelbreve9: folds 
castiego2: folds 
ana paula900: folds 
NEMOXYX: folds 
Uncalled bet (€0.01) returned to POÇAOMAGICA
POÇAOMAGICA collected €0.02 from pot
POÇAOMAGICA: doesn't show hand 
*** SUMMARY ***
Total pot €0.02 | Rake €0 
Seat 1: ana paula900 (button) folded before Flop (didn't bet)
Seat 2: NEMOXYX (small blind) folded before Flop
Seat 3: POÇAOMAGICA (big blind) collected (€0.02)
Seat 4: WJSP folded before Flop (didn't bet)
Seat 5: pipinoelbreve9 folded before Flop (didn't bet)
Seat 6: castiego2 folded before Flop (didn't bet)



PokerStars Zoom Hand #257562724114:  Hold'em No Limit (€0.01/€0.02) - 2025/08/31 22:27:42 CET [2025/08/31 16:27:42 ET]
Table 'Arneb' 6-max Seat #1 is the button
Seat 1: pipinoelbreve9 (€2.57 in chips) 
Seat 2: CheckMate1346 (€2 in chips) 
Seat 3: tanoun1 (€2.15 in chips) 
Seat 4: Fulcrumm (€1.59 in chips) 
Seat 5: CASCALE$ (€1.49 in chips) 
Seat 6: ana paula900 (€1.78 in chips) 
CheckMate1346: posts small blind €0.01
tanoun1: posts big blind €0.02
*** HOLE CARDS ***
Dealt to pipinoelbreve9 [As 5h]
Fulcrumm: folds 
CASCALE$: calls €0.02
ana paula900: raises €0.07 to €0.09
pipinoelbreve9: folds 
CheckMate1346: folds 
tanoun1: folds 
CASCALE$: folds 
Uncalled bet (€0.07) returned to ana paula900
ana paula900 collected €0.07 from pot
ana paula900: doesn't show hand 
*** SUMMARY ***
Total pot €0.07 | Rake €0 
Seat 1: pipinoelbreve9 (button) folded before Flop (didn't bet)
Seat 2: CheckMate1346 (small blind) folded before Flop
Seat 3: tanoun1 (big blind) folded before Flop
Seat 4: Fulcrumm folded before Flop (didn't bet)
Seat 5: CASCALE$ folded before Flop
Seat 6: ana paula900 collected (€0.07)



PokerStars Zoom Hand #257562725618:  Hold'em No Limit (€0.01/€0.02) - 2025/08/31 22:27:48 CET [2025/08/31 16:27:48 ET]
Table 'Arneb' 6-max Seat #1 is the button
Seat 1: eres_tontito (€1.89 in chips) 
Seat 2: pipinoelbreve9 (€2.57 in chips) 
Seat 3: WJSP (€2.03 in chips) 
Seat 4: Lumifer (€2.53 in chips) 
Seat 5: kurtconlei14 (€1.76 in chips) 
Seat 6: maximus_powah (€1.44 in chips) 
pipinoelbreve9: posts small blind €0.01
WJSP: posts big blind €0.02
*** HOLE CARDS ***
Dealt to pipinoelbreve9 [Js 3d]
Lumifer: folds 
kurtconlei14: folds 
maximus_powah has timed out
maximus_powah: folds 
eres_tontito: folds 
pipinoelbreve9: folds 
Uncalled bet (€0.01) returned to WJSP
WJSP collected €0.02 from pot
WJSP: doesn't show hand 
*** SUMMARY ***
Total pot €0.02 | Rake €0 
Seat 1: eres_tontito (button) folded before Flop (didn't bet)
Seat 2: pipinoelbreve9 (small blind) folded before Flop
Seat 3: WJSP (big blind) collected (€0.02)
Seat 4: Lumifer folded before Flop (didn't bet)
Seat 5: kurtconlei14 folded before Flop (didn't bet)
Seat 6: maximus_powah folded before Flop (didn't bet)



PokerStars Zoom Hand #257562729102:  Hold'em No Limit (€0.01/€0.02) - 2025/08/31 22:27:59 CET [2025/08/31 16:27:59 ET]
Table 'Arneb' 6-max Seat #1 is the button
Seat 1: smoking9000 (€0.91 in chips) 
Seat 2: POÇAOMAGICA (€5.81 in chips) 
Seat 3: pipinoelbreve9 (€2.56 in chips) 
Seat 4: sanpistakio (€1.37 in chips) 
Seat 5: Phamtom123 (€0.97 in chips) 
Seat 6: castiego2 (€2.07 in chips) 
POÇAOMAGICA: posts small blind €0.01
pipinoelbreve9: posts big blind €0.02
*** HOLE CARDS ***
Dealt to pipinoelbreve9 [5d Js]
sanpistakio: folds 
Phamtom123: folds 
castiego2: raises €0.04 to €0.06
smoking9000: folds 
POÇAOMAGICA: folds 
pipinoelbreve9: folds 
Uncalled bet (€0.04) returned to castiego2
castiego2 collected €0.05 from pot
castiego2: doesn't show hand 
*** SUMMARY ***
Total pot €0.05 | Rake €0 
Seat 1: smoking9000 (button) folded before Flop (didn't bet)
Seat 2: POÇAOMAGICA (small blind) folded before Flop
Seat 3: pipinoelbreve9 (big blind) folded before Flop
Seat 4: sanpistakio folded before Flop (didn't bet)
Seat 5: Phamtom123 folded before Flop (didn't bet)
Seat 6: castiego2 collected (€0.05)



PokerStars Zoom Hand #257562726945:  Hold'em No Limit (€0.01/€0.02) - 2025/08/31 22:27:52 CET [2025/08/31 16:27:52 ET]
Table 'Arneb' 6-max Seat #1 is the button
Seat 1: Lucasdechaux17 (€2.35 in chips) 
Seat 2: bokanegraa (€0.63 in chips) 
Seat 3: finfin13205 (€0.96 in chips) 
Seat 4: pipinoelbreve9 (€2.56 in chips) 
Seat 5: sambupkr (€2.16 in chips) 
Seat 6: smoking9000 (€0.91 in chips) 
bokanegraa: posts small blind €0.01
finfin13205: posts big blind €0.02
*** HOLE CARDS ***
Dealt to pipinoelbreve9 [Kd 6c]
pipinoelbreve9: folds 
sambupkr: folds 
smoking9000: folds 
Lucasdechaux17: raises €0.03 to €0.05
bokanegraa: folds 
finfin13205: raises €0.91 to €0.96 and is all-in
Lucasdechaux17: calls €0.91
*** FLOP *** [6h 5s Tc]
*** TURN *** [6h 5s Tc] [8s]
*** RIVER *** [6h 5s Tc 8s] [7s]
*** SHOW DOWN ***
finfin13205: shows [Kh 4c] (a straight, Four to Eight)
Lucasdechaux17: shows [Ah Jd] (high card Ace)
finfin13205 collected €1.83 from pot
*** SUMMARY ***
Total pot €1.93 | Rake €0.10 
Board [6h 5s Tc 8s 7s]
Seat 1: Lucasdechaux17 (button) showed [Ah Jd] and lost with high card Ace
Seat 2: bokanegraa (small blind) folded before Flop
Seat 3: finfin13205 (big blind) showed [Kh 4c] and won (€1.83) with a straight, Four to Eight
Seat 4: pipinoelbreve9 folded before Flop (didn't bet)
Seat 5: sambupkr folded before Flop (didn't bet)
Seat 6: smoking9000 folded before Flop (didn't bet)



PokerStars Zoom Hand #257562732387:  Hold'em No Limit (€0.01/€0.02) - 2025/08/31 22:28:09 CET [2025/08/31 16:28:09 ET]
Table 'Arneb' 6-max Seat #1 is the button
Seat 1: jaqgarcia (€2 in chips) 
Seat 2: EiramSenpai (€1.98 in chips) 
Seat 3: CASCALE$ (€1.46 in chips) 
Seat 4: Fr@nkys (€2.14 in chips) 
Seat 5: castiego2 (€1.74 in chips) 
Seat 6: pipinoelbreve9 (€2.54 in chips) 
EiramSenpai: posts small blind €0.01
CASCALE$: posts big blind €0.02
*** HOLE CARDS ***
Dealt to pipinoelbreve9 [Ts Jh]
jaqgarcia is disconnected 
Fr@nkys: folds 
castiego2: folds 
pipinoelbreve9: raises €0.04 to €0.06
jaqgarcia has timed out while disconnected
jaqgarcia: folds 
EiramSenpai: folds 
CASCALE$: folds 
Uncalled bet (€0.04) returned to pipinoelbreve9
pipinoelbreve9 collected €0.05 from pot
pipinoelbreve9: doesn't show hand 
*** SUMMARY ***
Total pot €0.05 | Rake €0 
Seat 1: jaqgarcia (button) folded before Flop (didn't bet)
Seat 2: EiramSenpai (small blind) folded before Flop
Seat 3: CASCALE$ (big blind) folded before Flop
Seat 4: Fr@nkys folded before Flop (didn't bet)
Seat 5: castiego2 folded before Flop (didn't bet)
Seat 6: pipinoelbreve9 collected (€0.05)



PokerStars Zoom Hand #257562743718:  Hold'em No Limit (€0.01/€0.02) - 2025/08/31 22:28:44 CET [2025/08/31 16:28:44 ET]
Table 'Arneb' 6-max Seat #1 is the button
Seat 1: pipinoelbreve9 (€2.57 in chips) 
Seat 2: marcdevil (€2 in chips) 
Seat 3: wilbor123 (€4.88 in chips) 
Seat 4: LuisGR90 (€2 in chips) 
Seat 5: KillVerlaine (€2.34 in chips) 
Seat 6: Chichoampuero12 (€2 in chips) 
marcdevil: posts small blind €0.01
wilbor123: posts big blind €0.02
*** HOLE CARDS ***
Dealt to pipinoelbreve9 [9s 8c]
LuisGR90: folds 
KillVerlaine: raises €0.03 to €0.05
Chichoampuero12: folds 
pipinoelbreve9: folds 
marcdevil: folds 
wilbor123: folds 
Uncalled bet (€0.03) returned to KillVerlaine
KillVerlaine collected €0.05 from pot
KillVerlaine: doesn't show hand 
*** SUMMARY ***
Total pot €0.05 | Rake €0 
Seat 1: pipinoelbreve9 (button) folded before Flop (didn't bet)
Seat 2: marcdevil (small blind) folded before Flop
Seat 3: wilbor123 (big blind) folded before Flop
Seat 4: LuisGR90 folded before Flop (didn't bet)
Seat 5: KillVerlaine collected (€0.05)
Seat 6: Chichoampuero12 folded before Flop (didn't bet)



PokerStars Zoom Hand #257562746771:  Hold'em No Limit (€0.01/€0.02) - 2025/08/31 22:28:54 CET [2025/08/31 16:28:54 ET]
Table 'Arneb' 6-max Seat #1 is the button
Seat 1: Ujfalusi87 (€3.10 in chips) 
Seat 2: pipinoelbreve9 (€2.57 in chips) 
Seat 3: Bestiote (€0.97 in chips) 
Seat 4: Lumifer (€2 in chips) 
Seat 5: scaramouche84 (€3.04 in chips) 
Seat 6: NEMOXYX (€3.32 in chips) 
pipinoelbreve9: posts small blind €0.01
Bestiote: posts big blind €0.02
*** HOLE CARDS ***
Dealt to pipinoelbreve9 [Jc 4h]
Lumifer: folds 
scaramouche84: folds 
NEMOXYX: folds 
Ujfalusi87: folds 
pipinoelbreve9: folds 
Uncalled bet (€0.01) returned to Bestiote
Bestiote collected €0.02 from pot
Bestiote: doesn't show hand 
*** SUMMARY ***
Total pot €0.02 | Rake €0 
Seat 1: Ujfalusi87 (button) folded before Flop (didn't bet)
Seat 2: pipinoelbreve9 (small blind) folded before Flop
Seat 3: Bestiote (big blind) collected (€0.02)
Seat 4: Lumifer folded before Flop (didn't bet)
Seat 5: scaramouche84 folded before Flop (didn't bet)
Seat 6: NEMOXYX folded before Flop (didn't bet)



PokerStars Zoom Hand #257562749927:  Hold'em No Limit (€0.01/€0.02) - 2025/08/31 22:29:03 CET [2025/08/31 16:29:03 ET]
Table 'Arneb' 6-max Seat #1 is the button
Seat 1: tanoun1 (€2.12 in chips) 
Seat 2: eres_tontito (€2.02 in chips) 
Seat 3: pipinoelbreve9 (€2.56 in chips) 
Seat 4: kurtconlei14 (€2.22 in chips) 
Seat 5: PkBcN15 (€2 in chips) 
Seat 6: AnxoGM (€2.01 in chips) 
eres_tontito: posts small blind €0.01
pipinoelbreve9: posts big blind €0.02
*** HOLE CARDS ***
Dealt to pipinoelbreve9 [Ac 6s]
kurtconlei14: raises €0.02 to €0.04
PkBcN15: folds 
AnxoGM: folds 
tanoun1: folds 
eres_tontito: folds 
pipinoelbreve9: calls €0.02
*** FLOP *** [4s As 9h]
pipinoelbreve9: checks 
kurtconlei14: bets €0.05
pipinoelbreve9: calls €0.05
*** TURN *** [4s As 9h] [8h]
pipinoelbreve9: checks 
kurtconlei14: checks 
*** RIVER *** [4s As 9h 8h] [8c]
pipinoelbreve9: checks 
kurtconlei14: checks 
*** SHOW DOWN ***
pipinoelbreve9: shows [Ac 6s] (two pair, Aces and Eights)
kurtconlei14: mucks hand 
pipinoelbreve9 collected €0.18 from pot
*** SUMMARY ***
Total pot €0.19 | Rake €0.01 
Board [4s As 9h 8h 8c]
Seat 1: tanoun1 (button) folded before Flop (didn't bet)
Seat 2: eres_tontito (small blind) folded before Flop
Seat 3: pipinoelbreve9 (big blind) showed [Ac 6s] and won (€0.18) with two pair, Aces and Eights
Seat 4: kurtconlei14 mucked [5d 5h]
Seat 5: PkBcN15 folded before Flop (didn't bet)
Seat 6: AnxoGM folded before Flop (didn't bet)



PokerStars Zoom Hand #257562745206:  Hold'em No Limit (€0.01/€0.02) - 2025/08/31 22:28:49 CET [2025/08/31 16:28:49 ET]
Table 'Arneb' 6-max Seat #1 is the button
Seat 1: finfin13205 (€1.89 in chips) 
Seat 2: felgas1968 (€2.35 in chips) 
Seat 3: castiego2 (€2.19 in chips) 
Seat 4: galispin (€1.89 in chips) 
Seat 5: pipinoelbreve9 (€2.57 in chips) 
Seat 6: eres_tontito (€1.99 in chips) 
felgas1968: posts small blind €0.01
castiego2: posts big blind €0.02
*** HOLE CARDS ***
Dealt to pipinoelbreve9 [2s 2d]
galispin: folds 
pipinoelbreve9: folds 
eres_tontito: folds 
finfin13205: calls €0.02
felgas1968: folds 
castiego2: checks 
*** FLOP *** [5d Ah 9d]
castiego2: checks 
finfin13205: bets €0.02
castiego2: calls €0.02
*** TURN *** [5d Ah 9d] [Qs]
castiego2: checks 
finfin13205: bets €0.02
castiego2: calls €0.02
*** RIVER *** [5d Ah 9d Qs] [2c]
castiego2: checks 
finfin13205: bets €0.12
castiego2: folds 
Uncalled bet (€0.12) returned to finfin13205
finfin13205 collected €0.12 from pot
finfin13205: doesn't show hand 
*** SUMMARY ***
Total pot €0.13 | Rake €0.01 
Board [5d Ah 9d Qs 2c]
Seat 1: finfin13205 (button) collected (€0.12)
Seat 2: felgas1968 (small blind) folded before Flop
Seat 3: castiego2 (big blind) folded on the River
Seat 4: galispin folded before Flop (didn't bet)
Seat 5: pipinoelbreve9 folded before Flop (didn't bet)
Seat 6: eres_tontito folded before Flop (didn't bet)



PokerStars Zoom Hand #257562763413:  Hold'em No Limit (€0.01/€0.02) - 2025/08/31 22:29:46 CET [2025/08/31 16:29:46 ET]
Table 'Arneb' 6-max Seat #1 is the button
Seat 1: QQpkrQQ (€2 in chips) 
Seat 2: felgas1968 (€1.95 in chips) 
Seat 3: RCSA2 (€1.83 in chips) 
Seat 4: Fr@nkys (€2.70 in chips) 
Seat 5: kurtconlei14 (€2.13 in chips) 
Seat 6: pipinoelbreve9 (€2.65 in chips) 
felgas1968: posts small blind €0.01
RCSA2: posts big blind €0.02
*** HOLE CARDS ***
Dealt to pipinoelbreve9 [2d Jd]
Fr@nkys: folds 
kurtconlei14: raises €0.02 to €0.04
pipinoelbreve9: folds 
QQpkrQQ: folds 
felgas1968: calls €0.03
RCSA2: folds 
*** FLOP *** [2s 6d Qd]
felgas1968: checks 
kurtconlei14: bets €0.05
felgas1968: folds 
Uncalled bet (€0.05) returned to kurtconlei14
kurtconlei14 collected €0.10 from pot
kurtconlei14: doesn't show hand 
*** SUMMARY ***
Total pot €0.10 | Rake €0 
Board [2s 6d Qd]
Seat 1: QQpkrQQ (button) folded before Flop (didn't bet)
Seat 2: felgas1968 (small blind) folded on the Flop
Seat 3: RCSA2 (big blind) folded before Flop
Seat 4: Fr@nkys folded before Flop (didn't bet)
Seat 5: kurtconlei14 collected (€0.10)
Seat 6: pipinoelbreve9 folded before Flop (didn't bet)



PokerStars Zoom Hand #257562765188:  Hold'em No Limit (€0.01/€0.02) - 2025/08/31 22:29:52 CET [2025/08/31 16:29:52 ET]
Table 'Arneb' 6-max Seat #1 is the button
Seat 1: WJSP (€2 in chips) 
Seat 2: tanoun1 (€2.07 in chips) 
Seat 3: QQpkrQQ (€2.41 in chips) 
Seat 4: KillVerlaine (€2.34 in chips) 
Seat 5: pipinoelbreve9 (€2.65 in chips) 
Seat 6: NEMOXYX (€5.24 in chips) 
tanoun1: posts small blind €0.01
QQpkrQQ: posts big blind €0.02
*** HOLE CARDS ***
Dealt to pipinoelbreve9 [Ah Qh]
KillVerlaine: folds 
pipinoelbreve9: raises €0.04 to €0.06
NEMOXYX: folds 
WJSP: folds 
tanoun1: calls €0.05
QQpkrQQ: folds 
*** FLOP *** [Qd 4d 8s]
tanoun1: checks 
pipinoelbreve9: bets €0.05
tanoun1: calls €0.05
*** TURN *** [Qd 4d 8s] [6d]
tanoun1: bets €0.08
pipinoelbreve9: calls €0.08
*** RIVER *** [Qd 4d 8s 6d] [8c]
tanoun1: bets €0.29
pipinoelbreve9: calls €0.29
*** SHOW DOWN ***
tanoun1: shows [6s 6c] (a full house, Sixes full of Eights)
pipinoelbreve9: mucks hand 
tanoun1 collected €0.93 from pot
*** SUMMARY ***
Total pot €0.98 | Rake €0.05 
Board [Qd 4d 8s 6d 8c]
Seat 1: WJSP (button) folded before Flop (didn't bet)
Seat 2: tanoun1 (small blind) showed [6s 6c] and won (€0.93) with a full house, Sixes full of Eights
Seat 3: QQpkrQQ (big blind) folded before Flop
Seat 4: KillVerlaine folded before Flop (didn't bet)
Seat 5: pipinoelbreve9 mucked [Ah Qh]
Seat 6: NEMOXYX folded before Flop (didn't bet)



PokerStars Zoom Hand #257562784243:  Hold'em No Limit (€0.01/€0.02) - 2025/08/31 22:30:51 CET [2025/08/31 16:30:51 ET]
Table 'Arneb' 6-max Seat #1 is the button
Seat 1: Lokarionn (€1.60 in chips) 
Seat 2: ernest384 (€2.76 in chips) 
Seat 3: Phamtom123 (€0.60 in chips) 
Seat 4: pipinoelbreve9 (€2.17 in chips) 
Seat 5: PkBcN15 (€2 in chips) 
Seat 6: 34pluto (€1.87 in chips) 
ernest384: posts small blind €0.01
Phamtom123: posts big blind €0.02
*** HOLE CARDS ***
Dealt to pipinoelbreve9 [Qs Qh]
pipinoelbreve9: raises €0.04 to €0.06
PkBcN15: folds 
34pluto: folds 
Lokarionn: raises €0.04 to €0.10
ernest384: folds 
Phamtom123: folds 
pipinoelbreve9: raises €0.16 to €0.26
Lokarionn: raises €0.16 to €0.42
pipinoelbreve9: raises €1.75 to €2.17 and is all-in
Lokarionn: calls €1.18 and is all-in
Uncalled bet (€0.57) returned to pipinoelbreve9
*** FLOP *** [Kd 9h 9s]
*** TURN *** [Kd 9h 9s] [4s]
*** RIVER *** [Kd 9h 9s 4s] [Kc]
*** SHOW DOWN ***
pipinoelbreve9: shows [Qs Qh] (two pair, Kings and Queens)
Lokarionn: shows [Jc Js] (two pair, Kings and Jacks)
pipinoelbreve9 collected €3.07 from pot
*** SUMMARY ***
Total pot €3.23 | Rake €0.16 
Board [Kd 9h 9s 4s Kc]
Seat 1: Lokarionn (button) showed [Jc Js] and lost with two pair, Kings and Jacks
Seat 2: ernest384 (small blind) folded before Flop
Seat 3: Phamtom123 (big blind) folded before Flop
Seat 4: pipinoelbreve9 showed [Qs Qh] and won (€3.07) with two pair, Kings and Queens
Seat 5: PkBcN15 folded before Flop (didn't bet)
Seat 6: 34pluto folded before Flop (didn't bet)



PokerStars Zoom Hand #257562795916:  Hold'em No Limit (€0.01/€0.02) - 2025/08/31 22:31:28 CET [2025/08/31 16:31:28 ET]
Table 'Arneb' 6-max Seat #1 is the button
Seat 1: tanoun1 (€2.12 in chips) 
Seat 2: CheckMate1346 (€2 in chips) 
Seat 3: Chichoampuero12 (€3.11 in chips) 
Seat 4: 34pluto (€1.15 in chips) 
Seat 5: Arrantzale46 (€2 in chips) 
Seat 6: pipinoelbreve9 (€3.64 in chips) 
CheckMate1346: posts small blind €0.01
Chichoampuero12: posts big blind €0.02
*** HOLE CARDS ***
Dealt to pipinoelbreve9 [6d 9h]
34pluto: folds 
Arrantzale46: folds 
pipinoelbreve9: folds 
tanoun1: folds 
CheckMate1346: folds 
Uncalled bet (€0.01) returned to Chichoampuero12
Chichoampuero12 collected €0.02 from pot
Chichoampuero12: doesn't show hand 
*** SUMMARY ***
Total pot €0.02 | Rake €0 
Seat 1: tanoun1 (button) folded before Flop (didn't bet)
Seat 2: CheckMate1346 (small blind) folded before Flop
Seat 3: Chichoampuero12 (big blind) collected (€0.02)
Seat 4: 34pluto folded before Flop (didn't bet)
Seat 5: Arrantzale46 folded before Flop (didn't bet)
Seat 6: pipinoelbreve9 folded before Flop (didn't bet)



PokerStars Zoom Hand #257562794296:  Hold'em No Limit (€0.01/€0.02) - 2025/08/31 22:31:23 CET [2025/08/31 16:31:23 ET]
Table 'Arneb' 6-max Seat #1 is the button
Seat 1: pipinoelbreve9 (€3.64 in chips) 
Seat 2: castiego2 (€1.98 in chips) 
Seat 3: Lumifer (€2.14 in chips) 
Seat 4: 34pluto (€1.15 in chips) 
Seat 5: felgas1968 (€2.57 in chips) 
Seat 6: WJSP (€2.02 in chips) 
castiego2: posts small blind €0.01
Lumifer: posts big blind €0.02
*** HOLE CARDS ***
Dealt to pipinoelbreve9 [6d 9s]
34pluto: folds 
felgas1968: folds 
WJSP: folds 
pipinoelbreve9: folds 
castiego2: raises €0.02 to €0.04
Lumifer: raises €0.10 to €0.14
castiego2: folds 
Uncalled bet (€0.10) returned to Lumifer
Lumifer collected €0.08 from pot
Lumifer: doesn't show hand 
*** SUMMARY ***
Total pot €0.08 | Rake €0 
Seat 1: pipinoelbreve9 (button) folded before Flop (didn't bet)
Seat 2: castiego2 (small blind) folded before Flop
Seat 3: Lumifer (big blind) collected (€0.08)
Seat 4: 34pluto folded before Flop (didn't bet)
Seat 5: felgas1968 folded before Flop (didn't bet)
Seat 6: WJSP folded before Flop (didn't bet)



PokerStars Zoom Hand #257562799974:  Hold'em No Limit (€0.01/€0.02) - 2025/08/31 22:31:40 CET [2025/08/31 16:31:40 ET]
Table 'Arneb' 6-max Seat #1 is the button
Seat 1: pipinoelbreve9 (€3.63 in chips) 
Seat 2: eres_tontito (€2.08 in chips) 
Seat 3: sambupkr (€2 in chips) 
Seat 4: wilbor123 (€2.14 in chips) 
Seat 5: Ujfalusi87 (€3.13 in chips) 
Seat 6: Lauranve (€1.60 in chips) 
eres_tontito: posts small blind €0.01
sambupkr: posts big blind €0.02
*** HOLE CARDS ***
Dealt to pipinoelbreve9 [5d 3s]
wilbor123: folds 
Ujfalusi87: raises €0.03 to €0.05
Lauranve: folds 
pipinoelbreve9: folds 
eres_tontito: folds 
sambupkr: folds 
Uncalled bet (€0.03) returned to Ujfalusi87
Ujfalusi87 collected €0.05 from pot
Ujfalusi87: doesn't show hand 
*** SUMMARY ***
Total pot €0.05 | Rake €0 
Seat 1: pipinoelbreve9 (button) folded before Flop (didn't bet)
Seat 2: eres_tontito (small blind) folded before Flop
Seat 3: sambupkr (big blind) folded before Flop
Seat 4: wilbor123 folded before Flop (didn't bet)
Seat 5: Ujfalusi87 collected (€0.05)
Seat 6: Lauranve folded before Flop (didn't bet)



PokerStars Zoom Hand #257562798303:  Hold'em No Limit (€0.01/€0.02) - 2025/08/31 22:31:35 CET [2025/08/31 16:31:35 ET]
Table 'Arneb' 6-max Seat #1 is the button
Seat 1: Lauranve (€1.60 in chips) 
Seat 2: pipinoelbreve9 (€3.64 in chips) 
Seat 3: NEMOXYX (€3.18 in chips) 
Seat 4: rare12345 (€2.32 in chips) 
Seat 5: Lumifer (€2 in chips) 
Seat 6: LuisGR90 (€2.56 in chips) 
pipinoelbreve9: posts small blind €0.01
NEMOXYX: posts big blind €0.02
*** HOLE CARDS ***
Dealt to pipinoelbreve9 [4c Qs]
rare12345: folds 
Lumifer: raises €0.03 to €0.05
LuisGR90: folds 
Lauranve: folds 
pipinoelbreve9: folds 
NEMOXYX: calls €0.03
*** FLOP *** [Jc Qd 9d]
NEMOXYX: checks 
Lumifer: bets €0.05
NEMOXYX: calls €0.05
*** TURN *** [Jc Qd 9d] [As]
NEMOXYX: checks 
Lumifer: bets €0.15
NEMOXYX: calls €0.15
*** RIVER *** [Jc Qd 9d As] [9c]
NEMOXYX: checks 
Lumifer: bets €0.16
NEMOXYX: folds 
Uncalled bet (€0.16) returned to Lumifer
Lumifer collected €0.48 from pot
Lumifer: doesn't show hand 
*** SUMMARY ***
Total pot €0.51 | Rake €0.03 
Board [Jc Qd 9d As 9c]
Seat 1: Lauranve (button) folded before Flop (didn't bet)
Seat 2: pipinoelbreve9 (small blind) folded before Flop
Seat 3: NEMOXYX (big blind) folded on the River
Seat 4: rare12345 folded before Flop (didn't bet)
Seat 5: Lumifer collected (€0.48)
Seat 6: LuisGR90 folded before Flop (didn't bet)



PokerStars Zoom Hand #257562821662:  Hold'em No Limit (€0.01/€0.02) - 2025/08/31 22:32:48 CET [2025/08/31 16:32:48 ET]
Table 'Arneb' 6-max Seat #1 is the button
Seat 1: Xoco Cusco (€0.28 in chips) 
Seat 2: scaramouche84 (€3.23 in chips) 
Seat 3: pipinoelbreve9 (€3.63 in chips) 
Seat 4: ana paula900 (€1.58 in chips) 
Seat 5: josep10965 (€2.15 in chips) 
Seat 6: bdcscstars (€1.75 in chips) 
scaramouche84: posts small blind €0.01
pipinoelbreve9: posts big blind €0.02
*** HOLE CARDS ***
Dealt to pipinoelbreve9 [5h Qh]
ana paula900: raises €0.02 to €0.04
josep10965: folds 
bdcscstars: folds 
Xoco Cusco: folds 
scaramouche84: calls €0.03
pipinoelbreve9: calls €0.02
*** FLOP *** [8s 5s 2h]
scaramouche84: checks 
pipinoelbreve9: checks 
ana paula900: checks 
*** TURN *** [8s 5s 2h] [4c]
scaramouche84: checks 
pipinoelbreve9: checks 
ana paula900: bets €0.11
scaramouche84: folds 
pipinoelbreve9: calls €0.11
*** RIVER *** [8s 5s 2h 4c] [2s]
pipinoelbreve9: checks 
ana paula900: checks 
*** SHOW DOWN ***
pipinoelbreve9: shows [5h Qh] (two pair, Fives and Deuces)
ana paula900: mucks hand 
pipinoelbreve9 collected €0.32 from pot
*** SUMMARY ***
Total pot €0.34 | Rake €0.02 
Board [8s 5s 2h 4c 2s]
Seat 1: Xoco Cusco (button) folded before Flop (didn't bet)
Seat 2: scaramouche84 (small blind) folded on the Turn
Seat 3: pipinoelbreve9 (big blind) showed [5h Qh] and won (€0.32) with two pair, Fives and Deuces
Seat 4: ana paula900 mucked [Qd Jh]
Seat 5: josep10965 folded before Flop (didn't bet)
Seat 6: bdcscstars folded before Flop (didn't bet)



PokerStars Zoom Hand #257562844775:  Hold'em No Limit (€0.01/€0.02) - 2025/08/31 22:34:01 CET [2025/08/31 16:34:01 ET]
Table 'Arneb' 6-max Seat #1 is the button
Seat 1: LuisGR90 (€2.03 in chips) 
Seat 2: pipinoelbreve9 (€3.80 in chips) 
Seat 3: bdcscstars (€2.04 in chips) 
Seat 4: AnxoGM (€2.28 in chips) 
Seat 5: Minyens33 (€1.53 in chips) 
Seat 6: kurikutela53 (€0.84 in chips) 
pipinoelbreve9: posts small blind €0.01
bdcscstars: posts big blind €0.02
*** HOLE CARDS ***
Dealt to pipinoelbreve9 [Ad 2s]
AnxoGM: folds 
Minyens33: folds 
kurikutela53: raises €0.02 to €0.04
LuisGR90: raises €0.12 to €0.16
pipinoelbreve9: folds 
bdcscstars: folds 
kurikutela53: raises €0.68 to €0.84 and is all-in
LuisGR90: folds 
Uncalled bet (€0.68) returned to kurikutela53
kurikutela53 collected €0.35 from pot
kurikutela53: doesn't show hand 
*** SUMMARY ***
Total pot €0.35 | Rake €0 
Seat 1: LuisGR90 (button) folded before Flop
Seat 2: pipinoelbreve9 (small blind) folded before Flop
Seat 3: bdcscstars (big blind) folded before Flop
Seat 4: AnxoGM folded before Flop (didn't bet)
Seat 5: Minyens33 folded before Flop (didn't bet)
Seat 6: kurikutela53 collected (€0.35)



PokerStars Zoom Hand #257562848656:  Hold'em No Limit (€0.01/€0.02) - 2025/08/31 22:34:13 CET [2025/08/31 16:34:13 ET]
Table 'Arneb' 6-max Seat #1 is the button
Seat 1: pipinoelbreve9 (€3.79 in chips) 
Seat 2: eres_tontito (€2.09 in chips) 
Seat 3: wilbor123 (€2.06 in chips) 
Seat 4: POÇAOMAGICA (€2.08 in chips) 
Seat 5: sambupkr (€2.06 in chips) 
Seat 6: Chichoampuero12 (€2.72 in chips) 
eres_tontito: posts small blind €0.01
wilbor123: posts big blind €0.02
*** HOLE CARDS ***
Dealt to pipinoelbreve9 [3c 5d]
POÇAOMAGICA: folds 
sambupkr: folds 
Chichoampuero12: folds 
pipinoelbreve9: folds 
eres_tontito: folds 
Uncalled bet (€0.01) returned to wilbor123
wilbor123 collected €0.02 from pot
wilbor123: doesn't show hand 
*** SUMMARY ***
Total pot €0.02 | Rake €0 
Seat 1: pipinoelbreve9 (button) folded before Flop (didn't bet)
Seat 2: eres_tontito (small blind) folded before Flop
Seat 3: wilbor123 (big blind) collected (€0.02)
Seat 4: POÇAOMAGICA folded before Flop (didn't bet)
Seat 5: sambupkr folded before Flop (didn't bet)
Seat 6: Chichoampuero12 folded before Flop (didn't bet)



PokerStars Zoom Hand #257562850001:  Hold'em No Limit (€0.01/€0.02) - 2025/08/31 22:34:17 CET [2025/08/31 16:34:17 ET]
Table 'Arneb' 6-max Seat #1 is the button
Seat 1: bdcscstars (€1.56 in chips) 
Seat 2: tanoun1 (€2.39 in chips) 
Seat 3: rare12345 (€2.31 in chips) 
Seat 4: QQpkrQQ (€4.52 in chips) 
Seat 5: lorocontento (€1 in chips) 
Seat 6: pipinoelbreve9 (€3.79 in chips) 
tanoun1: posts small blind €0.01
rare12345: posts big blind €0.02
*** HOLE CARDS ***
Dealt to pipinoelbreve9 [Td 3s]
QQpkrQQ: folds 
lorocontento: folds 
pipinoelbreve9: folds 
bdcscstars: raises €0.02 to €0.04
tanoun1: folds 
rare12345: folds 
Uncalled bet (€0.02) returned to bdcscstars
bdcscstars collected €0.05 from pot
bdcscstars: doesn't show hand 
*** SUMMARY ***
Total pot €0.05 | Rake €0 
Seat 1: bdcscstars (button) collected (€0.05)
Seat 2: tanoun1 (small blind) folded before Flop
Seat 3: rare12345 (big blind) folded before Flop
Seat 4: QQpkrQQ folded before Flop (didn't bet)
Seat 5: lorocontento folded before Flop (didn't bet)
Seat 6: pipinoelbreve9 folded before Flop (didn't bet)



PokerStars Zoom Hand #257562853713:  Hold'em No Limit (€0.01/€0.02) - 2025/08/31 22:34:29 CET [2025/08/31 16:34:29 ET]
Table 'Arneb' 6-max Seat #1 is the button
Seat 1: eres_tontito (€2.01 in chips) 
Seat 2: WJSP (€2.08 in chips) 
Seat 3: AnxoGM (€2.96 in chips) 
Seat 4: tanoun1 (€2.38 in chips) 
Seat 5: pipinoelbreve9 (€3.79 in chips) 
Seat 6: NEMOXYX (€2.92 in chips) 
WJSP: posts small blind €0.01
AnxoGM: posts big blind €0.02
*** HOLE CARDS ***
Dealt to pipinoelbreve9 [4c 9d]
tanoun1: folds 
pipinoelbreve9: folds 
NEMOXYX: folds 
eres_tontito: folds 
WJSP: folds 
Uncalled bet (€0.01) returned to AnxoGM
AnxoGM collected €0.02 from pot
AnxoGM: doesn't show hand 
*** SUMMARY ***
Total pot €0.02 | Rake €0 
Seat 1: eres_tontito (button) folded before Flop (didn't bet)
Seat 2: WJSP (small blind) folded before Flop
Seat 3: AnxoGM (big blind) collected (€0.02)
Seat 4: tanoun1 folded before Flop (didn't bet)
Seat 5: pipinoelbreve9 folded before Flop (didn't bet)
Seat 6: NEMOXYX folded before Flop (didn't bet)



PokerStars Zoom Hand #257562851446:  Hold'em No Limit (€0.01/€0.02) - 2025/08/31 22:34:21 CET [2025/08/31 16:34:21 ET]
Table 'Arneb' 6-max Seat #1 is the button
Seat 1: CASCALE$ (€1.80 in chips) 
Seat 2: POÇAOMAGICA (€5.70 in chips) 
Seat 3: ocsur (€1.65 in chips) 
Seat 4: pipinoelbreve9 (€3.79 in chips) 
Seat 5: Arrantzale46 (€2.17 in chips) 
Seat 6: tanoun1 (€2.38 in chips) 
POÇAOMAGICA: posts small blind €0.01
ocsur: posts big blind €0.02
*** HOLE CARDS ***
Dealt to pipinoelbreve9 [8c 4s]
pipinoelbreve9: folds 
Arrantzale46: raises €0.02 to €0.04
tanoun1: folds 
CASCALE$: folds 
POÇAOMAGICA: folds 
ocsur: folds 
Uncalled bet (€0.02) returned to Arrantzale46
Arrantzale46 collected €0.05 from pot
Arrantzale46: doesn't show hand 
*** SUMMARY ***
Total pot €0.05 | Rake €0 
Seat 1: CASCALE$ (button) folded before Flop (didn't bet)
Seat 2: POÇAOMAGICA (small blind) folded before Flop
Seat 3: ocsur (big blind) folded before Flop
Seat 4: pipinoelbreve9 folded before Flop (didn't bet)
Seat 5: Arrantzale46 collected (€0.05)
Seat 6: tanoun1 folded before Flop (didn't bet)



PokerStars Zoom Hand #257562856517:  Hold'em No Limit (€0.01/€0.02) - 2025/08/31 22:34:38 CET [2025/08/31 16:34:38 ET]
Table 'Arneb' 6-max Seat #1 is the button
Seat 1: ocsur (€1.63 in chips) 
Seat 2: maximus_powah (€1.98 in chips) 
Seat 3: pipinoelbreve9 (€3.79 in chips) 
Seat 4: rare12345 (€2.33 in chips) 
Seat 5: tanoun1 (€2.96 in chips) 
Seat 6: sambupkr (€2.10 in chips) 
maximus_powah: posts small blind €0.01
pipinoelbreve9: posts big blind €0.02
*** HOLE CARDS ***
Dealt to pipinoelbreve9 [Jh 7s]
rare12345: folds 
tanoun1: folds 
sambupkr: folds 
ocsur: folds 
maximus_powah: folds 
Uncalled bet (€0.01) returned to pipinoelbreve9
pipinoelbreve9 collected €0.02 from pot
pipinoelbreve9: doesn't show hand 
*** SUMMARY ***
Total pot €0.02 | Rake €0 
Seat 1: ocsur (button) folded before Flop (didn't bet)
Seat 2: maximus_powah (small blind) folded before Flop
Seat 3: pipinoelbreve9 (big blind) collected (€0.02)
Seat 4: rare12345 folded before Flop (didn't bet)
Seat 5: tanoun1 folded before Flop (didn't bet)
Seat 6: sambupkr folded before Flop (didn't bet)



PokerStars Zoom Hand #257562859151:  Hold'em No Limit (€0.01/€0.02) - 2025/08/31 22:34:46 CET [2025/08/31 16:34:46 ET]
Table 'Arneb' 6-max Seat #1 is the button
Seat 1: NEMOXYX (€2.90 in chips) 
Seat 2: pipinoelbreve9 (€3.80 in chips) 
Seat 3: Bestiote (€0.71 in chips) 
Seat 4: Izibeaxh (€3.20 in chips) 
Seat 5: bdcscstars (€1.69 in chips) 
Seat 6: tanoun1 (€2.70 in chips) 
pipinoelbreve9: posts small blind €0.01
Bestiote: posts big blind €0.02
*** HOLE CARDS ***
Dealt to pipinoelbreve9 [Ah 4c]
Izibeaxh: folds 
bdcscstars: folds 
tanoun1: raises €0.03 to €0.05
NEMOXYX: folds 
pipinoelbreve9: folds 
Bestiote: folds 
Uncalled bet (€0.03) returned to tanoun1
tanoun1 collected €0.05 from pot
tanoun1: doesn't show hand 
*** SUMMARY ***
Total pot €0.05 | Rake €0 
Seat 1: NEMOXYX (button) folded before Flop (didn't bet)
Seat 2: pipinoelbreve9 (small blind) folded before Flop
Seat 3: Bestiote (big blind) folded before Flop
Seat 4: Izibeaxh folded before Flop (didn't bet)
Seat 5: bdcscstars folded before Flop (didn't bet)
Seat 6: tanoun1 collected (€0.05)



PokerStars Zoom Hand #257562861495:  Hold'em No Limit (€0.01/€0.02) - 2025/08/31 22:34:53 CET [2025/08/31 16:34:53 ET]
Table 'Arneb' 6-max Seat #1 is the button
Seat 1: pipinoelbreve9 (€3.79 in chips) 
Seat 2: Belezaso21 (€1.33 in chips) 
Seat 3: Fr@nkys (€2.86 in chips) 
Seat 4: sambupkr (€2.10 in chips) 
Seat 5: josep10965 (€2.13 in chips) 
Seat 6: 28chan28 (€2.16 in chips) 
Belezaso21: posts small blind €0.01
Fr@nkys: posts big blind €0.02
*** HOLE CARDS ***
Dealt to pipinoelbreve9 [Tc Qs]
sambupkr: folds 
josep10965: folds 
28chan28: raises €0.04 to €0.06
pipinoelbreve9: calls €0.06
Belezaso21: folds 
Fr@nkys: folds 
*** FLOP *** [3c 6s 9c]
28chan28: checks 
pipinoelbreve9: checks 
*** TURN *** [3c 6s 9c] [9d]
28chan28: bets €0.06
pipinoelbreve9: folds 
Uncalled bet (€0.06) returned to 28chan28
28chan28 collected €0.14 from pot
28chan28: doesn't show hand 
*** SUMMARY ***
Total pot €0.15 | Rake €0.01 
Board [3c 6s 9c 9d]
Seat 1: pipinoelbreve9 (button) folded on the Turn
Seat 2: Belezaso21 (small blind) folded before Flop
Seat 3: Fr@nkys (big blind) folded before Flop
Seat 4: sambupkr folded before Flop (didn't bet)
Seat 5: josep10965 folded before Flop (didn't bet)
Seat 6: 28chan28 collected (€0.14)



PokerStars Zoom Hand #257562874332:  Hold'em No Limit (€0.01/€0.02) - 2025/08/31 22:35:33 CET [2025/08/31 16:35:33 ET]
Table 'Arneb' 6-max Seat #1 is the button
Seat 1: maximus_powah (€1.60 in chips) 
Seat 2: tanoun1 (€2.96 in chips) 
Seat 3: Xexugol (€2 in chips) 
Seat 4: NEMOXYX (€5.58 in chips) 
Seat 5: pipinoelbreve9 (€3.73 in chips) 
Seat 6: Fr@nkys (€2.44 in chips) 
tanoun1: posts small blind €0.01
Xexugol: posts big blind €0.02
*** HOLE CARDS ***
Dealt to pipinoelbreve9 [Jh Kc]
NEMOXYX: folds 
pipinoelbreve9: raises €0.04 to €0.06
Fr@nkys: folds 
maximus_powah: folds 
tanoun1: folds 
Xexugol: folds 
Uncalled bet (€0.04) returned to pipinoelbreve9
pipinoelbreve9 collected €0.05 from pot
pipinoelbreve9: doesn't show hand 
*** SUMMARY ***
Total pot €0.05 | Rake €0 
Seat 1: maximus_powah (button) folded before Flop (didn't bet)
Seat 2: tanoun1 (small blind) folded before Flop
Seat 3: Xexugol (big blind) folded before Flop
Seat 4: NEMOXYX folded before Flop (didn't bet)
Seat 5: pipinoelbreve9 collected (€0.05)
Seat 6: Fr@nkys folded before Flop (didn't bet)



PokerStars Zoom Hand #257562883211:  Hold'em No Limit (€0.01/€0.02) - 2025/08/31 22:36:01 CET [2025/08/31 16:36:01 ET]
Table 'Arneb' 6-max Seat #1 is the button
Seat 1: josep10965 (€2.16 in chips) 
Seat 2: POÇAOMAGICA (€2.05 in chips) 
Seat 3: pipinoelbreve9 (€3.76 in chips) 
Seat 4: bdcscstars (€1.75 in chips) 
Seat 5: PkBcN15 (€2.08 in chips) 
Seat 6: LGC04 (€2.03 in chips) 
POÇAOMAGICA: posts small blind €0.01
pipinoelbreve9: posts big blind €0.02
*** HOLE CARDS ***
Dealt to pipinoelbreve9 [2h 3s]
bdcscstars: folds 
PkBcN15: folds 
LGC04: folds 
josep10965: folds 
POÇAOMAGICA: folds 
Uncalled bet (€0.01) returned to pipinoelbreve9
pipinoelbreve9 collected €0.02 from pot
pipinoelbreve9: doesn't show hand 
*** SUMMARY ***
Total pot €0.02 | Rake €0 
Seat 1: josep10965 (button) folded before Flop (didn't bet)
Seat 2: POÇAOMAGICA (small blind) folded before Flop
Seat 3: pipinoelbreve9 (big blind) collected (€0.02)
Seat 4: bdcscstars folded before Flop (didn't bet)
Seat 5: PkBcN15 folded before Flop (didn't bet)
Seat 6: LGC04 folded before Flop (didn't bet)



PokerStars Zoom Hand #257562886197:  Hold'em No Limit (€0.01/€0.02) - 2025/08/31 22:36:11 CET [2025/08/31 16:36:11 ET]
Table 'Arneb' 6-max Seat #1 is the button
Seat 1: POÇAOMAGICA (€5.63 in chips) 
Seat 2: pipinoelbreve9 (€3.77 in chips) 
Seat 3: ana paula900 (€1.30 in chips) 
Seat 4: felgas1968 (€2.39 in chips) 
Seat 5: sanpistakio (€1.12 in chips) 
Seat 6: RCSA2 (€1.93 in chips) 
pipinoelbreve9: posts small blind €0.01
ana paula900: posts big blind €0.02
*** HOLE CARDS ***
Dealt to pipinoelbreve9 [4c As]
felgas1968: folds 
sanpistakio: folds 
RCSA2: folds 
POÇAOMAGICA: folds 
pipinoelbreve9: raises €0.04 to €0.06
ana paula900: folds 
Uncalled bet (€0.04) returned to pipinoelbreve9
pipinoelbreve9 collected €0.04 from pot
pipinoelbreve9: doesn't show hand 
*** SUMMARY ***
Total pot €0.04 | Rake €0 
Seat 1: POÇAOMAGICA (button) folded before Flop (didn't bet)
Seat 2: pipinoelbreve9 (small blind) collected (€0.04)
Seat 3: ana paula900 (big blind) folded before Flop
Seat 4: felgas1968 folded before Flop (didn't bet)
Seat 5: sanpistakio folded before Flop (didn't bet)
Seat 6: RCSA2 folded before Flop (didn't bet)



PokerStars Zoom Hand #257562878779:  Hold'em No Limit (€0.01/€0.02) - 2025/08/31 22:35:47 CET [2025/08/31 16:35:47 ET]
Table 'Arneb' 6-max Seat #1 is the button
Seat 1: rare12345 (€2.38 in chips) 
Seat 2: AleactaEst21 (€2.33 in chips) 
Seat 3: kurikutela53 (€1 in chips) 
Seat 4: POÇAOMAGICA (€2.05 in chips) 
Seat 5: Lumifer (€2.24 in chips) 
Seat 6: pipinoelbreve9 (€3.76 in chips) 
AleactaEst21: posts small blind €0.01
kurikutela53: posts big blind €0.02
*** HOLE CARDS ***
Dealt to pipinoelbreve9 [7h 9h]
POÇAOMAGICA: folds 
Lumifer: raises €0.03 to €0.05
pipinoelbreve9: folds 
rare12345: raises €0.11 to €0.16
AleactaEst21: folds 
kurikutela53: folds 
Lumifer: calls €0.11
*** FLOP *** [2c 2s 3s]
Lumifer: checks 
rare12345: bets €0.11
Lumifer: calls €0.11
*** TURN *** [2c 2s 3s] [Td]
Lumifer: checks 
rare12345: bets €0.38
Lumifer: folds 
Uncalled bet (€0.38) returned to rare12345
rare12345 collected €0.54 from pot
rare12345: doesn't show hand 
*** SUMMARY ***
Total pot €0.57 | Rake €0.03 
Board [2c 2s 3s Td]
Seat 1: rare12345 (button) collected (€0.54)
Seat 2: AleactaEst21 (small blind) folded before Flop
Seat 3: kurikutela53 (big blind) folded before Flop
Seat 4: POÇAOMAGICA folded before Flop (didn't bet)
Seat 5: Lumifer folded on the Turn
Seat 6: pipinoelbreve9 folded before Flop (didn't bet)



PokerStars Zoom Hand #257562882069:  Hold'em No Limit (€0.01/€0.02) - 2025/08/31 22:35:57 CET [2025/08/31 16:35:57 ET]
Table 'Arneb' 6-max Seat #1 is the button
Seat 1: Chichoampuero12 (€2.68 in chips) 
Seat 2: felgas1968 (€2.29 in chips) 
Seat 3: Yumbele (€1 in chips) 
Seat 4: pipinoelbreve9 (€3.76 in chips) 
Seat 5: Jebahon (€1.74 in chips) 
Seat 6: AleactaEst21 (€2.32 in chips) 
felgas1968: posts small blind €0.01
Yumbele: posts big blind €0.02
*** HOLE CARDS ***
Dealt to pipinoelbreve9 [2d 5h]
pipinoelbreve9: folds 
Jebahon: folds 
AleactaEst21: raises €0.04 to €0.06
Chichoampuero12: folds 
felgas1968: folds 
Yumbele: calls €0.04
*** FLOP *** [Tc Qs Jd]
Yumbele: checks 
AleactaEst21: bets €0.04
Yumbele: calls €0.04
*** TURN *** [Tc Qs Jd] [6d]
Yumbele: checks 
AleactaEst21: bets €0.15
Yumbele: folds 
Uncalled bet (€0.15) returned to AleactaEst21
AleactaEst21 collected €0.20 from pot
AleactaEst21: doesn't show hand 
*** SUMMARY ***
Total pot €0.21 | Rake €0.01 
Board [Tc Qs Jd 6d]
Seat 1: Chichoampuero12 (button) folded before Flop (didn't bet)
Seat 2: felgas1968 (small blind) folded before Flop
Seat 3: Yumbele (big blind) folded on the Turn
Seat 4: pipinoelbreve9 folded before Flop (didn't bet)
Seat 5: Jebahon folded before Flop (didn't bet)
Seat 6: AleactaEst21 collected (€0.20)



PokerStars Zoom Hand #257562880895:  Hold'em No Limit (€0.01/€0.02) - 2025/08/31 22:35:54 CET [2025/08/31 16:35:54 ET]
Table 'Arneb' 6-max Seat #1 is the button
Seat 1: sambupkr (€2 in chips) 
Seat 2: sanpistakio (€1.13 in chips) 
Seat 3: wilbor123 (€2.06 in chips) 
Seat 4: pipinoelbreve9 (€3.76 in chips) 
Seat 5: bdcscstars (€1.75 in chips) 
Seat 6: PkBcN15 (€2.08 in chips) 
sanpistakio: posts small blind €0.01
wilbor123: posts big blind €0.02
*** HOLE CARDS ***
Dealt to pipinoelbreve9 [4s 6d]
pipinoelbreve9: folds 
bdcscstars: folds 
PkBcN15: folds 
sambupkr: raises €0.04 to €0.06
sanpistakio: folds 
wilbor123: calls €0.04
*** FLOP *** [2d Qs Jh]
wilbor123: checks 
sambupkr: bets €0.04
wilbor123: calls €0.04
*** TURN *** [2d Qs Jh] [Kd]
wilbor123: checks 
sambupkr: bets €0.15
wilbor123: calls €0.15
*** RIVER *** [2d Qs Jh Kd] [Qh]
wilbor123: checks 
sambupkr: bets €0.36
wilbor123: raises €1.45 to €1.81 and is all-in
sambupkr: calls €1.39 and is all-in
Uncalled bet (€0.06) returned to wilbor123
*** SHOW DOWN ***
wilbor123: shows [Jc Jd] (a full house, Jacks full of Queens)
sambupkr: shows [Tc Ad] (a straight, Ten to Ace)
wilbor123 collected €3.81 from pot
*** SUMMARY ***
Total pot €4.01 | Rake €0.20 
Board [2d Qs Jh Kd Qh]
Seat 1: sambupkr (button) showed [Tc Ad] and lost with a straight, Ten to Ace
Seat 2: sanpistakio (small blind) folded before Flop
Seat 3: wilbor123 (big blind) showed [Jc Jd] and won (€3.81) with a full house, Jacks full of Queens
Seat 4: pipinoelbreve9 folded before Flop (didn't bet)
Seat 5: bdcscstars folded before Flop (didn't bet)
Seat 6: PkBcN15 folded before Flop (didn't bet)



PokerStars Zoom Hand #257562896732:  Hold'em No Limit (€0.01/€0.02) - 2025/08/31 22:36:43 CET [2025/08/31 16:36:43 ET]
Table 'Arneb' 6-max Seat #1 is the button
Seat 1: Lucasdechaux17 (€1.98 in chips) 
Seat 2: vivilivrevivi26 (€1.75 in chips) 
Seat 3: PkBcN15 (€2.05 in chips) 
Seat 4: ocsur (€1.39 in chips) 
Seat 5: pipinoelbreve9 (€3.79 in chips) 
Seat 6: LuisGR90 (€2.02 in chips) 
vivilivrevivi26: posts small blind €0.01
PkBcN15: posts big blind €0.02
*** HOLE CARDS ***
Dealt to pipinoelbreve9 [4h Js]
ocsur: folds 
pipinoelbreve9: folds 
LuisGR90: folds 
Lucasdechaux17: folds 
vivilivrevivi26: folds 
Uncalled bet (€0.01) returned to PkBcN15
PkBcN15 collected €0.02 from pot
PkBcN15: doesn't show hand 
*** SUMMARY ***
Total pot €0.02 | Rake €0 
Seat 1: Lucasdechaux17 (button) folded before Flop (didn't bet)
Seat 2: vivilivrevivi26 (small blind) folded before Flop
Seat 3: PkBcN15 (big blind) collected (€0.02)
Seat 4: ocsur folded before Flop (didn't bet)
Seat 5: pipinoelbreve9 folded before Flop (didn't bet)
Seat 6: LuisGR90 folded before Flop (didn't bet)



PokerStars Zoom Hand #257562894797:  Hold'em No Limit (€0.01/€0.02) - 2025/08/31 22:36:37 CET [2025/08/31 16:36:37 ET]
Table 'Arneb' 6-max Seat #1 is the button
Seat 1: kurikutela53 (€0.93 in chips) 
Seat 2: Xoco Cusco (€0.47 in chips) 
Seat 3: LGC04 (€2 in chips) 
Seat 4: Chichoampuero12 (€5.30 in chips) 
Seat 5: maximus_powah (€1.65 in chips) 
Seat 6: pipinoelbreve9 (€3.79 in chips) 
Xoco Cusco: posts small blind €0.01
LGC04: posts big blind €0.02
*** HOLE CARDS ***
Dealt to pipinoelbreve9 [7h Jd]
Chichoampuero12: folds 
maximus_powah: raises €0.04 to €0.06
pipinoelbreve9: folds 
kurikutela53: folds 
Xoco Cusco: folds 
LGC04: folds 
Uncalled bet (€0.04) returned to maximus_powah
maximus_powah collected €0.05 from pot
maximus_powah: doesn't show hand 
*** SUMMARY ***
Total pot €0.05 | Rake €0 
Seat 1: kurikutela53 (button) folded before Flop (didn't bet)
Seat 2: Xoco Cusco (small blind) folded before Flop
Seat 3: LGC04 (big blind) folded before Flop
Seat 4: Chichoampuero12 folded before Flop (didn't bet)
Seat 5: maximus_powah collected (€0.05)
Seat 6: pipinoelbreve9 folded before Flop (didn't bet)



PokerStars Zoom Hand #257562898355:  Hold'em No Limit (€0.01/€0.02) - 2025/08/31 22:36:48 CET [2025/08/31 16:36:48 ET]
Table 'Arneb' 6-max Seat #1 is the button
Seat 1: 34pluto (€0.97 in chips) 
Seat 2: Izibeaxh (€3.40 in chips) 
Seat 3: POÇAOMAGICA (€5.62 in chips) 
Seat 4: pipinoelbreve9 (€3.79 in chips) 
Seat 5: Chichoampuero12 (€5.30 in chips) 
Seat 6: sambupkr (€2 in chips) 
Izibeaxh: posts small blind €0.01
POÇAOMAGICA: posts big blind €0.02
*** HOLE CARDS ***
Dealt to pipinoelbreve9 [3c Qd]
pipinoelbreve9: folds 
Chichoampuero12: folds 
sambupkr: folds 
34pluto: folds 
Izibeaxh: folds 
Uncalled bet (€0.01) returned to POÇAOMAGICA
POÇAOMAGICA collected €0.02 from pot
POÇAOMAGICA: doesn't show hand 
*** SUMMARY ***
Total pot €0.02 | Rake €0 
Seat 1: 34pluto (button) folded before Flop (didn't bet)
Seat 2: Izibeaxh (small blind) folded before Flop
Seat 3: POÇAOMAGICA (big blind) collected (€0.02)
Seat 4: pipinoelbreve9 folded before Flop (didn't bet)
Seat 5: Chichoampuero12 folded before Flop (didn't bet)
Seat 6: sambupkr folded before Flop (didn't bet)



PokerStars Zoom Hand #257562893365:  Hold'em No Limit (€0.01/€0.02) - 2025/08/31 22:36:33 CET [2025/08/31 16:36:33 ET]
Table 'Arneb' 6-max Seat #1 is the button
Seat 1: pipinoelbreve9 (€3.79 in chips) 
Seat 2: Chichoampuero12 (€3.48 in chips) 
Seat 3: Xoseanro510 (€2 in chips) 
Seat 4: LGC04 (€2 in chips) 
Seat 5: vivilivrevivi26 (€1.75 in chips) 
Seat 6: Lumifer (€2 in chips) 
Chichoampuero12: posts small blind €0.01
Xoseanro510: posts big blind €0.02
*** HOLE CARDS ***
Dealt to pipinoelbreve9 [4d 9c]
LGC04: folds 
vivilivrevivi26: folds 
Lumifer: folds 
pipinoelbreve9: folds 
Chichoampuero12: raises €0.04 to €0.06
Xoseanro510: calls €0.04
*** FLOP *** [5c 9h 3d]
Chichoampuero12: bets €0.04
Xoseanro510: calls €0.04
*** TURN *** [5c 9h 3d] [6c]
Chichoampuero12: bets €0.14
Xoseanro510: folds 
Uncalled bet (€0.14) returned to Chichoampuero12
Chichoampuero12 collected €0.19 from pot
Chichoampuero12: doesn't show hand 
*** SUMMARY ***
Total pot €0.20 | Rake €0.01 
Board [5c 9h 3d 6c]
Seat 1: pipinoelbreve9 (button) folded before Flop (didn't bet)
Seat 2: Chichoampuero12 (small blind) collected (€0.19)
Seat 3: Xoseanro510 (big blind) folded on the Turn
Seat 4: LGC04 folded before Flop (didn't bet)
Seat 5: vivilivrevivi26 folded before Flop (didn't bet)
Seat 6: Lumifer folded before Flop (didn't bet)



PokerStars Zoom Hand #257562899690:  Hold'em No Limit (€0.01/€0.02) - 2025/08/31 22:36:53 CET [2025/08/31 16:36:53 ET]
Table 'Arneb' 6-max Seat #1 is the button
Seat 1: Pepita71 (€4.25 in chips) 
Seat 2: Lauranve (€1.51 in chips) 
Seat 3: pipinoelbreve9 (€3.79 in chips) 
Seat 4: EiramSenpai (€2.44 in chips) 
Seat 5: rare12345 (€2.63 in chips) 
Seat 6: LGC04 (€1.98 in chips) 
Lauranve: posts small blind €0.01
pipinoelbreve9: posts big blind €0.02
*** HOLE CARDS ***
Dealt to pipinoelbreve9 [9h 2d]
EiramSenpai: folds 
rare12345: folds 
LGC04: folds 
Pepita71: folds 
Lauranve: calls €0.01
pipinoelbreve9: checks 
*** FLOP *** [5s 9c Ad]
Lauranve: checks 
pipinoelbreve9: checks 
*** TURN *** [5s 9c Ad] [3s]
Lauranve: checks 
pipinoelbreve9: bets €0.02
Lauranve: calls €0.02
*** RIVER *** [5s 9c Ad 3s] [Th]
Lauranve: checks 
pipinoelbreve9: checks 
*** SHOW DOWN ***
Lauranve: shows [4s Jc] (high card Ace)
pipinoelbreve9: shows [9h 2d] (a pair of Nines)
pipinoelbreve9 collected €0.08 from pot
*** SUMMARY ***
Total pot €0.08 | Rake €0 
Board [5s 9c Ad 3s Th]
Seat 1: Pepita71 (button) folded before Flop (didn't bet)
Seat 2: Lauranve (small blind) showed [4s Jc] and lost with high card Ace
Seat 3: pipinoelbreve9 (big blind) showed [9h 2d] and won (€0.08) with a pair of Nines
Seat 4: EiramSenpai folded before Flop (didn't bet)
Seat 5: rare12345 folded before Flop (didn't bet)
Seat 6: LGC04 folded before Flop (didn't bet)



PokerStars Zoom Hand #257562915517:  Hold'em No Limit (€0.01/€0.02) - 2025/08/31 22:37:43 CET [2025/08/31 16:37:43 ET]
Table 'Arneb' 6-max Seat #1 is the button
Seat 1: elseneka-1 (€3.02 in chips) 
Seat 2: pipinoelbreve9 (€3.83 in chips) 
Seat 3: 34pluto (€0.99 in chips) 
Seat 4: rare12345 (€2.26 in chips) 
Seat 5: Lauranve (€1.47 in chips) 
Seat 6: error207 (€1.94 in chips) 
pipinoelbreve9: posts small blind €0.01
34pluto: posts big blind €0.02
*** HOLE CARDS ***
Dealt to pipinoelbreve9 [2d Jd]
rare12345: folds 
Lauranve: calls €0.02
error207: raises €0.06 to €0.08
elseneka-1: folds 
pipinoelbreve9: folds 
34pluto: folds 
Lauranve: folds 
Uncalled bet (€0.06) returned to error207
error207 collected €0.07 from pot
error207: doesn't show hand 
*** SUMMARY ***
Total pot €0.07 | Rake €0 
Seat 1: elseneka-1 (button) folded before Flop (didn't bet)
Seat 2: pipinoelbreve9 (small blind) folded before Flop
Seat 3: 34pluto (big blind) folded before Flop
Seat 4: rare12345 folded before Flop (didn't bet)
Seat 5: Lauranve folded before Flop
Seat 6: error207 collected (€0.07)



PokerStars Zoom Hand #257562919519:  Hold'em No Limit (€0.01/€0.02) - 2025/08/31 22:37:55 CET [2025/08/31 16:37:55 ET]
Table 'Arneb' 6-max Seat #1 is the button
Seat 1: pipinoelbreve9 (€3.82 in chips) 
Seat 2: rare12345 (€2.26 in chips) 
Seat 3: AleactaEst21 (€2.38 in chips) 
Seat 4: LuisGR90 (€2.04 in chips) 
Seat 5: scaramouche84 (€2.82 in chips) 
Seat 6: AnxoGM (€2.27 in chips) 
rare12345: posts small blind €0.01
AleactaEst21: posts big blind €0.02
*** HOLE CARDS ***
Dealt to pipinoelbreve9 [Ks 6c]
LuisGR90: raises €0.04 to €0.06
scaramouche84: folds 
AnxoGM: folds 
pipinoelbreve9: folds 
rare12345: folds 
AleactaEst21: folds 
Uncalled bet (€0.04) returned to LuisGR90
LuisGR90 collected €0.05 from pot
LuisGR90: doesn't show hand 
*** SUMMARY ***
Total pot €0.05 | Rake €0 
Seat 1: pipinoelbreve9 (button) folded before Flop (didn't bet)
Seat 2: rare12345 (small blind) folded before Flop
Seat 3: AleactaEst21 (big blind) folded before Flop
Seat 4: LuisGR90 collected (€0.05)
Seat 5: scaramouche84 folded before Flop (didn't bet)
Seat 6: AnxoGM folded before Flop (didn't bet)



PokerStars Zoom Hand #257562923765:  Hold'em No Limit (€0.01/€0.02) - 2025/08/31 22:38:09 CET [2025/08/31 16:38:09 ET]
Table 'Arneb' 6-max Seat #1 is the button
Seat 1: 34pluto (€1 in chips) 
Seat 2: pipinoelbreve9 (€3.82 in chips) 
Seat 3: bdcscstars (€1.79 in chips) 
Seat 4: WJSP (€2 in chips) 
Seat 5: tanoun1 (€2.01 in chips) 
Seat 6: smoking9000 (€1 in chips) 
pipinoelbreve9: posts small blind €0.01
bdcscstars: posts big blind €0.02
*** HOLE CARDS ***
Dealt to pipinoelbreve9 [7c Th]
WJSP: folds 
tanoun1: folds 
smoking9000: folds 
34pluto: folds 
pipinoelbreve9: folds 
Uncalled bet (€0.01) returned to bdcscstars
bdcscstars collected €0.02 from pot
bdcscstars: doesn't show hand 
*** SUMMARY ***
Total pot €0.02 | Rake €0 
Seat 1: 34pluto (button) folded before Flop (didn't bet)
Seat 2: pipinoelbreve9 (small blind) folded before Flop
Seat 3: bdcscstars (big blind) collected (€0.02)
Seat 4: WJSP folded before Flop (didn't bet)
Seat 5: tanoun1 folded before Flop (didn't bet)
Seat 6: smoking9000 folded before Flop (didn't bet)



PokerStars Zoom Hand #257562926749:  Hold'em No Limit (€0.01/€0.02) - 2025/08/31 22:38:18 CET [2025/08/31 16:38:18 ET]
Table 'Arneb' 6-max Seat #1 is the button
Seat 1: pipinoelbreve9 (€3.81 in chips) 
Seat 2: AnxoGM (€3.09 in chips) 
Seat 3: kurikutela53 (€0.95 in chips) 
Seat 4: tanoun1 (€2.16 in chips) 
Seat 5: LuisGR90 (€2.23 in chips) 
Seat 6: juanlu2000china (€2 in chips) 
AnxoGM: posts small blind €0.01
kurikutela53: posts big blind €0.02
*** HOLE CARDS ***
Dealt to pipinoelbreve9 [Ts 2c]
tanoun1: folds 
LuisGR90: folds 
juanlu2000china: folds 
pipinoelbreve9: folds 
AnxoGM: raises €0.04 to €0.06
kurikutela53: folds 
Uncalled bet (€0.04) returned to AnxoGM
AnxoGM collected €0.04 from pot
AnxoGM: doesn't show hand 
*** SUMMARY ***
Total pot €0.04 | Rake €0 
Seat 1: pipinoelbreve9 (button) folded before Flop (didn't bet)
Seat 2: AnxoGM (small blind) collected (€0.04)
Seat 3: kurikutela53 (big blind) folded before Flop
Seat 4: tanoun1 folded before Flop (didn't bet)
Seat 5: LuisGR90 folded before Flop (didn't bet)
Seat 6: juanlu2000china folded before Flop (didn't bet)



PokerStars Zoom Hand #257562922203:  Hold'em No Limit (€0.01/€0.02) - 2025/08/31 22:38:04 CET [2025/08/31 16:38:04 ET]
Table 'Arneb' 6-max Seat #1 is the button
Seat 1: Bestiote (€0.68 in chips) 
Seat 2: charlyleon92 (€2.09 in chips) 
Seat 3: sanpistakio (€1 in chips) 
Seat 4: Minyens33 (€1.38 in chips) 
Seat 5: rare12345 (€2.25 in chips) 
Seat 6: pipinoelbreve9 (€3.82 in chips) 
charlyleon92: posts small blind €0.01
sanpistakio: posts big blind €0.02
*** HOLE CARDS ***
Dealt to pipinoelbreve9 [Th 2c]
Minyens33: calls €0.02
rare12345: folds 
pipinoelbreve9: folds 
Bestiote: folds 
charlyleon92: calls €0.01
sanpistakio: checks 
*** FLOP *** [4h 9d 6h]
charlyleon92: checks 
sanpistakio: checks 
Minyens33: checks 
*** TURN *** [4h 9d 6h] [7h]
charlyleon92: checks 
sanpistakio: checks 
Minyens33: bets €0.06
charlyleon92: folds 
sanpistakio: folds 
Uncalled bet (€0.06) returned to Minyens33
Minyens33 collected €0.06 from pot
Minyens33: doesn't show hand 
*** SUMMARY ***
Total pot €0.06 | Rake €0 
Board [4h 9d 6h 7h]
Seat 1: Bestiote (button) folded before Flop (didn't bet)
Seat 2: charlyleon92 (small blind) folded on the Turn
Seat 3: sanpistakio (big blind) folded on the Turn
Seat 4: Minyens33 collected (€0.06)
Seat 5: rare12345 folded before Flop (didn't bet)
Seat 6: pipinoelbreve9 folded before Flop (didn't bet)



PokerStars Zoom Hand #257562928447:  Hold'em No Limit (€0.01/€0.02) - 2025/08/31 22:38:24 CET [2025/08/31 16:38:24 ET]
Table 'Arneb' 6-max Seat #1 is the button
Seat 1: wilbor123 (€4.95 in chips) 
Seat 2: danywoo (€0.75 in chips) 
Seat 3: pipinoelbreve9 (€3.81 in chips) 
Seat 4: bdcscstars (€1.80 in chips) 
Seat 5: EiramSenpai (€2.24 in chips) 
Seat 6: Chichoampuero12 (€2.26 in chips) 
danywoo: posts small blind €0.01
pipinoelbreve9: posts big blind €0.02
*** HOLE CARDS ***
Dealt to pipinoelbreve9 [7h 9s]
bdcscstars: folds 
EiramSenpai: folds 
Chichoampuero12: folds 
wilbor123: raises €0.04 to €0.06
danywoo: folds 
pipinoelbreve9: folds 
Uncalled bet (€0.04) returned to wilbor123
wilbor123 collected €0.05 from pot
wilbor123: doesn't show hand 
*** SUMMARY ***
Total pot €0.05 | Rake €0 
Seat 1: wilbor123 (button) collected (€0.05)
Seat 2: danywoo (small blind) folded before Flop
Seat 3: pipinoelbreve9 (big blind) folded before Flop
Seat 4: bdcscstars folded before Flop (didn't bet)
Seat 5: EiramSenpai folded before Flop (didn't bet)
Seat 6: Chichoampuero12 folded before Flop (didn't bet)



PokerStars Zoom Hand #257562933948:  Hold'em No Limit (€0.01/€0.02) - 2025/08/31 22:38:41 CET [2025/08/31 16:38:41 ET]
Table 'Arneb' 6-max Seat #1 is the button
Seat 1: rare12345 (€2 in chips) 
Seat 2: POÇAOMAGICA (€3.53 in chips) 
Seat 3: josep10965 (€2.23 in chips) 
Seat 4: Lumifer (€2.14 in chips) 
Seat 5: pipinoelbreve9 (€3.79 in chips) 
Seat 6: WJSP (€2 in chips) 
POÇAOMAGICA: posts small blind €0.01
josep10965: posts big blind €0.02
*** HOLE CARDS ***
Dealt to pipinoelbreve9 [8c 6s]
Lumifer: folds 
pipinoelbreve9: folds 
WJSP: folds 
rare12345: folds 
POÇAOMAGICA: folds 
Uncalled bet (€0.01) returned to josep10965
josep10965 collected €0.02 from pot
josep10965: doesn't show hand 
*** SUMMARY ***
Total pot €0.02 | Rake €0 
Seat 1: rare12345 (button) folded before Flop (didn't bet)
Seat 2: POÇAOMAGICA (small blind) folded before Flop
Seat 3: josep10965 (big blind) collected (€0.02)
Seat 4: Lumifer folded before Flop (didn't bet)
Seat 5: pipinoelbreve9 folded before Flop (didn't bet)
Seat 6: WJSP folded before Flop (didn't bet)



PokerStars Zoom Hand #257562935013:  Hold'em No Limit (€0.01/€0.02) - 2025/08/31 22:38:44 CET [2025/08/31 16:38:44 ET]
Table 'Arneb' 6-max Seat #1 is the button
Seat 1: wilbor123 (€3.85 in chips) 
Seat 2: rare12345 (€2.76 in chips) 
Seat 3: Lumifer (€2.14 in chips) 
Seat 4: LGC04 (€1.88 in chips) 
Seat 5: pipinoelbreve9 (€3.79 in chips) 
Seat 6: tanoun1 (€3.63 in chips) 
rare12345: posts small blind €0.01
Lumifer: posts big blind €0.02
*** HOLE CARDS ***
Dealt to pipinoelbreve9 [2s 8d]
LGC04: folds 
pipinoelbreve9: folds 
tanoun1: folds 
wilbor123: raises €0.04 to €0.06
rare12345: folds 
Lumifer: folds 
Uncalled bet (€0.04) returned to wilbor123
wilbor123 collected €0.05 from pot
wilbor123: doesn't show hand 
*** SUMMARY ***
Total pot €0.05 | Rake €0 
Seat 1: wilbor123 (button) collected (€0.05)
Seat 2: rare12345 (small blind) folded before Flop
Seat 3: Lumifer (big blind) folded before Flop
Seat 4: LGC04 folded before Flop (didn't bet)
Seat 5: pipinoelbreve9 folded before Flop (didn't bet)
Seat 6: tanoun1 folded before Flop (didn't bet)



PokerStars Zoom Hand #257562936263:  Hold'em No Limit (€0.01/€0.02) - 2025/08/31 22:38:49 CET [2025/08/31 16:38:49 ET]
Table 'Arneb' 6-max Seat #1 is the button
Seat 1: DAVVINCI (€2.01 in chips) 
Seat 2: masquisiera (€1 in chips) 
Seat 3: pipinoelbreve9 (€3.79 in chips) 
Seat 4: sambupkr (€2.13 in chips) 
Seat 5: josep10965 (€2.01 in chips) 
Seat 6: sanpistakio (€0.97 in chips) 
masquisiera: posts small blind €0.01
pipinoelbreve9: posts big blind €0.02
*** HOLE CARDS ***
Dealt to pipinoelbreve9 [9d 5d]
sambupkr: folds 
josep10965: folds 
sanpistakio: folds 
DAVVINCI: raises €0.02 to €0.04
masquisiera: folds 
pipinoelbreve9: folds 
Uncalled bet (€0.02) returned to DAVVINCI
DAVVINCI collected €0.05 from pot
DAVVINCI: doesn't show hand 
*** SUMMARY ***
Total pot €0.05 | Rake €0 
Seat 1: DAVVINCI (button) collected (€0.05)
Seat 2: masquisiera (small blind) folded before Flop
Seat 3: pipinoelbreve9 (big blind) folded before Flop
Seat 4: sambupkr folded before Flop (didn't bet)
Seat 5: josep10965 folded before Flop (didn't bet)
Seat 6: sanpistakio folded before Flop (didn't bet)



PokerStars Zoom Hand #257562939804:  Hold'em No Limit (€0.01/€0.02) - 2025/08/31 22:38:59 CET [2025/08/31 16:38:59 ET]
Table 'Arneb' 6-max Seat #1 is the button
Seat 1: Xoco Cusco (€0.46 in chips) 
Seat 2: pipinoelbreve9 (€3.77 in chips) 
Seat 3: Chichoampuero12 (€2.76 in chips) 
Seat 4: nyko2a (€3.21 in chips) 
Seat 5: wilbor123 (€3.88 in chips) 
Seat 6: xhadd (€3.30 in chips) 
pipinoelbreve9: posts small blind €0.01
Chichoampuero12: posts big blind €0.02
*** HOLE CARDS ***
Dealt to pipinoelbreve9 [2d Ad]
nyko2a: raises €0.04 to €0.06
wilbor123: folds 
xhadd: folds 
Xoco Cusco: folds 
pipinoelbreve9: calls €0.05
Chichoampuero12: calls €0.04
*** FLOP *** [8s 3s 8d]
pipinoelbreve9: checks 
Chichoampuero12: checks 
nyko2a: checks 
*** TURN *** [8s 3s 8d] [2c]
pipinoelbreve9: checks 
Chichoampuero12: checks 
nyko2a: checks 
*** RIVER *** [8s 3s 8d 2c] [Ts]
pipinoelbreve9: bets €0.09
Chichoampuero12: folds 
nyko2a: calls €0.09
*** SHOW DOWN ***
pipinoelbreve9: shows [2d Ad] (two pair, Eights and Deuces)
nyko2a: mucks hand 
pipinoelbreve9 collected €0.34 from pot
*** SUMMARY ***
Total pot €0.36 | Rake €0.02 
Board [8s 3s 8d 2c Ts]
Seat 1: Xoco Cusco (button) folded before Flop (didn't bet)
Seat 2: pipinoelbreve9 (small blind) showed [2d Ad] and won (€0.34) with two pair, Eights and Deuces
Seat 3: Chichoampuero12 (big blind) folded on the River
Seat 4: nyko2a mucked [Ac Js]
Seat 5: wilbor123 folded before Flop (didn't bet)
Seat 6: xhadd folded before Flop (didn't bet)



PokerStars Zoom Hand #257562925334:  Hold'em No Limit (€0.01/€0.02) - 2025/08/31 22:38:14 CET [2025/08/31 16:38:14 ET]
Table 'Arneb' 6-max Seat #1 is the button
Seat 1: maximus_powah (€2 in chips) 
Seat 2: McDodo86 (€1.11 in chips) 
Seat 3: Xoseanro510 (€2 in chips) 
Seat 4: pipinoelbreve9 (€3.81 in chips) 
Seat 5: Fr@nkys (€2.78 in chips) 
Seat 6: kurikutela53 (€0.95 in chips) 
McDodo86: posts small blind €0.01
Xoseanro510: posts big blind €0.02
*** HOLE CARDS ***
Dealt to pipinoelbreve9 [6h Ah]
pipinoelbreve9: folds 
Fr@nkys: folds 
kurikutela53: folds 
maximus_powah: raises €0.03 to €0.05
McDodo86: calls €0.04
Xoseanro510: calls €0.03
*** FLOP *** [8h 5d 9s]
McDodo86: checks 
Xoseanro510: bets €0.11
maximus_powah: calls €0.11
McDodo86: calls €0.11
*** TURN *** [8h 5d 9s] [Kh]
McDodo86: checks 
Xoseanro510: checks 
maximus_powah: bets €0.35
McDodo86: folds 
Xoseanro510: folds 
Uncalled bet (€0.35) returned to maximus_powah
maximus_powah collected €0.46 from pot
maximus_powah: doesn't show hand 
*** SUMMARY ***
Total pot €0.48 | Rake €0.02 
Board [8h 5d 9s Kh]
Seat 1: maximus_powah (button) collected (€0.46)
Seat 2: McDodo86 (small blind) folded on the Turn
Seat 3: Xoseanro510 (big blind) folded on the Turn
Seat 4: pipinoelbreve9 folded before Flop (didn't bet)
Seat 5: Fr@nkys folded before Flop (didn't bet)
Seat 6: kurikutela53 folded before Flop (didn't bet)



PokerStars Zoom Hand #257562953441:  Hold'em No Limit (€0.01/€0.02) - 2025/08/31 22:39:43 CET [2025/08/31 16:39:43 ET]
Table 'Arneb' 6-max Seat #1 is the button
Seat 1: Chichoampuero12 (€2.30 in chips) 
Seat 2: Xoseanro510 (€2.20 in chips) 
Seat 3: ana paula900 (€1.16 in chips) 
Seat 4: POÇAOMAGICA (€2.06 in chips) 
Seat 5: bdcscstars (€1.89 in chips) 
Seat 6: pipinoelbreve9 (€3.96 in chips) 
Xoseanro510: posts small blind €0.01
ana paula900: posts big blind €0.02
*** HOLE CARDS ***
Dealt to pipinoelbreve9 [3s 5c]
POÇAOMAGICA: calls €0.02
bdcscstars: folds 
pipinoelbreve9: folds 
Chichoampuero12: raises €0.06 to €0.08
Xoseanro510: raises €0.20 to €0.28
ana paula900: folds 
POÇAOMAGICA: folds 
Chichoampuero12: folds 
Uncalled bet (€0.20) returned to Xoseanro510
Xoseanro510 collected €0.20 from pot
Xoseanro510: doesn't show hand 
*** SUMMARY ***
Total pot €0.20 | Rake €0 
Seat 1: Chichoampuero12 (button) folded before Flop
Seat 2: Xoseanro510 (small blind) collected (€0.20)
Seat 3: ana paula900 (big blind) folded before Flop
Seat 4: POÇAOMAGICA folded before Flop
Seat 5: bdcscstars folded before Flop (didn't bet)
Seat 6: pipinoelbreve9 folded before Flop (didn't bet)



PokerStars Zoom Hand #257562960974:  Hold'em No Limit (€0.01/€0.02) - 2025/08/31 22:40:07 CET [2025/08/31 16:40:07 ET]
Table 'Arneb' 6-max Seat #1 is the button
Seat 1: josep10965 (€2 in chips) 
Seat 2: 34pluto (€1.77 in chips) 
Seat 3: Chichoampuero12 (€5.24 in chips) 
Seat 4: pipinoelbreve9 (€3.96 in chips) 
Seat 5: Lucasdechaux17 (€2.22 in chips) 
Seat 6: Fr@nkys (€2.92 in chips) 
34pluto: posts small blind €0.01
Chichoampuero12: posts big blind €0.02
*** HOLE CARDS ***
Dealt to pipinoelbreve9 [Ad 6c]
pipinoelbreve9: folds 
Lucasdechaux17: folds 
Fr@nkys: folds 
josep10965: folds 
34pluto: folds 
Uncalled bet (€0.01) returned to Chichoampuero12
Chichoampuero12 collected €0.02 from pot
Chichoampuero12: doesn't show hand 
*** SUMMARY ***
Total pot €0.02 | Rake €0 
Seat 1: josep10965 (button) folded before Flop (didn't bet)
Seat 2: 34pluto (small blind) folded before Flop
Seat 3: Chichoampuero12 (big blind) collected (€0.02)
Seat 4: pipinoelbreve9 folded before Flop (didn't bet)
Seat 5: Lucasdechaux17 folded before Flop (didn't bet)
Seat 6: Fr@nkys folded before Flop (didn't bet)



PokerStars Zoom Hand #257562962911:  Hold'em No Limit (€0.01/€0.02) - 2025/08/31 22:40:13 CET [2025/08/31 16:40:13 ET]
Table 'Arneb' 6-max Seat #1 is the button
Seat 1: sambupkr (€2.04 in chips) 
Seat 2: DAVVINCI (€2.06 in chips) 
Seat 3: felgas1968 (€4.33 in chips) 
Seat 4: 28chan28 (€2.32 in chips) 
Seat 5: pipinoelbreve9 (€3.96 in chips) 
Seat 6: Lumifer (€2.05 in chips) 
DAVVINCI: posts small blind €0.01
felgas1968: posts big blind €0.02
*** HOLE CARDS ***
Dealt to pipinoelbreve9 [Qc As]
28chan28: raises €0.02 to €0.04
pipinoelbreve9: raises €0.10 to €0.14
Lumifer: folds 
sambupkr: folds 
DAVVINCI: folds 
felgas1968: folds 
28chan28: folds 
Uncalled bet (€0.10) returned to pipinoelbreve9
pipinoelbreve9 collected €0.11 from pot
pipinoelbreve9: doesn't show hand 
*** SUMMARY ***
Total pot €0.11 | Rake €0 
Seat 1: sambupkr (button) folded before Flop (didn't bet)
Seat 2: DAVVINCI (small blind) folded before Flop
Seat 3: felgas1968 (big blind) folded before Flop
Seat 4: 28chan28 folded before Flop
Seat 5: pipinoelbreve9 collected (€0.11)
Seat 6: Lumifer folded before Flop (didn't bet)



PokerStars Zoom Hand #257562955931:  Hold'em No Limit (€0.01/€0.02) - 2025/08/31 22:39:51 CET [2025/08/31 16:39:51 ET]
Table 'Arneb' 6-max Seat #1 is the button
Seat 1: pipinoelbreve9 (€3.96 in chips) 
Seat 2: lorocontento (€1 in chips) 
Seat 3: Andres010328 (€1 in chips) 
Seat 4: Fulcrumm (€0.99 in chips) 
Seat 5: masquisiera (€1.11 in chips) 
Seat 6: bdcscstars (€1.75 in chips) 
lorocontento: posts small blind €0.01
Andres010328: posts big blind €0.02
*** HOLE CARDS ***
Dealt to pipinoelbreve9 [3d Qd]
Fulcrumm: folds 
masquisiera: raises €0.04 to €0.06
bdcscstars: raises €0.12 to €0.18
pipinoelbreve9: folds 
lorocontento: folds 
Andres010328: folds 
masquisiera: calls €0.12
*** FLOP *** [5c Kd 8s]
masquisiera: checks 
bdcscstars: bets €0.19
masquisiera: calls €0.19
*** TURN *** [5c Kd 8s] [Jh]
masquisiera: checks 
bdcscstars: checks 
*** RIVER *** [5c Kd 8s Jh] [8h]
masquisiera: bets €0.74 and is all-in
bdcscstars: folds 
Uncalled bet (€0.74) returned to masquisiera
masquisiera collected €0.73 from pot
masquisiera: doesn't show hand 
*** SUMMARY ***
Total pot €0.77 | Rake €0.04 
Board [5c Kd 8s Jh 8h]
Seat 1: pipinoelbreve9 (button) folded before Flop (didn't bet)
Seat 2: lorocontento (small blind) folded before Flop
Seat 3: Andres010328 (big blind) folded before Flop
Seat 4: Fulcrumm folded before Flop (didn't bet)
Seat 5: masquisiera collected (€0.73)
Seat 6: bdcscstars folded on the River



PokerStars Zoom Hand #257562967849:  Hold'em No Limit (€0.01/€0.02) - 2025/08/31 22:40:29 CET [2025/08/31 16:40:29 ET]
Table 'Arneb' 6-max Seat #1 is the button
Seat 1: pipinoelbreve9 (€4.03 in chips) 
Seat 2: 28chan28 (€2.28 in chips) 
Seat 3: Cruasan17 (€1.88 in chips) 
Seat 4: 34pluto (€0.87 in chips) 
Seat 5: tanoun1 (€3.56 in chips) 
Seat 6: WJSP (€2.05 in chips) 
28chan28: posts small blind €0.01
Cruasan17: posts big blind €0.02
*** HOLE CARDS ***
Dealt to pipinoelbreve9 [Ah Jd]
34pluto: folds 
tanoun1: folds 
WJSP: folds 
pipinoelbreve9: raises €0.04 to €0.06
28chan28: folds 
Cruasan17: calls €0.04
*** FLOP *** [Qc 8s Qs]
Cruasan17: checks 
pipinoelbreve9: checks 
*** TURN *** [Qc 8s Qs] [Ks]
Cruasan17: checks 
pipinoelbreve9: bets €0.06
Cruasan17: folds 
Uncalled bet (€0.06) returned to pipinoelbreve9
pipinoelbreve9 collected €0.12 from pot
pipinoelbreve9: doesn't show hand 
*** SUMMARY ***
Total pot €0.13 | Rake €0.01 
Board [Qc 8s Qs Ks]
Seat 1: pipinoelbreve9 (button) collected (€0.12)
Seat 2: 28chan28 (small blind) folded before Flop
Seat 3: Cruasan17 (big blind) folded on the Turn
Seat 4: 34pluto folded before Flop (didn't bet)
Seat 5: tanoun1 folded before Flop (didn't bet)
Seat 6: WJSP folded before Flop (didn't bet)



PokerStars Zoom Hand #257562959686:  Hold'em No Limit (€0.01/€0.02) - 2025/08/31 22:40:03 CET [2025/08/31 16:40:03 ET]
Table 'Arneb' 6-max Seat #1 is the button
Seat 1: nyko2a (€3.04 in chips) 
Seat 2: wilbor123 (€4.99 in chips) 
Seat 3: charlyleon92 (€1.98 in chips) 
Seat 4: WJSP (€2.28 in chips) 
Seat 5: Jebahon (€1.73 in chips) 
Seat 6: pipinoelbreve9 (€3.96 in chips) 
wilbor123: posts small blind €0.01
charlyleon92: posts big blind €0.02
*** HOLE CARDS ***
Dealt to pipinoelbreve9 [9h 3c]
nyko2a is disconnected 
WJSP: folds 
Jebahon: calls €0.02
pipinoelbreve9: folds 
nyko2a has timed out while disconnected
nyko2a: folds 
wilbor123: calls €0.01
charlyleon92: checks 
*** FLOP *** [7d 2s 4d]
wilbor123: checks 
charlyleon92: bets €0.06
Jebahon: calls €0.06
wilbor123: calls €0.06
*** TURN *** [7d 2s 4d] [Ad]
wilbor123: checks 
charlyleon92: checks 
Jebahon: bets €0.14
wilbor123: calls €0.14
charlyleon92: folds 
*** RIVER *** [7d 2s 4d Ad] [3s]
wilbor123: checks 
Jebahon: checks 
*** SHOW DOWN ***
wilbor123: shows [3d As] (two pair, Aces and Threes)
Jebahon: shows [Ah Ac] (three of a kind, Aces)
Jebahon collected €0.49 from pot
*** SUMMARY ***
Total pot €0.52 | Rake €0.03 
Board [7d 2s 4d Ad 3s]
Seat 1: nyko2a (button) folded before Flop (didn't bet)
Seat 2: wilbor123 (small blind) showed [3d As] and lost with two pair, Aces and Threes
Seat 3: charlyleon92 (big blind) folded on the Turn
Seat 4: WJSP folded before Flop (didn't bet)
Seat 5: Jebahon showed [Ah Ac] and won (€0.49) with three of a kind, Aces
Seat 6: pipinoelbreve9 folded before Flop (didn't bet)



PokerStars Zoom Hand #257562976130:  Hold'em No Limit (€0.01/€0.02) - 2025/08/31 22:40:55 CET [2025/08/31 16:40:55 ET]
Table 'Arneb' 6-max Seat #1 is the button
Seat 1: LGC04 (€1.87 in chips) 
Seat 2: sambupkr (€2.03 in chips) 
Seat 3: pipinoelbreve9 (€4.09 in chips) 
Seat 4: Fr@nkys (€2.44 in chips) 
Seat 5: Yumbele (€1.09 in chips) 
Seat 6: RCSA2 (€1.71 in chips) 
sambupkr: posts small blind €0.01
pipinoelbreve9: posts big blind €0.02
*** HOLE CARDS ***
Dealt to pipinoelbreve9 [4h 2h]
Fr@nkys: folds 
Yumbele: raises €0.08 to €0.10
RCSA2: folds 
LGC04: folds 
sambupkr: folds 
pipinoelbreve9: folds 
Uncalled bet (€0.08) returned to Yumbele
Yumbele collected €0.05 from pot
Yumbele: doesn't show hand 
*** SUMMARY ***
Total pot €0.05 | Rake €0 
Seat 1: LGC04 (button) folded before Flop (didn't bet)
Seat 2: sambupkr (small blind) folded before Flop
Seat 3: pipinoelbreve9 (big blind) folded before Flop
Seat 4: Fr@nkys folded before Flop (didn't bet)
Seat 5: Yumbele collected (€0.05)
Seat 6: RCSA2 folded before Flop (didn't bet)



PokerStars Zoom Hand #257562980475:  Hold'em No Limit (€0.01/€0.02) - 2025/08/31 22:41:09 CET [2025/08/31 16:41:09 ET]
Table 'Arneb' 6-max Seat #1 is the button
Seat 1: WJSP (€2.24 in chips) 
Seat 2: pipinoelbreve9 (€4.07 in chips) 
Seat 3: kurikutela53 (€0.79 in chips) 
Seat 4: maximus_powah (€2.60 in chips) 
Seat 5: LGC04 (€1.87 in chips) 
Seat 6: Lumifer (€2.02 in chips) 
pipinoelbreve9: posts small blind €0.01
kurikutela53: posts big blind €0.02
*** HOLE CARDS ***
Dealt to pipinoelbreve9 [9d Ad]
maximus_powah: folds 
LGC04: folds 
Lumifer: folds 
WJSP: folds 
pipinoelbreve9: raises €0.04 to €0.06
kurikutela53: folds 
Uncalled bet (€0.04) returned to pipinoelbreve9
pipinoelbreve9 collected €0.04 from pot
pipinoelbreve9: doesn't show hand 
*** SUMMARY ***
Total pot €0.04 | Rake €0 
Seat 1: WJSP (button) folded before Flop (didn't bet)
Seat 2: pipinoelbreve9 (small blind) collected (€0.04)
Seat 3: kurikutela53 (big blind) folded before Flop
Seat 4: maximus_powah folded before Flop (didn't bet)
Seat 5: LGC04 folded before Flop (didn't bet)
Seat 6: Lumifer folded before Flop (didn't bet)



PokerStars Zoom Hand #257562983775:  Hold'em No Limit (€0.01/€0.02) - 2025/08/31 22:41:20 CET [2025/08/31 16:41:20 ET]
Table 'Arneb' 6-max Seat #1 is the button
Seat 1: vivilivrevivi26 (€1.23 in chips) 
Seat 2: 34pluto (€0.70 in chips) 
Seat 3: Fulcrumm (€0.83 in chips) 
Seat 4: pipinoelbreve9 (€4.09 in chips) 
Seat 5: elseneka-1 (€3.06 in chips) 
Seat 6: Xoseanro510 (€2.29 in chips) 
34pluto: posts small blind €0.01
Fulcrumm: posts big blind €0.02
*** HOLE CARDS ***
Dealt to pipinoelbreve9 [3d As]
pipinoelbreve9: folds 
elseneka-1 has timed out
elseneka-1: folds 
Xoseanro510: folds 
vivilivrevivi26: folds 
34pluto: folds 
Uncalled bet (€0.01) returned to Fulcrumm
Fulcrumm collected €0.02 from pot
Fulcrumm: doesn't show hand 
*** SUMMARY ***
Total pot €0.02 | Rake €0 
Seat 1: vivilivrevivi26 (button) folded before Flop (didn't bet)
Seat 2: 34pluto (small blind) folded before Flop
Seat 3: Fulcrumm (big blind) collected (€0.02)
Seat 4: pipinoelbreve9 folded before Flop (didn't bet)
Seat 5: elseneka-1 folded before Flop (didn't bet)
Seat 6: Xoseanro510 folded before Flop (didn't bet)



PokerStars Zoom Hand #257562985002:  Hold'em No Limit (€0.01/€0.02) - 2025/08/31 22:41:24 CET [2025/08/31 16:41:24 ET]
Table 'Arneb' 6-max Seat #1 is the button
Seat 1: sambupkr (€2.12 in chips) 
Seat 2: 34pluto (€1.74 in chips) 
Seat 3: ericerev (€0.95 in chips) 
Seat 4: Pepita71 (€4.68 in chips) 
Seat 5: pipinoelbreve9 (€4.09 in chips) 
Seat 6: LGC04 (€1.85 in chips) 
34pluto: posts small blind €0.01
ericerev: posts big blind €0.02
*** HOLE CARDS ***
Dealt to pipinoelbreve9 [Jc 8d]
Pepita71: folds 
pipinoelbreve9: folds 
LGC04: raises €0.02 to €0.04
sambupkr: folds 
34pluto: folds 
ericerev: calls €0.02
*** FLOP *** [Qh 5h 8h]
ericerev: checks 
LGC04: checks 
*** TURN *** [Qh 5h 8h] [Th]
ericerev: bets €0.02
LGC04: calls €0.02
*** RIVER *** [Qh 5h 8h Th] [Ts]
ericerev: bets €0.02
LGC04: raises €0.08 to €0.10
ericerev: calls €0.08
*** SHOW DOWN ***
LGC04: shows [Qc Tc] (a full house, Tens full of Queens)
ericerev: mucks hand 
LGC04 collected €0.31 from pot
*** SUMMARY ***
Total pot €0.33 | Rake €0.02 
Board [Qh 5h 8h Th Ts]
Seat 1: sambupkr (button) folded before Flop (didn't bet)
Seat 2: 34pluto (small blind) folded before Flop
Seat 3: ericerev (big blind) mucked [3s Ah]
Seat 4: Pepita71 folded before Flop (didn't bet)
Seat 5: pipinoelbreve9 folded before Flop (didn't bet)
Seat 6: LGC04 showed [Qc Tc] and won (€0.31) with a full house, Tens full of Queens



PokerStars Zoom Hand #257562986236:  Hold'em No Limit (€0.01/€0.02) - 2025/08/31 22:41:28 CET [2025/08/31 16:41:28 ET]
Table 'Arneb' 6-max Seat #1 is the button
Seat 1: AnxoGM (€2.03 in chips) 
Seat 2: WJSP (€2.06 in chips) 
Seat 3: pipinoelbreve9 (€4.09 in chips) 
Seat 4: bdcscstars (€1.81 in chips) 
Seat 5: 34pluto (€1.73 in chips) 
Seat 6: Andres010328 (€0.83 in chips) 
WJSP: posts small blind €0.01
pipinoelbreve9: posts big blind €0.02
*** HOLE CARDS ***
Dealt to pipinoelbreve9 [9d Tc]
bdcscstars: folds 
34pluto: folds 
Andres010328: raises €0.02 to €0.04
AnxoGM: folds 
WJSP: folds 
pipinoelbreve9: calls €0.02
*** FLOP *** [2h 7s Ks]
pipinoelbreve9: checks 
Andres010328: checks 
*** TURN *** [2h 7s Ks] [6d]
pipinoelbreve9: checks 
Andres010328: bets €0.04
pipinoelbreve9: folds 
Uncalled bet (€0.04) returned to Andres010328
Andres010328 collected €0.09 from pot
Andres010328: doesn't show hand 
*** SUMMARY ***
Total pot €0.09 | Rake €0 
Board [2h 7s Ks 6d]
Seat 1: AnxoGM (button) folded before Flop (didn't bet)
Seat 2: WJSP (small blind) folded before Flop
Seat 3: pipinoelbreve9 (big blind) folded on the Turn
Seat 4: bdcscstars folded before Flop (didn't bet)
Seat 5: 34pluto folded before Flop (didn't bet)
Seat 6: Andres010328 collected (€0.09)



PokerStars Zoom Hand #257562997783:  Hold'em No Limit (€0.01/€0.02) - 2025/08/31 22:42:05 CET [2025/08/31 16:42:05 ET]
Table 'Arneb' 6-max Seat #1 is the button
Seat 1: sambupkr (€4.20 in chips) 
Seat 2: pipinoelbreve9 (€4.05 in chips) 
Seat 3: LGC04 (€1.84 in chips) 
Seat 4: tanoun1 (€4.83 in chips) 
Seat 5: WJSP (€2.22 in chips) 
Seat 6: Jebahon (€2 in chips) 
pipinoelbreve9: posts small blind €0.01
LGC04: posts big blind €0.02
*** HOLE CARDS ***
Dealt to pipinoelbreve9 [Jd 9d]
tanoun1: folds 
WJSP: folds 
Jebahon: folds 
sambupkr: folds 
pipinoelbreve9: raises €0.04 to €0.06
LGC04: calls €0.04
*** FLOP *** [Ac Jh 2s]
pipinoelbreve9: checks 
LGC04: bets €0.04
pipinoelbreve9: calls €0.04
*** TURN *** [Ac Jh 2s] [3c]
pipinoelbreve9: checks 
LGC04: checks 
*** RIVER *** [Ac Jh 2s 3c] [2c]
pipinoelbreve9: checks 
LGC04: bets €0.04
pipinoelbreve9: calls €0.04
*** SHOW DOWN ***
LGC04: shows [Ad Qd] (two pair, Aces and Deuces)
pipinoelbreve9: mucks hand 
LGC04 collected €0.27 from pot
*** SUMMARY ***
Total pot €0.28 | Rake €0.01 
Board [Ac Jh 2s 3c 2c]
Seat 1: sambupkr (button) folded before Flop (didn't bet)
Seat 2: pipinoelbreve9 (small blind) mucked [Jd 9d]
Seat 3: LGC04 (big blind) showed [Ad Qd] and won (€0.27) with two pair, Aces and Deuces
Seat 4: tanoun1 folded before Flop (didn't bet)
Seat 5: WJSP folded before Flop (didn't bet)
Seat 6: Jebahon folded before Flop (didn't bet)



PokerStars Zoom Hand #257563015338:  Hold'em No Limit (€0.01/€0.02) - 2025/08/31 22:43:00 CET [2025/08/31 16:43:00 ET]
Table 'Arneb' 6-max Seat #1 is the button
Seat 1: maximus_powah (€2.05 in chips) 
Seat 2: AleactaEst21 (€2.28 in chips) 
Seat 3: scaramouche84 (€2.68 in chips) 
Seat 4: LGC04 (€1.97 in chips) 
Seat 5: sambupkr (€2 in chips) 
Seat 6: pipinoelbreve9 (€3.91 in chips) 
AleactaEst21: posts small blind €0.01
scaramouche84: posts big blind €0.02
*** HOLE CARDS ***
Dealt to pipinoelbreve9 [Qd 4c]
LGC04: folds 
sambupkr: folds 
pipinoelbreve9: folds 
maximus_powah: folds 
AleactaEst21: folds 
Uncalled bet (€0.01) returned to scaramouche84
scaramouche84 collected €0.02 from pot
scaramouche84: doesn't show hand 
*** SUMMARY ***
Total pot €0.02 | Rake €0 
Seat 1: maximus_powah (button) folded before Flop (didn't bet)
Seat 2: AleactaEst21 (small blind) folded before Flop
Seat 3: scaramouche84 (big blind) collected (€0.02)
Seat 4: LGC04 folded before Flop (didn't bet)
Seat 5: sambupkr folded before Flop (didn't bet)
Seat 6: pipinoelbreve9 folded before Flop (didn't bet)



PokerStars Zoom Hand #257563017581:  Hold'em No Limit (€0.01/€0.02) - 2025/08/31 22:43:08 CET [2025/08/31 16:43:08 ET]
Table 'Arneb' 6-max Seat #1 is the button
Seat 1: 34pluto (€1.73 in chips) 
Seat 2: AnxoGM (€2.10 in chips) 
Seat 3: Minyens33 (€2.07 in chips) 
Seat 4: Jebahon (€2.02 in chips) 
Seat 5: pipinoelbreve9 (€3.91 in chips) 
Seat 6: charlyleon92 (€2.33 in chips) 
AnxoGM: posts small blind €0.01
Minyens33: posts big blind €0.02
*** HOLE CARDS ***
Dealt to pipinoelbreve9 [4c 2c]
Jebahon: folds 
pipinoelbreve9: folds 
charlyleon92: folds 
34pluto: folds 
AnxoGM: raises €0.04 to €0.06
Minyens33: calls €0.04
*** FLOP *** [2s 8s Ad]
AnxoGM: checks 
Minyens33: checks 
*** TURN *** [2s 8s Ad] [7d]
AnxoGM: bets €0.08
Minyens33: folds 
Uncalled bet (€0.08) returned to AnxoGM
AnxoGM collected €0.11 from pot
AnxoGM: doesn't show hand 
*** SUMMARY ***
Total pot €0.12 | Rake €0.01 
Board [2s 8s Ad 7d]
Seat 1: 34pluto (button) folded before Flop (didn't bet)
Seat 2: AnxoGM (small blind) collected (€0.11)
Seat 3: Minyens33 (big blind) folded on the Turn
Seat 4: Jebahon folded before Flop (didn't bet)
Seat 5: pipinoelbreve9 folded before Flop (didn't bet)
Seat 6: charlyleon92 folded before Flop (didn't bet)



PokerStars Zoom Hand #257563019173:  Hold'em No Limit (€0.01/€0.02) - 2025/08/31 22:43:13 CET [2025/08/31 16:43:13 ET]
Table 'Arneb' 6-max Seat #1 is the button
Seat 1: winie66 (€1.81 in chips) 
Seat 2: Belezaso21 (€1.31 in chips) 
Seat 3: kurikutela53 (€0.71 in chips) 
Seat 4: LGC04 (€2 in chips) 
Seat 5: tanoun1 (€3.50 in chips) 
Seat 6: pipinoelbreve9 (€3.91 in chips) 
Belezaso21: posts small blind €0.01
kurikutela53: posts big blind €0.02
*** HOLE CARDS ***
Dealt to pipinoelbreve9 [Qd 8d]
LGC04: folds 
tanoun1: raises €0.03 to €0.05
pipinoelbreve9: calls €0.05
winie66: folds 
Belezaso21: folds 
kurikutela53: folds 
*** FLOP *** [Kc 5s Ks]
tanoun1: checks 
pipinoelbreve9: checks 
*** TURN *** [Kc 5s Ks] [Ah]
tanoun1: checks 
pipinoelbreve9: checks 
*** RIVER *** [Kc 5s Ks Ah] [9h]
tanoun1: checks 
pipinoelbreve9: checks 
*** SHOW DOWN ***
tanoun1: shows [4s 4d] (two pair, Kings and Fours)
pipinoelbreve9: mucks hand 
tanoun1 collected €0.12 from pot
*** SUMMARY ***
Total pot €0.13 | Rake €0.01 
Board [Kc 5s Ks Ah 9h]
Seat 1: winie66 (button) folded before Flop (didn't bet)
Seat 2: Belezaso21 (small blind) folded before Flop
Seat 3: kurikutela53 (big blind) folded before Flop
Seat 4: LGC04 folded before Flop (didn't bet)
Seat 5: tanoun1 showed [4s 4d] and won (€0.12) with two pair, Kings and Fours
Seat 6: pipinoelbreve9 mucked [Qd 8d]



PokerStars Zoom Hand #257563029630:  Hold'em No Limit (€0.01/€0.02) - 2025/08/31 22:43:46 CET [2025/08/31 16:43:46 ET]
Table 'Arneb' 6-max Seat #1 is the button
Seat 1: xhadd (€3.73 in chips) 
Seat 2: Xexugol (€2.05 in chips) 
Seat 3: ocsur (€1.69 in chips) 
Seat 4: pipinoelbreve9 (€3.86 in chips) 
Seat 5: LuisGR90 (€2.03 in chips) 
Seat 6: 34pluto (€1.70 in chips) 
Xexugol: posts small blind €0.01
ocsur: posts big blind €0.02
*** HOLE CARDS ***
Dealt to pipinoelbreve9 [3d Td]
pipinoelbreve9: folds 
LuisGR90: folds 
34pluto: folds 
xhadd: folds 
Xexugol: folds 
Uncalled bet (€0.01) returned to ocsur
ocsur collected €0.02 from pot
ocsur: doesn't show hand 
*** SUMMARY ***
Total pot €0.02 | Rake €0 
Seat 1: xhadd (button) folded before Flop (didn't bet)
Seat 2: Xexugol (small blind) folded before Flop
Seat 3: ocsur (big blind) collected (€0.02)
Seat 4: pipinoelbreve9 folded before Flop (didn't bet)
Seat 5: LuisGR90 folded before Flop (didn't bet)
Seat 6: 34pluto folded before Flop (didn't bet)



PokerStars Zoom Hand #257563030813:  Hold'em No Limit (€0.01/€0.02) - 2025/08/31 22:43:50 CET [2025/08/31 16:43:50 ET]
Table 'Arneb' 6-max Seat #1 is the button
Seat 1: AleactaEst21 (€2.49 in chips) 
Seat 2: pingu_771 (€2.12 in chips) 
Seat 3: juanlu2000china (€1.81 in chips) 
Seat 4: Strlen83 (€2.09 in chips) 
Seat 5: pipinoelbreve9 (€3.86 in chips) 
Seat 6: Lumifer (€2.46 in chips) 
pingu_771: posts small blind €0.01
juanlu2000china: posts big blind €0.02
*** HOLE CARDS ***
Dealt to pipinoelbreve9 [5d 5s]
Strlen83: folds 
pipinoelbreve9: raises €0.04 to €0.06
Lumifer: folds 
AleactaEst21: folds 
pingu_771: folds 
juanlu2000china: folds 
Uncalled bet (€0.04) returned to pipinoelbreve9
pipinoelbreve9 collected €0.05 from pot
pipinoelbreve9: doesn't show hand 
*** SUMMARY ***
Total pot €0.05 | Rake €0 
Seat 1: AleactaEst21 (button) folded before Flop (didn't bet)
Seat 2: pingu_771 (small blind) folded before Flop
Seat 3: juanlu2000china (big blind) folded before Flop
Seat 4: Strlen83 folded before Flop (didn't bet)
Seat 5: pipinoelbreve9 collected (€0.05)
Seat 6: Lumifer folded before Flop (didn't bet)



PokerStars Zoom Hand #257563026764:  Hold'em No Limit (€0.01/€0.02) - 2025/08/31 22:43:37 CET [2025/08/31 16:43:37 ET]
Table 'Arneb' 6-max Seat #1 is the button
Seat 1: pipinoelbreve9 (€3.86 in chips) 
Seat 2: masquisiera (€1 in chips) 
Seat 3: wilbor123 (€3.93 in chips) 
Seat 4: Xoco Cusco (€2.25 in chips) 
Seat 5: LGC04 (€1.93 in chips) 
Seat 6: WJSP (€2.16 in chips) 
masquisiera: posts small blind €0.01
wilbor123: posts big blind €0.02
*** HOLE CARDS ***
Dealt to pipinoelbreve9 [8s Ac]
Xoco Cusco: folds 
LGC04: raises €0.02 to €0.04
WJSP: folds 
pipinoelbreve9: folds 
masquisiera: folds 
wilbor123: calls €0.02
*** FLOP *** [Kh Ad 3c]
wilbor123: checks 
LGC04: bets €0.02
wilbor123: folds 
Uncalled bet (€0.02) returned to LGC04
LGC04 collected €0.09 from pot
LGC04: doesn't show hand 
*** SUMMARY ***
Total pot €0.09 | Rake €0 
Board [Kh Ad 3c]
Seat 1: pipinoelbreve9 (button) folded before Flop (didn't bet)
Seat 2: masquisiera (small blind) folded before Flop
Seat 3: wilbor123 (big blind) folded on the Flop
Seat 4: Xoco Cusco folded before Flop (didn't bet)
Seat 5: LGC04 collected (€0.09)
Seat 6: WJSP folded before Flop (didn't bet)



PokerStars Zoom Hand #257563035773:  Hold'em No Limit (€0.01/€0.02) - 2025/08/31 22:44:06 CET [2025/08/31 16:44:06 ET]
Table 'Arneb' 6-max Seat #1 is the button
Seat 1: LuisGR90 (€2 in chips) 
Seat 2: RCSA2 (€1.89 in chips) 
Seat 3: maximus_powah (€1.81 in chips) 
Seat 4: pipinoelbreve9 (€3.89 in chips) 
Seat 5: AnxoGM (€2.67 in chips) 
Seat 6: pingu_771 (€2.11 in chips) 
RCSA2: posts small blind €0.01
maximus_powah: posts big blind €0.02
*** HOLE CARDS ***
Dealt to pipinoelbreve9 [Js 3s]
pipinoelbreve9: folds 
AnxoGM: folds 
pingu_771: folds 
LuisGR90: raises €0.03 to €0.05
RCSA2: folds 
maximus_powah: calls €0.03
*** FLOP *** [8s 8c Jc]
maximus_powah: checks 
LuisGR90: bets €0.03
maximus_powah: folds 
Uncalled bet (€0.03) returned to LuisGR90
LuisGR90 collected €0.10 from pot
LuisGR90: doesn't show hand 
*** SUMMARY ***
Total pot €0.11 | Rake €0.01 
Board [8s 8c Jc]
Seat 1: LuisGR90 (button) collected (€0.10)
Seat 2: RCSA2 (small blind) folded before Flop
Seat 3: maximus_powah (big blind) folded on the Flop
Seat 4: pipinoelbreve9 folded before Flop (didn't bet)
Seat 5: AnxoGM folded before Flop (didn't bet)
Seat 6: pingu_771 folded before Flop (didn't bet)



PokerStars Zoom Hand #257563037611:  Hold'em No Limit (€0.01/€0.02) - 2025/08/31 22:44:12 CET [2025/08/31 16:44:12 ET]
Table 'Arneb' 6-max Seat #1 is the button
Seat 1: luketluk (€1.25 in chips) 
Seat 2: LuisGR90 (€2.01 in chips) 
Seat 3: pipinoelbreve9 (€3.89 in chips) 
Seat 4: AnxoGM (€2.13 in chips) 
Seat 5: felgas1968 (€4.19 in chips) 
Seat 6: ajustes (€1.91 in chips) 
LuisGR90: posts small blind €0.01
pipinoelbreve9: posts big blind €0.02
*** HOLE CARDS ***
Dealt to pipinoelbreve9 [Tc Ks]
AnxoGM: folds 
felgas1968: folds 
ajustes: raises €0.04 to €0.06
luketluk: calls €0.06
LuisGR90: folds 
pipinoelbreve9: calls €0.04
*** FLOP *** [6s Qh 2s]
pipinoelbreve9: checks 
ajustes: bets €0.09
luketluk: folds 
pipinoelbreve9: folds 
Uncalled bet (€0.09) returned to ajustes
ajustes collected €0.18 from pot
ajustes: doesn't show hand 
*** SUMMARY ***
Total pot €0.19 | Rake €0.01 
Board [6s Qh 2s]
Seat 1: luketluk (button) folded on the Flop
Seat 2: LuisGR90 (small blind) folded before Flop
Seat 3: pipinoelbreve9 (big blind) folded on the Flop
Seat 4: AnxoGM folded before Flop (didn't bet)
Seat 5: felgas1968 folded before Flop (didn't bet)
Seat 6: ajustes collected (€0.18)



PokerStars Zoom Hand #257563046579:  Hold'em No Limit (€0.01/€0.02) - 2025/08/31 22:44:41 CET [2025/08/31 16:44:41 ET]
Table 'Arneb' 6-max Seat #1 is the button
Seat 1: wilbor123 (€3.88 in chips) 
Seat 2: pipinoelbreve9 (€3.83 in chips) 
Seat 3: sambupkr (€2.57 in chips) 
Seat 4: ajustes (€2.03 in chips) 
Seat 5: WJSP (€2.18 in chips) 
Seat 6: charlyleon92 (€2.69 in chips) 
pipinoelbreve9: posts small blind €0.01
sambupkr: posts big blind €0.02
*** HOLE CARDS ***
Dealt to pipinoelbreve9 [7h 9h]
ajustes: folds 
WJSP: folds 
charlyleon92: calls €0.02
wilbor123: folds 
pipinoelbreve9: raises €0.08 to €0.10
sambupkr: folds 
charlyleon92: calls €0.08
*** FLOP *** [8d Js Qd]
pipinoelbreve9: bets €0.11
charlyleon92: calls €0.11
*** TURN *** [8d Js Qd] [Ah]
pipinoelbreve9: checks 
charlyleon92: checks 
*** RIVER *** [8d Js Qd Ah] [Tc]
pipinoelbreve9: bets €0.21
charlyleon92: folds 
Uncalled bet (€0.21) returned to pipinoelbreve9
pipinoelbreve9 collected €0.42 from pot
pipinoelbreve9: doesn't show hand 
*** SUMMARY ***
Total pot €0.44 | Rake €0.02 
Board [8d Js Qd Ah Tc]
Seat 1: wilbor123 (button) folded before Flop (didn't bet)
Seat 2: pipinoelbreve9 (small blind) collected (€0.42)
Seat 3: sambupkr (big blind) folded before Flop
Seat 4: ajustes folded before Flop (didn't bet)
Seat 5: WJSP folded before Flop (didn't bet)
Seat 6: charlyleon92 folded on the River



PokerStars Zoom Hand #257563057529:  Hold'em No Limit (€0.01/€0.02) - 2025/08/31 22:45:16 CET [2025/08/31 16:45:16 ET]
Table 'Arneb' 6-max Seat #1 is the button
Seat 1: pipinoelbreve9 (€4.04 in chips) 
Seat 2: forinal (€1.71 in chips) 
Seat 3: Chichoampuero12 (€2 in chips) 
Seat 4: 34pluto (€1.65 in chips) 
Seat 5: LGC04 (€2.17 in chips) 
Seat 6: ocsur (€1.61 in chips) 
forinal: posts small blind €0.01
Chichoampuero12: posts big blind €0.02
*** HOLE CARDS ***
Dealt to pipinoelbreve9 [2d 3c]
34pluto: folds 
LGC04: folds 
ocsur: folds 
pipinoelbreve9: folds 
forinal: folds 
Uncalled bet (€0.01) returned to Chichoampuero12
Chichoampuero12 collected €0.02 from pot
Chichoampuero12: doesn't show hand 
*** SUMMARY ***
Total pot €0.02 | Rake €0 
Seat 1: pipinoelbreve9 (button) folded before Flop (didn't bet)
Seat 2: forinal (small blind) folded before Flop
Seat 3: Chichoampuero12 (big blind) collected (€0.02)
Seat 4: 34pluto folded before Flop (didn't bet)
Seat 5: LGC04 folded before Flop (didn't bet)
Seat 6: ocsur folded before Flop (didn't bet)



PokerStars Zoom Hand #257563061580:  Hold'em No Limit (€0.01/€0.02) - 2025/08/31 22:45:29 CET [2025/08/31 16:45:29 ET]
Table 'Arneb' 6-max Seat #1 is the button
Seat 1: 34pluto (€1.65 in chips) 
Seat 2: pipinoelbreve9 (€4.04 in chips) 
Seat 3: Grokuyu (€2.64 in chips) 
Seat 4: elseneka-1 (€3.29 in chips) 
Seat 5: tanoun1 (€2 in chips) 
Seat 6: pingu_771 (€2.14 in chips) 
pipinoelbreve9: posts small blind €0.01
Grokuyu: posts big blind €0.02
*** HOLE CARDS ***
Dealt to pipinoelbreve9 [Kd 3c]
elseneka-1: calls €0.02
tanoun1: folds 
pingu_771: raises €0.05 to €0.07
34pluto: folds 
pipinoelbreve9: folds 
Grokuyu: folds 
elseneka-1: calls €0.05
*** FLOP *** [6s Kh Qs]
elseneka-1: checks 
pingu_771: bets €0.04
elseneka-1: calls €0.04
*** TURN *** [6s Kh Qs] [Jd]
elseneka-1: checks 
pingu_771: checks 
*** RIVER *** [6s Kh Qs Jd] [8d]
elseneka-1: bets €0.12
pingu_771: folds 
Uncalled bet (€0.12) returned to elseneka-1
elseneka-1 collected €0.24 from pot
elseneka-1: doesn't show hand 
*** SUMMARY ***
Total pot €0.25 | Rake €0.01 
Board [6s Kh Qs Jd 8d]
Seat 1: 34pluto (button) folded before Flop (didn't bet)
Seat 2: pipinoelbreve9 (small blind) folded before Flop
Seat 3: Grokuyu (big blind) folded before Flop
Seat 4: elseneka-1 collected (€0.24)
Seat 5: tanoun1 folded before Flop (didn't bet)
Seat 6: pingu_771 folded on the River



PokerStars Zoom Hand #257563062941:  Hold'em No Limit (€0.01/€0.02) - 2025/08/31 22:45:34 CET [2025/08/31 16:45:34 ET]
Table 'Arneb' 6-max Seat #1 is the button
Seat 1: tanoun1 (€4.87 in chips) 
Seat 2: xhadd (€3.76 in chips) 
Seat 3: sambupkr (€2 in chips) 
Seat 4: 28chan28 (€2.26 in chips) 
Seat 5: AnxoGM (€2.32 in chips) 
Seat 6: pipinoelbreve9 (€4.03 in chips) 
xhadd: posts small blind €0.01
sambupkr: posts big blind €0.02
*** HOLE CARDS ***
Dealt to pipinoelbreve9 [Jd As]
28chan28: folds 
AnxoGM: folds 
pipinoelbreve9: raises €0.04 to €0.06
tanoun1: folds 
xhadd: calls €0.05
sambupkr: folds 
*** FLOP *** [Kh 8h 3d]
xhadd: checks 
pipinoelbreve9: checks 
*** TURN *** [Kh 8h 3d] [2c]
xhadd: bets €0.04
pipinoelbreve9: calls €0.04
*** RIVER *** [Kh 8h 3d 2c] [5c]
xhadd: bets €0.06
pipinoelbreve9: folds 
Uncalled bet (€0.06) returned to xhadd
xhadd collected €0.21 from pot
xhadd: doesn't show hand 
*** SUMMARY ***
Total pot €0.22 | Rake €0.01 
Board [Kh 8h 3d 2c 5c]
Seat 1: tanoun1 (button) folded before Flop (didn't bet)
Seat 2: xhadd (small blind) collected (€0.21)
Seat 3: sambupkr (big blind) folded before Flop
Seat 4: 28chan28 folded before Flop (didn't bet)
Seat 5: AnxoGM folded before Flop (didn't bet)
Seat 6: pipinoelbreve9 folded on the River



PokerStars Zoom Hand #257563076222:  Hold'em No Limit (€0.01/€0.02) - 2025/08/31 22:46:16 CET [2025/08/31 16:46:16 ET]
Table 'Arneb' 6-max Seat #1 is the button
Seat 1: 28chan28 (€2.17 in chips) 
Seat 2: scaramouche84 (€2.46 in chips) 
Seat 3: pipinoelbreve9 (€3.93 in chips) 
Seat 4: RCSA2 (€1.93 in chips) 
Seat 5: ana paula900 (€1.97 in chips) 
Seat 6: Xoseanro510 (€2.29 in chips) 
scaramouche84: posts small blind €0.01
pipinoelbreve9: posts big blind €0.02
*** HOLE CARDS ***
Dealt to pipinoelbreve9 [5h 8d]
RCSA2: folds 
ana paula900: folds 
Xoseanro510: folds 
28chan28: raises €0.06 to €0.08
scaramouche84: folds 
pipinoelbreve9: folds 
Uncalled bet (€0.06) returned to 28chan28
28chan28 collected €0.05 from pot
28chan28: doesn't show hand 
*** SUMMARY ***
Total pot €0.05 | Rake €0 
Seat 1: 28chan28 (button) collected (€0.05)
Seat 2: scaramouche84 (small blind) folded before Flop
Seat 3: pipinoelbreve9 (big blind) folded before Flop
Seat 4: RCSA2 folded before Flop (didn't bet)
Seat 5: ana paula900 folded before Flop (didn't bet)
Seat 6: Xoseanro510 folded before Flop (didn't bet)



PokerStars Zoom Hand #257563058955:  Hold'em No Limit (€0.01/€0.02) - 2025/08/31 22:45:21 CET [2025/08/31 16:45:21 ET]
Table 'Arneb' 6-max Seat #1 is the button
Seat 1: maximus_powah (€1.92 in chips) 
Seat 2: Lumifer (€2 in chips) 
Seat 3: EiramSenpai (€2.21 in chips) 
Seat 4: RCSA2 (€2.23 in chips) 
Seat 5: LGC04 (€2.17 in chips) 
Seat 6: pipinoelbreve9 (€4.04 in chips) 
Lumifer: posts small blind €0.01
EiramSenpai: posts big blind €0.02
*** HOLE CARDS ***
Dealt to pipinoelbreve9 [3s 2d]
EiramSenpai is disconnected 
RCSA2: calls €0.02
LGC04: folds 
pipinoelbreve9: folds 
maximus_powah: raises €0.08 to €0.10
Lumifer: raises €0.22 to €0.32
EiramSenpai has timed out while disconnected
EiramSenpai: folds 
RCSA2: folds 
maximus_powah: folds 
Uncalled bet (€0.22) returned to Lumifer
Lumifer collected €0.24 from pot
Lumifer: doesn't show hand 
*** SUMMARY ***
Total pot €0.24 | Rake €0 
Seat 1: maximus_powah (button) folded before Flop
Seat 2: Lumifer (small blind) collected (€0.24)
Seat 3: EiramSenpai (big blind) folded before Flop
Seat 4: RCSA2 folded before Flop
Seat 5: LGC04 folded before Flop (didn't bet)
Seat 6: pipinoelbreve9 folded before Flop (didn't bet)



PokerStars Zoom Hand #257563080615:  Hold'em No Limit (€0.01/€0.02) - 2025/08/31 22:46:30 CET [2025/08/31 16:46:30 ET]
Table 'Arneb' 6-max Seat #1 is the button
Seat 1: ana paula900 (€1.96 in chips) 
Seat 2: smoking9000 (€1.12 in chips) 
Seat 3: WJSP (€2.20 in chips) 
Seat 4: pipinoelbreve9 (€3.91 in chips) 
Seat 5: McDodo86 (€1.17 in chips) 
Seat 6: luketluk (€1.07 in chips) 
smoking9000: posts small blind €0.01
WJSP: posts big blind €0.02
*** HOLE CARDS ***
Dealt to pipinoelbreve9 [6c 5h]
pipinoelbreve9: folds 
McDodo86: folds 
luketluk: folds 
ana paula900: folds 
smoking9000: calls €0.01
WJSP: checks 
*** FLOP *** [3h 8c 3c]
smoking9000: checks 
WJSP: checks 
*** TURN *** [3h 8c 3c] [7h]
smoking9000: checks 
WJSP: bets €0.02
smoking9000: folds 
Uncalled bet (€0.02) returned to WJSP
WJSP collected €0.04 from pot
WJSP: doesn't show hand 
*** SUMMARY ***
Total pot €0.04 | Rake €0 
Board [3h 8c 3c 7h]
Seat 1: ana paula900 (button) folded before Flop (didn't bet)
Seat 2: smoking9000 (small blind) folded on the Turn
Seat 3: WJSP (big blind) collected (€0.04)
Seat 4: pipinoelbreve9 folded before Flop (didn't bet)
Seat 5: McDodo86 folded before Flop (didn't bet)
Seat 6: luketluk folded before Flop (didn't bet)



PokerStars Zoom Hand #257563082098:  Hold'em No Limit (€0.01/€0.02) - 2025/08/31 22:46:35 CET [2025/08/31 16:46:35 ET]
Table 'Arneb' 6-max Seat #1 is the button
Seat 1: pipinoelbreve9 (€3.91 in chips) 
Seat 2: winie66 (€3.72 in chips) 
Seat 3: Jeffkijay (€3.34 in chips) 
Seat 4: 28chan28 (€2.20 in chips) 
Seat 5: McDodo86 (€1.17 in chips) 
Seat 6: sambupkr (€2.49 in chips) 
winie66: posts small blind €0.01
Jeffkijay: posts big blind €0.02
*** HOLE CARDS ***
Dealt to pipinoelbreve9 [Qd Jc]
28chan28: raises €0.04 to €0.06
McDodo86: folds 
sambupkr: folds 
pipinoelbreve9: calls €0.06
winie66: folds 
Jeffkijay: folds 
*** FLOP *** [Qh 3s 6d]
28chan28: checks 
pipinoelbreve9: bets €0.07
28chan28: calls €0.07
*** TURN *** [Qh 3s 6d] [7d]
28chan28: checks 
pipinoelbreve9: bets €0.14
28chan28: folds 
Uncalled bet (€0.14) returned to pipinoelbreve9
pipinoelbreve9 collected €0.28 from pot
pipinoelbreve9: doesn't show hand 
*** SUMMARY ***
Total pot €0.29 | Rake €0.01 
Board [Qh 3s 6d 7d]
Seat 1: pipinoelbreve9 (button) collected (€0.28)
Seat 2: winie66 (small blind) folded before Flop
Seat 3: Jeffkijay (big blind) folded before Flop
Seat 4: 28chan28 folded on the Turn
Seat 5: McDodo86 folded before Flop (didn't bet)
Seat 6: sambupkr folded before Flop (didn't bet)



PokerStars Zoom Hand #257563093245:  Hold'em No Limit (€0.01/€0.02) - 2025/08/31 22:47:11 CET [2025/08/31 16:47:11 ET]
Table 'Arneb' 6-max Seat #1 is the button
Seat 1: wilbor123 (€3.69 in chips) 
Seat 2: trinityandme (€1.58 in chips) 
Seat 3: felgas1968 (€1.92 in chips) 
Seat 4: pipinoelbreve9 (€4.06 in chips) 
Seat 5: maximus_powah (€2.63 in chips) 
Seat 6: AnxoGM (€2.97 in chips) 
trinityandme: posts small blind €0.01
felgas1968: posts big blind €0.02
*** HOLE CARDS ***
Dealt to pipinoelbreve9 [Ks 9s]
pipinoelbreve9: raises €0.04 to €0.06
maximus_powah: folds 
AnxoGM: folds 
wilbor123: folds 
trinityandme: folds 
felgas1968: folds 
Uncalled bet (€0.04) returned to pipinoelbreve9
pipinoelbreve9 collected €0.05 from pot
pipinoelbreve9: doesn't show hand 
*** SUMMARY ***
Total pot €0.05 | Rake €0 
Seat 1: wilbor123 (button) folded before Flop (didn't bet)
Seat 2: trinityandme (small blind) folded before Flop
Seat 3: felgas1968 (big blind) folded before Flop
Seat 4: pipinoelbreve9 collected (€0.05)
Seat 5: maximus_powah folded before Flop (didn't bet)
Seat 6: AnxoGM folded before Flop (didn't bet)



PokerStars Zoom Hand #257563090762:  Hold'em No Limit (€0.01/€0.02) - 2025/08/31 22:47:03 CET [2025/08/31 16:47:03 ET]
Table 'Arneb' 6-max Seat #1 is the button
Seat 1: AnxoGM (€2.97 in chips) 
Seat 2: LuisGR90 (€2.48 in chips) 
Seat 3: Strlen83 (€2 in chips) 
Seat 4: finfin13205 (€2.47 in chips) 
Seat 5: pipinoelbreve9 (€4.06 in chips) 
Seat 6: winie66 (€3.69 in chips) 
LuisGR90: posts small blind €0.01
Strlen83: posts big blind €0.02
*** HOLE CARDS ***
Dealt to pipinoelbreve9 [6h 4d]
finfin13205: raises €0.05 to €0.07
pipinoelbreve9: folds 
winie66: folds 
AnxoGM: folds 
LuisGR90: folds 
Strlen83: calls €0.05
*** FLOP *** [4c 9h 7s]
Strlen83: checks 
finfin13205: bets €0.07
Strlen83: calls €0.07
*** TURN *** [4c 9h 7s] [Ad]
Strlen83: checks 
finfin13205: checks 
*** RIVER *** [4c 9h 7s Ad] [Qh]
Strlen83: checks 
finfin13205: checks 
*** SHOW DOWN ***
Strlen83: shows [Qc Kh] (a pair of Queens)
finfin13205: mucks hand 
Strlen83 collected €0.28 from pot
*** SUMMARY ***
Total pot €0.29 | Rake €0.01 
Board [4c 9h 7s Ad Qh]
Seat 1: AnxoGM (button) folded before Flop (didn't bet)
Seat 2: LuisGR90 (small blind) folded before Flop
Seat 3: Strlen83 (big blind) showed [Qc Kh] and won (€0.28) with a pair of Queens
Seat 4: finfin13205 mucked [3d 2h]
Seat 5: pipinoelbreve9 folded before Flop (didn't bet)
Seat 6: winie66 folded before Flop (didn't bet)



PokerStars Zoom Hand #257563104167:  Hold'em No Limit (€0.01/€0.02) - 2025/08/31 22:47:46 CET [2025/08/31 16:47:46 ET]
Table 'Arneb' 6-max Seat #1 is the button
Seat 1: XXXJAVIXXX14 (€1.13 in chips) 
Seat 2: felgas1968 (€1.69 in chips) 
Seat 3: LGC04 (€2.02 in chips) 
Seat 4: pipinoelbreve9 (€4.06 in chips) 
Seat 5: PkBcN15 (€2 in chips) 
Seat 6: forinal (€2.01 in chips) 
felgas1968: posts small blind €0.01
LGC04: posts big blind €0.02
*** HOLE CARDS ***
Dealt to pipinoelbreve9 [2d 5h]
pipinoelbreve9: folds 
PkBcN15: folds 
forinal: folds 
XXXJAVIXXX14: raises €0.02 to €0.04
felgas1968: folds 
LGC04: folds 
Uncalled bet (€0.02) returned to XXXJAVIXXX14
XXXJAVIXXX14 collected €0.05 from pot
XXXJAVIXXX14: doesn't show hand 
*** SUMMARY ***
Total pot €0.05 | Rake €0 
Seat 1: XXXJAVIXXX14 (button) collected (€0.05)
Seat 2: felgas1968 (small blind) folded before Flop
Seat 3: LGC04 (big blind) folded before Flop
Seat 4: pipinoelbreve9 folded before Flop (didn't bet)
Seat 5: PkBcN15 folded before Flop (didn't bet)
Seat 6: forinal folded before Flop (didn't bet)



PokerStars Zoom Hand #257563097257:  Hold'em No Limit (€0.01/€0.02) - 2025/08/31 22:47:24 CET [2025/08/31 16:47:24 ET]
Table 'Arneb' 6-max Seat #1 is the button
Seat 1: top101 (€3.36 in chips) 
Seat 2: pipinoelbreve9 (€4.09 in chips) 
Seat 3: AnxoGM (€2.97 in chips) 
Seat 4: charlyleon92 (€1.60 in chips) 
Seat 5: Pepita71 (€4.73 in chips) 
Seat 6: Xoco Cusco (€2.30 in chips) 
pipinoelbreve9: posts small blind €0.01
AnxoGM: posts big blind €0.02
*** HOLE CARDS ***
Dealt to pipinoelbreve9 [9h 5c]
charlyleon92: calls €0.02
Pepita71: folds 
Xoco Cusco: raises €0.08 to €0.10
top101: folds 
pipinoelbreve9: folds 
AnxoGM: folds 
charlyleon92: calls €0.08
*** FLOP *** [3s 3h 2h]
charlyleon92: checks 
Xoco Cusco: bets €0.15
charlyleon92: calls €0.15
*** TURN *** [3s 3h 2h] [Jd]
charlyleon92: checks 
Xoco Cusco: checks 
*** RIVER *** [3s 3h 2h Jd] [Kd]
charlyleon92: checks 
Xoco Cusco: bets €0.25
charlyleon92: folds 
Uncalled bet (€0.25) returned to Xoco Cusco
Xoco Cusco collected €0.50 from pot
Xoco Cusco: doesn't show hand 
*** SUMMARY ***
Total pot €0.53 | Rake €0.03 
Board [3s 3h 2h Jd Kd]
Seat 1: top101 (button) folded before Flop (didn't bet)
Seat 2: pipinoelbreve9 (small blind) folded before Flop
Seat 3: AnxoGM (big blind) folded before Flop
Seat 4: charlyleon92 folded on the River
Seat 5: Pepita71 folded before Flop (didn't bet)
Seat 6: Xoco Cusco collected (€0.50)



PokerStars Zoom Hand #257563105765:  Hold'em No Limit (€0.01/€0.02) - 2025/08/31 22:47:51 CET [2025/08/31 16:47:51 ET]
Table 'Arneb' 6-max Seat #1 is the button
Seat 1: pipinoelbreve9 (€4.06 in chips) 
Seat 2: AleactaEst21 (€2.83 in chips) 
Seat 3: Pepita71 (€4.73 in chips) 
Seat 4: Xoseanro510 (€2.35 in chips) 
Seat 5: Strlen83 (€2.14 in chips) 
Seat 6: richh74 (€1.39 in chips) 
AleactaEst21: posts small blind €0.01
Pepita71: posts big blind €0.02
*** HOLE CARDS ***
Dealt to pipinoelbreve9 [Ac 4h]
Xoseanro510: folds 
Strlen83: folds 
richh74: folds 
pipinoelbreve9: folds 
AleactaEst21: folds 
Uncalled bet (€0.01) returned to Pepita71
Pepita71 collected €0.02 from pot
Pepita71: doesn't show hand 
*** SUMMARY ***
Total pot €0.02 | Rake €0 
Seat 1: pipinoelbreve9 (button) folded before Flop (didn't bet)
Seat 2: AleactaEst21 (small blind) folded before Flop
Seat 3: Pepita71 (big blind) collected (€0.02)
Seat 4: Xoseanro510 folded before Flop (didn't bet)
Seat 5: Strlen83 folded before Flop (didn't bet)
Seat 6: richh74 folded before Flop (didn't bet)



PokerStars Zoom Hand #257563099433:  Hold'em No Limit (€0.01/€0.02) - 2025/08/31 22:47:31 CET [2025/08/31 16:47:31 ET]
Table 'Arneb' 6-max Seat #1 is the button
Seat 1: tanoun1 (€2 in chips) 
Seat 2: Chichoampuero12 (€2 in chips) 
Seat 3: pipinoelbreve9 (€4.08 in chips) 
Seat 4: juanlu2000china (€1.64 in chips) 
Seat 5: LGC04 (€2.03 in chips) 
Seat 6: Pepita71 (€4.73 in chips) 
Chichoampuero12: posts small blind €0.01
pipinoelbreve9: posts big blind €0.02
*** HOLE CARDS ***
Dealt to pipinoelbreve9 [5d 4s]
juanlu2000china: calls €0.02
LGC04: folds 
Pepita71: folds 
tanoun1: folds 
Chichoampuero12: raises €0.08 to €0.10
pipinoelbreve9: folds 
juanlu2000china: calls €0.08
*** FLOP *** [Js 8h 5c]
Chichoampuero12: bets €0.09
juanlu2000china: calls €0.09
*** TURN *** [Js 8h 5c] [3c]
Chichoampuero12: bets €0.31
juanlu2000china: folds 
Uncalled bet (€0.31) returned to Chichoampuero12
Chichoampuero12 collected €0.38 from pot
Chichoampuero12: doesn't show hand 
*** SUMMARY ***
Total pot €0.40 | Rake €0.02 
Board [Js 8h 5c 3c]
Seat 1: tanoun1 (button) folded before Flop (didn't bet)
Seat 2: Chichoampuero12 (small blind) collected (€0.38)
Seat 3: pipinoelbreve9 (big blind) folded before Flop
Seat 4: juanlu2000china folded on the Turn
Seat 5: LGC04 folded before Flop (didn't bet)
Seat 6: Pepita71 folded before Flop (didn't bet)



PokerStars Zoom Hand #257563108234:  Hold'em No Limit (€0.01/€0.02) - 2025/08/31 22:47:59 CET [2025/08/31 16:47:59 ET]
Table 'Arneb' 6-max Seat #1 is the button
Seat 1: AleactaEst21 (€2.82 in chips) 
Seat 2: LAROSA74 (€2.09 in chips) 
Seat 3: 34pluto (€1.39 in chips) 
Seat 4: LGC04 (€2 in chips) 
Seat 5: danywoo (€0.61 in chips) 
Seat 6: pipinoelbreve9 (€4.06 in chips) 
LAROSA74: posts small blind €0.01
34pluto: posts big blind €0.02
*** HOLE CARDS ***
Dealt to pipinoelbreve9 [5s Ts]
LGC04: folds 
danywoo: raises €0.05 to €0.07
pipinoelbreve9: folds 
AleactaEst21: folds 
LAROSA74: folds 
34pluto: folds 
Uncalled bet (€0.05) returned to danywoo
danywoo collected €0.05 from pot
danywoo: doesn't show hand 
*** SUMMARY ***
Total pot €0.05 | Rake €0 
Seat 1: AleactaEst21 (button) folded before Flop (didn't bet)
Seat 2: LAROSA74 (small blind) folded before Flop
Seat 3: 34pluto (big blind) folded before Flop
Seat 4: LGC04 folded before Flop (didn't bet)
Seat 5: danywoo collected (€0.05)
Seat 6: pipinoelbreve9 folded before Flop (didn't bet)



PokerStars Zoom Hand #257563110695:  Hold'em No Limit (€0.01/€0.02) - 2025/08/31 22:48:07 CET [2025/08/31 16:48:07 ET]
Table 'Arneb' 6-max Seat #1 is the button
Seat 1: WJSP (€2.14 in chips) 
Seat 2: LuisGR90 (€2.03 in chips) 
Seat 3: forinal (€2.01 in chips) 
Seat 4: Lumifer (€2 in chips) 
Seat 5: pipinoelbreve9 (€4.06 in chips) 
Seat 6: LGC04 (€2 in chips) 
LuisGR90: posts small blind €0.01
forinal: posts big blind €0.02
*** HOLE CARDS ***
Dealt to pipinoelbreve9 [5h 5s]
Lumifer: folds 
pipinoelbreve9: raises €0.04 to €0.06
LGC04: folds 
WJSP: folds 
LuisGR90: raises €0.14 to €0.20
forinal: folds 
pipinoelbreve9: calls €0.14
*** FLOP *** [3d 8h 2h]
LuisGR90: checks 
pipinoelbreve9: checks 
*** TURN *** [3d 8h 2h] [8d]
LuisGR90: checks 
pipinoelbreve9: bets €0.20
LuisGR90: calls €0.20
*** RIVER *** [3d 8h 2h 8d] [6c]
LuisGR90: checks 
pipinoelbreve9: checks 
*** SHOW DOWN ***
LuisGR90: shows [Ad Kd] (a pair of Eights)
pipinoelbreve9: shows [5h 5s] (two pair, Eights and Fives)
pipinoelbreve9 collected €0.78 from pot
*** SUMMARY ***
Total pot €0.82 | Rake €0.04 
Board [3d 8h 2h 8d 6c]
Seat 1: WJSP (button) folded before Flop (didn't bet)
Seat 2: LuisGR90 (small blind) showed [Ad Kd] and lost with a pair of Eights
Seat 3: forinal (big blind) folded before Flop
Seat 4: Lumifer folded before Flop (didn't bet)
Seat 5: pipinoelbreve9 showed [5h 5s] and won (€0.78) with two pair, Eights and Fives
Seat 6: LGC04 folded before Flop (didn't bet)



PokerStars Zoom Hand #257563120267:  Hold'em No Limit (€0.01/€0.02) - 2025/08/31 22:48:38 CET [2025/08/31 16:48:38 ET]
Table 'Arneb' 6-max Seat #1 is the button
Seat 1: tanoun1 (€4.28 in chips) 
Seat 2: pipinoelbreve9 (€4.44 in chips) 
Seat 3: joelini001 (€1.13 in chips) 
Seat 4: masquisiera (€1.54 in chips) 
Seat 5: sambupkr (€4.25 in chips) 
Seat 6: WJSP (€2.09 in chips) 
pipinoelbreve9: posts small blind €0.01
joelini001: posts big blind €0.02
*** HOLE CARDS ***
Dealt to pipinoelbreve9 [4s 3d]
masquisiera: folds 
sambupkr: folds 
WJSP: folds 
tanoun1: folds 
pipinoelbreve9: folds 
Uncalled bet (€0.01) returned to joelini001
joelini001 collected €0.02 from pot
joelini001: doesn't show hand 
*** SUMMARY ***
Total pot €0.02 | Rake €0 
Seat 1: tanoun1 (button) folded before Flop (didn't bet)
Seat 2: pipinoelbreve9 (small blind) folded before Flop
Seat 3: joelini001 (big blind) collected (€0.02)
Seat 4: masquisiera folded before Flop (didn't bet)
Seat 5: sambupkr folded before Flop (didn't bet)
Seat 6: WJSP folded before Flop (didn't bet)



PokerStars Zoom Hand #257563125003:  Hold'em No Limit (€0.01/€0.02) - 2025/08/31 22:48:53 CET [2025/08/31 16:48:53 ET]
Table 'Arneb' 6-max Seat #1 is the button
Seat 1: maximus_powah (€2.60 in chips) 
Seat 2: Lumifer (€2.01 in chips) 
Seat 3: felgas1968 (€1.91 in chips) 
Seat 4: LGC04 (€1.89 in chips) 
Seat 5: pipinoelbreve9 (€4.41 in chips) 
Seat 6: AnxoGM (€2.62 in chips) 
Lumifer: posts small blind €0.01
felgas1968: posts big blind €0.02
*** HOLE CARDS ***
Dealt to pipinoelbreve9 [6c 4d]
LGC04: raises €0.02 to €0.04
pipinoelbreve9: folds 
AnxoGM: folds 
maximus_powah: folds 
Lumifer: folds 
felgas1968: folds 
Uncalled bet (€0.02) returned to LGC04
LGC04 collected €0.05 from pot
LGC04: doesn't show hand 
*** SUMMARY ***
Total pot €0.05 | Rake €0 
Seat 1: maximus_powah (button) folded before Flop (didn't bet)
Seat 2: Lumifer (small blind) folded before Flop
Seat 3: felgas1968 (big blind) folded before Flop
Seat 4: LGC04 collected (€0.05)
Seat 5: pipinoelbreve9 folded before Flop (didn't bet)
Seat 6: AnxoGM folded before Flop (didn't bet)



PokerStars Zoom Hand #257563126199:  Hold'em No Limit (€0.01/€0.02) - 2025/08/31 22:48:57 CET [2025/08/31 16:48:57 ET]
Table 'Arneb' 6-max Seat #1 is the button
Seat 1: pipinoelbreve9 (€4.41 in chips) 
Seat 2: lorocontento (€1.21 in chips) 
Seat 3: LuisGR90 (€2 in chips) 
Seat 4: Lumifer (€2.26 in chips) 
Seat 5: Xoco Cusco (€2.40 in chips) 
Seat 6: felgas1968 (€1.66 in chips) 
lorocontento: posts small blind €0.01
LuisGR90: posts big blind €0.02
*** HOLE CARDS ***
Dealt to pipinoelbreve9 [Td Kh]
Lumifer: folds 
Xoco Cusco: raises €0.04 to €0.06
felgas1968: folds 
pipinoelbreve9: folds 
lorocontento: folds 
LuisGR90: folds 
Uncalled bet (€0.04) returned to Xoco Cusco
Xoco Cusco collected €0.05 from pot
Xoco Cusco: doesn't show hand 
*** SUMMARY ***
Total pot €0.05 | Rake €0 
Seat 1: pipinoelbreve9 (button) folded before Flop (didn't bet)
Seat 2: lorocontento (small blind) folded before Flop
Seat 3: LuisGR90 (big blind) folded before Flop
Seat 4: Lumifer folded before Flop (didn't bet)
Seat 5: Xoco Cusco collected (€0.05)
Seat 6: felgas1968 folded before Flop (didn't bet)



PokerStars Zoom Hand #257563128937:  Hold'em No Limit (€0.01/€0.02) - 2025/08/31 22:49:06 CET [2025/08/31 16:49:06 ET]
Table 'Arneb' 6-max Seat #1 is the button
Seat 1: WJSP (€2.21 in chips) 
Seat 2: CheckMate1346 (€2 in chips) 
Seat 3: felgas1968 (€1.89 in chips) 
Seat 4: Lumifer (€2.25 in chips) 
Seat 5: tanoun1 (€2.10 in chips) 
Seat 6: pipinoelbreve9 (€4.41 in chips) 
CheckMate1346: posts small blind €0.01
felgas1968: posts big blind €0.02
*** HOLE CARDS ***
Dealt to pipinoelbreve9 [9c 3s]
Lumifer: folds 
tanoun1: folds 
pipinoelbreve9: folds 
WJSP: folds 
CheckMate1346: raises €0.04 to €0.06
felgas1968: folds 
Uncalled bet (€0.04) returned to CheckMate1346
CheckMate1346 collected €0.04 from pot
CheckMate1346: doesn't show hand 
*** SUMMARY ***
Total pot €0.04 | Rake €0 
Seat 1: WJSP (button) folded before Flop (didn't bet)
Seat 2: CheckMate1346 (small blind) collected (€0.04)
Seat 3: felgas1968 (big blind) folded before Flop
Seat 4: Lumifer folded before Flop (didn't bet)
Seat 5: tanoun1 folded before Flop (didn't bet)
Seat 6: pipinoelbreve9 folded before Flop (didn't bet)



PokerStars Zoom Hand #257563122493:  Hold'em No Limit (€0.01/€0.02) - 2025/08/31 22:48:45 CET [2025/08/31 16:48:45 ET]
Table 'Arneb' 6-max Seat #1 is the button
Seat 1: GleQbenny (€1.96 in chips) 
Seat 2: AleactaEst21 (€2.84 in chips) 
Seat 3: pipinoelbreve9 (€4.43 in chips) 
Seat 4: RCSA2 (€2 in chips) 
Seat 5: Xexugol (€2.63 in chips) 
Seat 6: maximus_powah (€2.60 in chips) 
AleactaEst21: posts small blind €0.01
pipinoelbreve9: posts big blind €0.02
*** HOLE CARDS ***
Dealt to pipinoelbreve9 [5c 9d]
RCSA2: calls €0.02
Xexugol: folds 
maximus_powah: folds 
GleQbenny: raises €0.02 to €0.04
AleactaEst21: folds 
pipinoelbreve9: folds 
RCSA2: calls €0.02
*** FLOP *** [3d 2s 8s]
RCSA2: checks 
GleQbenny: checks 
*** TURN *** [3d 2s 8s] [3s]
RCSA2: checks 
GleQbenny: checks 
*** RIVER *** [3d 2s 8s 3s] [7c]
RCSA2: checks 
GleQbenny: checks 
*** SHOW DOWN ***
RCSA2: shows [6d Kd] (a pair of Threes)
GleQbenny: mucks hand 
RCSA2 collected €0.10 from pot
*** SUMMARY ***
Total pot €0.11 | Rake €0.01 
Board [3d 2s 8s 3s 7c]
Seat 1: GleQbenny (button) mucked [Tc Jd]
Seat 2: AleactaEst21 (small blind) folded before Flop
Seat 3: pipinoelbreve9 (big blind) folded before Flop
Seat 4: RCSA2 showed [6d Kd] and won (€0.10) with a pair of Threes
Seat 5: Xexugol folded before Flop (didn't bet)
Seat 6: maximus_powah folded before Flop (didn't bet)



PokerStars Zoom Hand #257563130165:  Hold'em No Limit (€0.01/€0.02) - 2025/08/31 22:49:10 CET [2025/08/31 16:49:10 ET]
Table 'Arneb' 6-max Seat #1 is the button
Seat 1: LGC04 (€1.90 in chips) 
Seat 2: pipinoelbreve9 (€4.41 in chips) 
Seat 3: sambupkr (€2.37 in chips) 
Seat 4: Xexugol (€2.61 in chips) 
Seat 5: WJSP (€2.21 in chips) 
Seat 6: Lumifer (€2.25 in chips) 
pipinoelbreve9: posts small blind €0.01
sambupkr: posts big blind €0.02
*** HOLE CARDS ***
Dealt to pipinoelbreve9 [5c Kc]
Xexugol: folds 
WJSP: raises €0.04 to €0.06
Lumifer: folds 
LGC04: calls €0.06
pipinoelbreve9: calls €0.05
sambupkr: folds 
*** FLOP *** [6c 9d Qh]
pipinoelbreve9: checks 
WJSP: bets €0.10
LGC04: folds 
pipinoelbreve9: folds 
Uncalled bet (€0.10) returned to WJSP
WJSP collected €0.19 from pot
WJSP: doesn't show hand 
*** SUMMARY ***
Total pot €0.20 | Rake €0.01 
Board [6c 9d Qh]
Seat 1: LGC04 (button) folded on the Flop
Seat 2: pipinoelbreve9 (small blind) folded on the Flop
Seat 3: sambupkr (big blind) folded before Flop
Seat 4: Xexugol folded before Flop (didn't bet)
Seat 5: WJSP collected (€0.19)
Seat 6: Lumifer folded before Flop (didn't bet)



PokerStars Zoom Hand #257563137571:  Hold'em No Limit (€0.01/€0.02) - 2025/08/31 22:49:34 CET [2025/08/31 16:49:34 ET]
Table 'Arneb' 6-max Seat #1 is the button
Seat 1: 34pluto (€1.39 in chips) 
Seat 2: tanoun1 (€2.08 in chips) 
Seat 3: lorocontento (€1.20 in chips) 
Seat 4: Chichoampuero12 (€2.49 in chips) 
Seat 5: pipinoelbreve9 (€4.35 in chips) 
Seat 6: ocsur (€1.74 in chips) 
tanoun1: posts small blind €0.01
lorocontento: posts big blind €0.02
*** HOLE CARDS ***
Dealt to pipinoelbreve9 [8s 3c]
Chichoampuero12: folds 
pipinoelbreve9: folds 
ocsur: folds 
34pluto: folds 
tanoun1: raises €0.04 to €0.06
lorocontento: calls €0.04
*** FLOP *** [Jd Td 3s]
tanoun1: checks 
lorocontento: bets €0.05
tanoun1: folds 
Uncalled bet (€0.05) returned to lorocontento
lorocontento collected €0.11 from pot
lorocontento: doesn't show hand 
*** SUMMARY ***
Total pot €0.12 | Rake €0.01 
Board [Jd Td 3s]
Seat 1: 34pluto (button) folded before Flop (didn't bet)
Seat 2: tanoun1 (small blind) folded on the Flop
Seat 3: lorocontento (big blind) collected (€0.11)
Seat 4: Chichoampuero12 folded before Flop (didn't bet)
Seat 5: pipinoelbreve9 folded before Flop (didn't bet)
Seat 6: ocsur folded before Flop (didn't bet)



PokerStars Zoom Hand #257563139355:  Hold'em No Limit (€0.01/€0.02) - 2025/08/31 22:49:40 CET [2025/08/31 16:49:40 ET]
Table 'Arneb' 6-max Seat #1 is the button
Seat 1: Belezaso21 (€1.08 in chips) 
Seat 2: WJSP (€2.06 in chips) 
Seat 3: masquisiera (€1 in chips) 
Seat 4: pipinoelbreve9 (€4.35 in chips) 
Seat 5: Grokuyu (€2.36 in chips) 
Seat 6: sambupkr (€2.44 in chips) 
WJSP: posts small blind €0.01
masquisiera: posts big blind €0.02
*** HOLE CARDS ***
Dealt to pipinoelbreve9 [Kd Kc]
pipinoelbreve9: raises €0.04 to €0.06
Grokuyu: folds 
sambupkr: calls €0.06
Belezaso21: folds 
WJSP: folds 
masquisiera: calls €0.04
*** FLOP *** [9d 4h Td]
masquisiera: checks 
pipinoelbreve9: checks 
sambupkr: checks 
*** TURN *** [9d 4h Td] [Qc]
masquisiera: bets €0.08
pipinoelbreve9: calls €0.08
sambupkr: folds 
*** RIVER *** [9d 4h Td Qc] [Js]
masquisiera: bets €0.17
pipinoelbreve9: raises €0.25 to €0.42
masquisiera: folds 
Uncalled bet (€0.25) returned to pipinoelbreve9
pipinoelbreve9 collected €0.66 from pot
pipinoelbreve9: doesn't show hand 
*** SUMMARY ***
Total pot €0.69 | Rake €0.03 
Board [9d 4h Td Qc Js]
Seat 1: Belezaso21 (button) folded before Flop (didn't bet)
Seat 2: WJSP (small blind) folded before Flop
Seat 3: masquisiera (big blind) folded on the River
Seat 4: pipinoelbreve9 collected (€0.66)
Seat 5: Grokuyu folded before Flop (didn't bet)
Seat 6: sambupkr folded on the Turn



PokerStars Zoom Hand #257563174840:  Hold'em No Limit (€0.01/€0.02) - 2025/08/31 22:51:36 CET [2025/08/31 16:51:36 ET]
Table 'Arneb' 6-max Seat #1 is the button
Seat 1: LuisGR90 (€2.08 in chips) 
Seat 2: MakesMeRich (€2.06 in chips) 
Seat 3: pipinoelbreve9 (€4.70 in chips) 
Seat 4: Minyens33 (€2.33 in chips) 
Seat 5: Chichoampuero12 (€2.47 in chips) 
Seat 6: ocsur (€1.95 in chips) 
MakesMeRich: posts small blind €0.01
pipinoelbreve9: posts big blind €0.02
*** HOLE CARDS ***
Dealt to pipinoelbreve9 [Kd 6c]
Minyens33: folds 
Chichoampuero12: folds 
ocsur: folds 
LuisGR90: raises €0.03 to €0.05
MakesMeRich: folds 
pipinoelbreve9: calls €0.03
*** FLOP *** [3s Qh 9c]
pipinoelbreve9: checks 
LuisGR90: checks 
*** TURN *** [3s Qh 9c] [Kh]
pipinoelbreve9: bets €0.05
LuisGR90: calls €0.05
*** RIVER *** [3s Qh 9c Kh] [Ad]
pipinoelbreve9: checks 
LuisGR90: checks 
*** SHOW DOWN ***
pipinoelbreve9: shows [Kd 6c] (a pair of Kings)
LuisGR90: shows [Kc 8s] (a pair of Kings)
pipinoelbreve9 collected €0.10 from pot
LuisGR90 collected €0.10 from pot
*** SUMMARY ***
Total pot €0.21 | Rake €0.01 
Board [3s Qh 9c Kh Ad]
Seat 1: LuisGR90 (button) showed [Kc 8s] and won (€0.10) with a pair of Kings
Seat 2: MakesMeRich (small blind) folded before Flop
Seat 3: pipinoelbreve9 (big blind) showed [Kd 6c] and won (€0.10) with a pair of Kings
Seat 4: Minyens33 folded before Flop (didn't bet)
Seat 5: Chichoampuero12 folded before Flop (didn't bet)
Seat 6: ocsur folded before Flop (didn't bet)



PokerStars Zoom Hand #257563187116:  Hold'em No Limit (€0.01/€0.02) - 2025/08/31 22:52:16 CET [2025/08/31 16:52:16 ET]
Table 'Arneb' 6-max Seat #1 is the button
Seat 1: felgas1968 (€1.80 in chips) 
Seat 2: pipinoelbreve9 (€4.70 in chips) 
Seat 3: joelini001 (€0.59 in chips) 
Seat 4: Grokuyu (€2.29 in chips) 
Seat 5: AnxoGM (€2.87 in chips) 
Seat 6: XXXJAVIXXX14 (€1.55 in chips) 
pipinoelbreve9: posts small blind €0.01
joelini001: posts big blind €0.02
*** HOLE CARDS ***
Dealt to pipinoelbreve9 [Qs Th]
Grokuyu: folds 
AnxoGM: folds 
XXXJAVIXXX14: folds 
felgas1968: folds 
pipinoelbreve9: raises €0.04 to €0.06
joelini001: calls €0.04
*** FLOP *** [7h Jc Tc]
pipinoelbreve9: bets €0.04
joelini001: calls €0.04
*** TURN *** [7h Jc Tc] [9c]
pipinoelbreve9: bets €0.15
joelini001: calls €0.15
*** RIVER *** [7h Jc Tc 9c] [5h]
pipinoelbreve9: checks 
joelini001: bets €0.34 and is all-in
pipinoelbreve9: calls €0.34
*** SHOW DOWN ***
joelini001: shows [8s Td] (a straight, Seven to Jack)
pipinoelbreve9: shows [Qs Th] (a pair of Tens)
joelini001 collected €1.12 from pot
*** SUMMARY ***
Total pot €1.18 | Rake €0.06 
Board [7h Jc Tc 9c 5h]
Seat 1: felgas1968 (button) folded before Flop (didn't bet)
Seat 2: pipinoelbreve9 (small blind) showed [Qs Th] and lost with a pair of Tens
Seat 3: joelini001 (big blind) showed [8s Td] and won (€1.12) with a straight, Seven to Jack
Seat 4: Grokuyu folded before Flop (didn't bet)
Seat 5: AnxoGM folded before Flop (didn't bet)
Seat 6: XXXJAVIXXX14 folded before Flop (didn't bet)



PokerStars Zoom Hand #257563206049:  Hold'em No Limit (€0.01/€0.02) - 2025/08/31 22:53:17 CET [2025/08/31 16:53:17 ET]
Table 'Arneb' 6-max Seat #1 is the button
Seat 1: WJSP (€2.19 in chips) 
Seat 2: AnxoGM (€2.71 in chips) 
Seat 3: LGC04 (€1.80 in chips) 
Seat 4: pipinoelbreve9 (€4.11 in chips) 
Seat 5: Jeffkijay (€2.98 in chips) 
Seat 6: Izibeaxh (€3.21 in chips) 
AnxoGM: posts small blind €0.01
LGC04: posts big blind €0.02
*** HOLE CARDS ***
Dealt to pipinoelbreve9 [3c Jc]
pipinoelbreve9: folds 
Jeffkijay: folds 
Izibeaxh: folds 
WJSP: raises €0.04 to €0.06
AnxoGM: folds 
LGC04: folds 
Uncalled bet (€0.04) returned to WJSP
WJSP collected €0.05 from pot
WJSP: doesn't show hand 
*** SUMMARY ***
Total pot €0.05 | Rake €0 
Seat 1: WJSP (button) collected (€0.05)
Seat 2: AnxoGM (small blind) folded before Flop
Seat 3: LGC04 (big blind) folded before Flop
Seat 4: pipinoelbreve9 folded before Flop (didn't bet)
Seat 5: Jeffkijay folded before Flop (didn't bet)
Seat 6: Izibeaxh folded before Flop (didn't bet)



PokerStars Zoom Hand #257563198391:  Hold'em No Limit (€0.01/€0.02) - 2025/08/31 22:52:52 CET [2025/08/31 16:52:52 ET]
Table 'Arneb' 6-max Seat #1 is the button
Seat 1: pipinoelbreve9 (€4.11 in chips) 
Seat 2: sambupkr (€2.04 in chips) 
Seat 3: GleQbenny (€1.83 in chips) 
Seat 4: Lumifer (€2 in chips) 
Seat 5: joelini001 (€1.12 in chips) 
Seat 6: McDodo86 (€1.67 in chips) 
sambupkr: posts small blind €0.01
GleQbenny: posts big blind €0.02
*** HOLE CARDS ***
Dealt to pipinoelbreve9 [9h Qs]
Lumifer: folds 
joelini001: calls €0.02
McDodo86: calls €0.02
pipinoelbreve9: folds 
sambupkr: folds 
GleQbenny: raises €0.13 to €0.15
joelini001: calls €0.13
McDodo86: calls €0.13
*** FLOP *** [Ks 4h 4c]
GleQbenny: checks 
joelini001: bets €0.97 and is all-in
McDodo86: folds 
GleQbenny: calls €0.97
*** TURN *** [Ks 4h 4c] [7d]
*** RIVER *** [Ks 4h 4c 7d] [Jd]
*** SHOW DOWN ***
GleQbenny: shows [Kh Kc] (a full house, Kings full of Fours)
joelini001: shows [As Ad] (two pair, Aces and Fours)
GleQbenny collected €2.28 from pot
*** SUMMARY ***
Total pot €2.40 | Rake €0.12 
Board [Ks 4h 4c 7d Jd]
Seat 1: pipinoelbreve9 (button) folded before Flop (didn't bet)
Seat 2: sambupkr (small blind) folded before Flop
Seat 3: GleQbenny (big blind) showed [Kh Kc] and won (€2.28) with a full house, Kings full of Fours
Seat 4: Lumifer folded before Flop (didn't bet)
Seat 5: joelini001 showed [As Ad] and lost with two pair, Aces and Fours
Seat 6: McDodo86 folded on the Flop



PokerStars Zoom Hand #257563202840:  Hold'em No Limit (€0.01/€0.02) - 2025/08/31 22:53:06 CET [2025/08/31 16:53:06 ET]
Table 'Arneb' 6-max Seat #1 is the button
Seat 1: LuisGR90 (€2 in chips) 
Seat 2: Lumifer (€3.14 in chips) 
Seat 3: pingu_771 (€2.16 in chips) 
Seat 4: winie66 (€3.47 in chips) 
Seat 5: Chichoampuero12 (€2.44 in chips) 
Seat 6: pipinoelbreve9 (€4.11 in chips) 
Lumifer: posts small blind €0.01
pingu_771: posts big blind €0.02
*** HOLE CARDS ***
Dealt to pipinoelbreve9 [7d 8h]
winie66: folds 
Chichoampuero12: folds 
pipinoelbreve9: folds 
LuisGR90: folds 
Lumifer: raises €0.04 to €0.06
pingu_771: folds 
Uncalled bet (€0.04) returned to Lumifer
Lumifer collected €0.04 from pot
Lumifer: doesn't show hand 
*** SUMMARY ***
Total pot €0.04 | Rake €0 
Seat 1: LuisGR90 (button) folded before Flop (didn't bet)
Seat 2: Lumifer (small blind) collected (€0.04)
Seat 3: pingu_771 (big blind) folded before Flop
Seat 4: winie66 folded before Flop (didn't bet)
Seat 5: Chichoampuero12 folded before Flop (didn't bet)
Seat 6: pipinoelbreve9 folded before Flop (didn't bet)



PokerStars Zoom Hand #257563207531:  Hold'em No Limit (€0.01/€0.02) - 2025/08/31 22:53:22 CET [2025/08/31 16:53:22 ET]
Table 'Arneb' 6-max Seat #1 is the button
Seat 1: pipinoelbreve9 (€4.11 in chips) 
Seat 2: RCSA2 (€1.52 in chips) 
Seat 3: maximus_powah (€3.58 in chips) 
Seat 4: charlyleon92 (€2.81 in chips) 
Seat 5: Izibeaxh (€3.21 in chips) 
Seat 6: Strlen83 (€2.10 in chips) 
RCSA2: posts small blind €0.01
maximus_powah: posts big blind €0.02
*** HOLE CARDS ***
Dealt to pipinoelbreve9 [7c 2h]
charlyleon92: folds 
Izibeaxh: raises €0.03 to €0.05
Strlen83: folds 
pipinoelbreve9: folds 
RCSA2: folds 
maximus_powah: folds 
Uncalled bet (€0.03) returned to Izibeaxh
Izibeaxh collected €0.05 from pot
Izibeaxh: doesn't show hand 
*** SUMMARY ***
Total pot €0.05 | Rake €0 
Seat 1: pipinoelbreve9 (button) folded before Flop (didn't bet)
Seat 2: RCSA2 (small blind) folded before Flop
Seat 3: maximus_powah (big blind) folded before Flop
Seat 4: charlyleon92 folded before Flop (didn't bet)
Seat 5: Izibeaxh collected (€0.05)
Seat 6: Strlen83 folded before Flop (didn't bet)



PokerStars Zoom Hand #257563204210:  Hold'em No Limit (€0.01/€0.02) - 2025/08/31 22:53:11 CET [2025/08/31 16:53:11 ET]
Table 'Arneb' 6-max Seat #1 is the button
Seat 1: Izibeaxh (€3.21 in chips) 
Seat 2: Belezaso21 (€1 in chips) 
Seat 3: winie66 (€3.47 in chips) 
Seat 4: Zohariel149 (€2.56 in chips) 
Seat 5: pipinoelbreve9 (€4.11 in chips) 
Seat 6: felgas1968 (€2.81 in chips) 
Belezaso21: posts small blind €0.01
winie66: posts big blind €0.02
*** HOLE CARDS ***
Dealt to pipinoelbreve9 [Ts 2h]
Zohariel149: raises €0.04 to €0.06
pipinoelbreve9: folds 
felgas1968: calls €0.06
Izibeaxh: folds 
Belezaso21: folds 
winie66: folds 
*** FLOP *** [Th 9d Qs]
Zohariel149: checks 
felgas1968: bets €0.06
Zohariel149: raises €0.09 to €0.15
felgas1968: calls €0.09
*** TURN *** [Th 9d Qs] [Qd]
Zohariel149: bets €0.24
felgas1968: raises €0.24 to €0.48
Zohariel149: folds 
Uncalled bet (€0.24) returned to felgas1968
felgas1968 collected €0.88 from pot
felgas1968: doesn't show hand 
*** SUMMARY ***
Total pot €0.93 | Rake €0.05 
Board [Th 9d Qs Qd]
Seat 1: Izibeaxh (button) folded before Flop (didn't bet)
Seat 2: Belezaso21 (small blind) folded before Flop
Seat 3: winie66 (big blind) folded before Flop
Seat 4: Zohariel149 folded on the Turn
Seat 5: pipinoelbreve9 folded before Flop (didn't bet)
Seat 6: felgas1968 collected (€0.88)



PokerStars Zoom Hand #257563222586:  Hold'em No Limit (€0.01/€0.02) - 2025/08/31 22:54:11 CET [2025/08/31 16:54:11 ET]
Table 'Arneb' 6-max Seat #1 is the button
Seat 1: Belezaso21 (€0.95 in chips) 
Seat 2: pipinoelbreve9 (€4.09 in chips) 
Seat 3: maximus_powah (€3.24 in chips) 
Seat 4: masquisiera (€1 in chips) 
Seat 5: RCSA2 (€3.35 in chips) 
Seat 6: Fulcrumm (€1.13 in chips) 
pipinoelbreve9: posts small blind €0.01
maximus_powah: posts big blind €0.02
*** HOLE CARDS ***
Dealt to pipinoelbreve9 [7h 7s]
masquisiera: folds 
RCSA2: folds 
Fulcrumm: folds 
Belezaso21: folds 
pipinoelbreve9: raises €0.04 to €0.06
maximus_powah: folds 
Uncalled bet (€0.04) returned to pipinoelbreve9
pipinoelbreve9 collected €0.04 from pot
pipinoelbreve9: doesn't show hand 
*** SUMMARY ***
Total pot €0.04 | Rake €0 
Seat 1: Belezaso21 (button) folded before Flop (didn't bet)
Seat 2: pipinoelbreve9 (small blind) collected (€0.04)
Seat 3: maximus_powah (big blind) folded before Flop
Seat 4: masquisiera folded before Flop (didn't bet)
Seat 5: RCSA2 folded before Flop (didn't bet)
Seat 6: Fulcrumm folded before Flop (didn't bet)



PokerStars Zoom Hand #257563209668:  Hold'em No Limit (€0.01/€0.02) - 2025/08/31 22:53:29 CET [2025/08/31 16:53:29 ET]
Table 'Arneb' 6-max Seat #1 is the button
Seat 1: raptureman1 (€2 in chips) 
Seat 2: felgas1968 (€2.53 in chips) 
Seat 3: pipinoelbreve9 (€4.11 in chips) 
Seat 4: Strlen83 (€2.10 in chips) 
Seat 5: WJSP (€1.67 in chips) 
Seat 6: ana paula900 (€0.99 in chips) 
felgas1968: posts small blind €0.01
pipinoelbreve9: posts big blind €0.02
*** HOLE CARDS ***
Dealt to pipinoelbreve9 [9s 7h]
Strlen83: folds 
WJSP: folds 
ana paula900: raises €0.02 to €0.04
raptureman1: calls €0.04
felgas1968: folds 
pipinoelbreve9: folds 
*** FLOP *** [Th Jd Qc]
ana paula900: bets €0.10
raptureman1: calls €0.10
*** TURN *** [Th Jd Qc] [4d]
ana paula900: checks 
raptureman1: bets €0.18
ana paula900: calls €0.18
*** RIVER *** [Th Jd Qc 4d] [6s]
ana paula900: checks 
raptureman1: checks 
*** SHOW DOWN ***
ana paula900: shows [Ad Jh] (a pair of Jacks)
raptureman1: shows [Kd Qh] (a pair of Queens)
raptureman1 collected €0.64 from pot
*** SUMMARY ***
Total pot €0.67 | Rake €0.03 
Board [Th Jd Qc 4d 6s]
Seat 1: raptureman1 (button) showed [Kd Qh] and won (€0.64) with a pair of Queens
Seat 2: felgas1968 (small blind) folded before Flop
Seat 3: pipinoelbreve9 (big blind) folded before Flop
Seat 4: Strlen83 folded before Flop (didn't bet)
Seat 5: WJSP folded before Flop (didn't bet)
Seat 6: ana paula900 showed [Ad Jh] and lost with a pair of Jacks



PokerStars Zoom Hand #257563226711:  Hold'em No Limit (€0.01/€0.02) - 2025/08/31 22:54:24 CET [2025/08/31 16:54:24 ET]
Table 'Arneb' 6-max Seat #1 is the button
Seat 1: Zohariel149 (€2.14 in chips) 
Seat 2: maximus_powah (€3.22 in chips) 
Seat 3: sambupkr (€4.21 in chips) 
Seat 4: masquisiera (€1 in chips) 
Seat 5: felgas1968 (€4.91 in chips) 
Seat 6: pipinoelbreve9 (€4.11 in chips) 
maximus_powah: posts small blind €0.01
sambupkr: posts big blind €0.02
*** HOLE CARDS ***
Dealt to pipinoelbreve9 [3h 4h]
masquisiera: folds 
felgas1968: folds 
pipinoelbreve9: raises €0.04 to €0.06
Zohariel149: folds 
maximus_powah: raises €0.12 to €0.18
sambupkr: folds 
pipinoelbreve9: calls €0.12
*** FLOP *** [8c 8d Kd]
maximus_powah: bets €0.12
pipinoelbreve9: folds 
Uncalled bet (€0.12) returned to maximus_powah
maximus_powah collected €0.36 from pot
maximus_powah: doesn't show hand 
*** SUMMARY ***
Total pot €0.38 | Rake €0.02 
Board [8c 8d Kd]
Seat 1: Zohariel149 (button) folded before Flop (didn't bet)
Seat 2: maximus_powah (small blind) collected (€0.36)
Seat 3: sambupkr (big blind) folded before Flop
Seat 4: masquisiera folded before Flop (didn't bet)
Seat 5: felgas1968 folded before Flop (didn't bet)
Seat 6: pipinoelbreve9 folded on the Flop



PokerStars Zoom Hand #257563238613:  Hold'em No Limit (€0.01/€0.02) - 2025/08/31 22:55:03 CET [2025/08/31 16:55:03 ET]
Table 'Arneb' 6-max Seat #1 is the button
Seat 1: Grilo9 (€2 in chips) 
Seat 2: PkBcN15 (€2 in chips) 
Seat 3: LGC04 (€1.14 in chips) 
Seat 4: pipinoelbreve9 (€3.93 in chips) 
Seat 5: sambupkr (€2.08 in chips) 
Seat 6: tanoun1 (€2.18 in chips) 
PkBcN15: posts small blind €0.01
LGC04: posts big blind €0.02
*** HOLE CARDS ***
Dealt to pipinoelbreve9 [4c 7s]
pipinoelbreve9: folds 
sambupkr: folds 
tanoun1: folds 
Grilo9: raises €0.04 to €0.06
PkBcN15: folds 
LGC04: calls €0.04
*** FLOP *** [4d 2s 5h]
LGC04: checks 
Grilo9: bets €0.06
LGC04: folds 
Uncalled bet (€0.06) returned to Grilo9
Grilo9 collected €0.12 from pot
Grilo9: doesn't show hand 
*** SUMMARY ***
Total pot €0.13 | Rake €0.01 
Board [4d 2s 5h]
Seat 1: Grilo9 (button) collected (€0.12)
Seat 2: PkBcN15 (small blind) folded before Flop
Seat 3: LGC04 (big blind) folded on the Flop
Seat 4: pipinoelbreve9 folded before Flop (didn't bet)
Seat 5: sambupkr folded before Flop (didn't bet)
Seat 6: tanoun1 folded before Flop (didn't bet)



PokerStars Zoom Hand #257563240195:  Hold'em No Limit (€0.01/€0.02) - 2025/08/31 22:55:08 CET [2025/08/31 16:55:08 ET]
Table 'Arneb' 6-max Seat #1 is the button
Seat 1: Xoco Cusco (€2.88 in chips) 
Seat 2: tanoun1 (€2.18 in chips) 
Seat 3: pipinoelbreve9 (€3.93 in chips) 
Seat 4: PkBcN15 (€2.06 in chips) 
Seat 5: Grilo9 (€2.08 in chips) 
Seat 6: El_hamel14 (€0.92 in chips) 
tanoun1: posts small blind €0.01
pipinoelbreve9: posts big blind €0.02
*** HOLE CARDS ***
Dealt to pipinoelbreve9 [Kh 7d]
PkBcN15: folds 
Grilo9: folds 
El_hamel14: folds 
Xoco Cusco: folds 
tanoun1: raises €0.04 to €0.06
pipinoelbreve9: calls €0.04
*** FLOP *** [9s Jd 5d]
tanoun1: bets €0.06
pipinoelbreve9: folds 
Uncalled bet (€0.06) returned to tanoun1
tanoun1 collected €0.11 from pot
tanoun1: doesn't show hand 
*** SUMMARY ***
Total pot €0.12 | Rake €0.01 
Board [9s Jd 5d]
Seat 1: Xoco Cusco (button) folded before Flop (didn't bet)
Seat 2: tanoun1 (small blind) collected (€0.11)
Seat 3: pipinoelbreve9 (big blind) folded on the Flop
Seat 4: PkBcN15 folded before Flop (didn't bet)
Seat 5: Grilo9 folded before Flop (didn't bet)
Seat 6: El_hamel14 folded before Flop (didn't bet)



PokerStars Zoom Hand #257563237478:  Hold'em No Limit (€0.01/€0.02) - 2025/08/31 22:54:59 CET [2025/08/31 16:54:59 ET]
Table 'Arneb' 6-max Seat #1 is the button
Seat 1: LGC04 (€1.14 in chips) 
Seat 2: 34pluto (€1.75 in chips) 
Seat 3: danywoo (€0.66 in chips) 
Seat 4: sambupkr (€2.08 in chips) 
Seat 5: pipinoelbreve9 (€3.93 in chips) 
Seat 6: juanlu2000china (€1.89 in chips) 
34pluto: posts small blind €0.01
danywoo: posts big blind €0.02
*** HOLE CARDS ***
Dealt to pipinoelbreve9 [5h Ad]
sambupkr: folds 
pipinoelbreve9: folds 
juanlu2000china: raises €0.02 to €0.04
LGC04: folds 
34pluto: folds 
danywoo: calls €0.02
*** FLOP *** [Js 9d 7c]
danywoo: checks 
juanlu2000china: bets €0.04
danywoo: calls €0.04
*** TURN *** [Js 9d 7c] [2s]
danywoo: checks 
juanlu2000china: bets €0.12
danywoo: folds 
Uncalled bet (€0.12) returned to juanlu2000china
juanlu2000china collected €0.16 from pot
juanlu2000china: doesn't show hand 
*** SUMMARY ***
Total pot €0.17 | Rake €0.01 
Board [Js 9d 7c 2s]
Seat 1: LGC04 (button) folded before Flop (didn't bet)
Seat 2: 34pluto (small blind) folded before Flop
Seat 3: danywoo (big blind) folded on the Turn
Seat 4: sambupkr folded before Flop (didn't bet)
Seat 5: pipinoelbreve9 folded before Flop (didn't bet)
Seat 6: juanlu2000china collected (€0.16)



PokerStars Zoom Hand #257563244971:  Hold'em No Limit (€0.01/€0.02) - 2025/08/31 22:55:39 CET [2025/08/31 16:55:39 ET]
Table 'Arneb' 6-max Seat #1 is the button
Seat 1: Xoseanro510 (€2.58 in chips) 
Seat 2: WJSP (€1.81 in chips) 
Seat 3: tanoun1 (€4.75 in chips) 
Seat 4: 28chan28 (€2.80 in chips) 
Seat 5: ana paula900 (€0.66 in chips) 
Seat 6: pipinoelbreve9 (€3.87 in chips) 
WJSP: posts small blind €0.01
tanoun1: posts big blind €0.02
*** HOLE CARDS ***
Dealt to pipinoelbreve9 [7s 4s]
28chan28: folds 
ana paula900: folds 
pipinoelbreve9: folds 
Xoseanro510: folds 
WJSP: raises €0.02 to €0.04
tanoun1: folds 
Uncalled bet (€0.02) returned to WJSP
WJSP collected €0.04 from pot
WJSP: doesn't show hand 
*** SUMMARY ***
Total pot €0.04 | Rake €0 
Seat 1: Xoseanro510 (button) folded before Flop (didn't bet)
Seat 2: WJSP (small blind) collected (€0.04)
Seat 3: tanoun1 (big blind) folded before Flop
Seat 4: 28chan28 folded before Flop (didn't bet)
Seat 5: ana paula900 folded before Flop (didn't bet)
Seat 6: pipinoelbreve9 folded before Flop (didn't bet)



PokerStars Zoom Hand #257563244272:  Hold'em No Limit (€0.01/€0.02) - 2025/08/31 22:55:34 CET [2025/08/31 16:55:34 ET]
Table 'Arneb' 6-max Seat #1 is the button
Seat 1: pipinoelbreve9 (€3.87 in chips) 
Seat 2: Strlen83 (€2.04 in chips) 
Seat 3: Belezaso21 (€0.93 in chips) 
Seat 4: juanlu2000china (€1.97 in chips) 
Seat 5: Jeffkijay (€3.24 in chips) 
Seat 6: Zohariel149 (€2 in chips) 
Strlen83: posts small blind €0.01
Belezaso21: posts big blind €0.02
*** HOLE CARDS ***
Dealt to pipinoelbreve9 [Ts 3d]
juanlu2000china: calls €0.02
Jeffkijay: folds 
Zohariel149: folds 
pipinoelbreve9: folds 
Strlen83: folds 
Belezaso21: checks 
*** FLOP *** [Ad 8c 2s]
Belezaso21: checks 
juanlu2000china: bets €0.02
Belezaso21: folds 
Uncalled bet (€0.02) returned to juanlu2000china
juanlu2000china collected €0.05 from pot
juanlu2000china: doesn't show hand 
*** SUMMARY ***
Total pot €0.05 | Rake €0 
Board [Ad 8c 2s]
Seat 1: pipinoelbreve9 (button) folded before Flop (didn't bet)
Seat 2: Strlen83 (small blind) folded before Flop
Seat 3: Belezaso21 (big blind) folded on the Flop
Seat 4: juanlu2000china collected (€0.05)
Seat 5: Jeffkijay folded before Flop (didn't bet)
Seat 6: Zohariel149 folded before Flop (didn't bet)



PokerStars Zoom Hand #257563245579:  Hold'em No Limit (€0.01/€0.02) - 2025/08/31 22:55:43 CET [2025/08/31 16:55:43 ET]
Table 'Arneb' 6-max Seat #1 is the button
Seat 1: RCSA2 (€1.46 in chips) 
Seat 2: pipinoelbreve9 (€3.87 in chips) 
Seat 3: elseneka-1 (€4.65 in chips) 
Seat 4: Grilo9 (€2.14 in chips) 
Seat 5: felgas1968 (€3.11 in chips) 
Seat 6: sambupkr (€2.58 in chips) 
pipinoelbreve9: posts small blind €0.01
elseneka-1: posts big blind €0.02
*** HOLE CARDS ***
Dealt to pipinoelbreve9 [7s Jh]
Grilo9: folds 
felgas1968: folds 
sambupkr: folds 
RCSA2: raises €0.08 to €0.10
pipinoelbreve9: folds 
elseneka-1: folds 
Uncalled bet (€0.08) returned to RCSA2
RCSA2 collected €0.05 from pot
RCSA2: doesn't show hand 
*** SUMMARY ***
Total pot €0.05 | Rake €0 
Seat 1: RCSA2 (button) collected (€0.05)
Seat 2: pipinoelbreve9 (small blind) folded before Flop
Seat 3: elseneka-1 (big blind) folded before Flop
Seat 4: Grilo9 folded before Flop (didn't bet)
Seat 5: felgas1968 folded before Flop (didn't bet)
Seat 6: sambupkr folded before Flop (didn't bet)



PokerStars Zoom Hand #257563246322:  Hold'em No Limit (€0.01/€0.02) - 2025/08/31 22:55:48 CET [2025/08/31 16:55:48 ET]
Table 'Arneb' 6-max Seat #1 is the button
Seat 1: Izibeaxh (€3.39 in chips) 
Seat 2: masquisiera (€1 in chips) 
Seat 3: rockola14 (€2 in chips) 
Seat 4: Grilo9 (€2.05 in chips) 
Seat 5: pipinoelbreve9 (€3.86 in chips) 
Seat 6: PavoN_PT (€2.14 in chips) 
masquisiera: posts small blind €0.01
rockola14: posts big blind €0.02
*** HOLE CARDS ***
Dealt to pipinoelbreve9 [Ks 9s]
Grilo9: folds 
pipinoelbreve9: raises €0.04 to €0.06
PavoN_PT: calls €0.06
Izibeaxh: calls €0.06
masquisiera: calls €0.05
rockola14: calls €0.04
*** FLOP *** [4d Qs Ah]
masquisiera: checks 
rockola14: checks 
pipinoelbreve9: checks 
PavoN_PT: checks 
Izibeaxh: bets €0.28
masquisiera: folds 
rockola14: folds 
pipinoelbreve9: folds 
PavoN_PT: folds 
Uncalled bet (€0.28) returned to Izibeaxh
Izibeaxh collected €0.28 from pot
Izibeaxh: doesn't show hand 
*** SUMMARY ***
Total pot €0.30 | Rake €0.02 
Board [4d Qs Ah]
Seat 1: Izibeaxh (button) collected (€0.28)
Seat 2: masquisiera (small blind) folded on the Flop
Seat 3: rockola14 (big blind) folded on the Flop
Seat 4: Grilo9 folded before Flop (didn't bet)
Seat 5: pipinoelbreve9 folded on the Flop
Seat 6: PavoN_PT folded on the Flop



PokerStars Zoom Hand #257563253571:  Hold'em No Limit (€0.01/€0.02) - 2025/08/31 22:56:34 CET [2025/08/31 16:56:34 ET]
Table 'Arneb' 6-max Seat #1 is the button
Seat 1: Manuxanxe78 (€2.05 in chips) 
Seat 2: 34pluto (€1.82 in chips) 
Seat 3: tanoun1 (€4.75 in chips) 
Seat 4: pipinoelbreve9 (€3.80 in chips) 
Seat 5: sambupkr (€2.51 in chips) 
Seat 6: raptureman1 (€2.44 in chips) 
34pluto: posts small blind €0.01
tanoun1: posts big blind €0.02
*** HOLE CARDS ***
Dealt to pipinoelbreve9 [3h 3d]
pipinoelbreve9: folds 
sambupkr: folds 
raptureman1: folds 
Manuxanxe78 has timed out
Manuxanxe78: folds 
34pluto: folds 
Uncalled bet (€0.01) returned to tanoun1
tanoun1 collected €0.02 from pot
tanoun1: doesn't show hand 
*** SUMMARY ***
Total pot €0.02 | Rake €0 
Seat 1: Manuxanxe78 (button) folded before Flop (didn't bet)
Seat 2: 34pluto (small blind) folded before Flop
Seat 3: tanoun1 (big blind) collected (€0.02)
Seat 4: pipinoelbreve9 folded before Flop (didn't bet)
Seat 5: sambupkr folded before Flop (didn't bet)
Seat 6: raptureman1 folded before Flop (didn't bet)



PokerStars Zoom Hand #257563255511:  Hold'em No Limit (€0.01/€0.02) - 2025/08/31 22:56:46 CET [2025/08/31 16:56:46 ET]
Table 'Arneb' 6-max Seat #1 is the button
Seat 1: pipinoelbreve9 (€3.80 in chips) 
Seat 2: sambupkr (€2.54 in chips) 
Seat 3: pemajoa (€2 in chips) 
Seat 4: raptureman1 (€2.44 in chips) 
Seat 5: LuisGR90 (€2.06 in chips) 
Seat 6: fauve45760 (€2.02 in chips) 
sambupkr: posts small blind €0.01
pemajoa: posts big blind €0.02
*** HOLE CARDS ***
Dealt to pipinoelbreve9 [Qc Jh]
raptureman1: folds 
LuisGR90: folds 
fauve45760: calls €0.02
pipinoelbreve9: raises €0.08 to €0.10
sambupkr: folds 
pemajoa: folds 
fauve45760: calls €0.08
*** FLOP *** [3c 9h Jc]
fauve45760: checks 
pipinoelbreve9: bets €0.11
fauve45760: raises €0.15 to €0.26
pipinoelbreve9: calls €0.15
*** TURN *** [3c 9h Jc] [2d]
fauve45760: bets €0.36
pipinoelbreve9: calls €0.36
*** RIVER *** [3c 9h Jc 2d] [4h]
fauve45760: checks 
pipinoelbreve9: bets €0.70
fauve45760: calls €0.70
*** SHOW DOWN ***
pipinoelbreve9: shows [Qc Jh] (a pair of Jacks)
fauve45760: mucks hand 
pipinoelbreve9 collected €2.73 from pot
*** SUMMARY ***
Total pot €2.87 | Rake €0.14 
Board [3c 9h Jc 2d 4h]
Seat 1: pipinoelbreve9 (button) showed [Qc Jh] and won (€2.73) with a pair of Jacks
Seat 2: sambupkr (small blind) folded before Flop
Seat 3: pemajoa (big blind) folded before Flop
Seat 4: raptureman1 folded before Flop (didn't bet)
Seat 5: LuisGR90 folded before Flop (didn't bet)
Seat 6: fauve45760 mucked [2h As]



PokerStars Zoom Hand #257563254592:  Hold'em No Limit (€0.01/€0.02) - 2025/08/31 22:56:40 CET [2025/08/31 16:56:40 ET]
Table 'Arneb' 6-max Seat #1 is the button
Seat 1: LGC04 (€1.69 in chips) 
Seat 2: felgas1968 (€1.61 in chips) 
Seat 3: masquisiera (€1 in chips) 
Seat 4: pipinoelbreve9 (€3.80 in chips) 
Seat 5: tanoun1 (€2.21 in chips) 
Seat 6: Grilo9 (€2.10 in chips) 
felgas1968: posts small blind €0.01
masquisiera: posts big blind €0.02
*** HOLE CARDS ***
Dealt to pipinoelbreve9 [7s Ac]
pipinoelbreve9: folds 
tanoun1: raises €0.03 to €0.05
Grilo9: folds 
LGC04: folds 
felgas1968: calls €0.04
masquisiera: calls €0.03
*** FLOP *** [3d Ah Td]
felgas1968: checks 
masquisiera: checks 
tanoun1: bets €0.08
felgas1968: calls €0.08
masquisiera: calls €0.08
*** TURN *** [3d Ah Td] [4c]
felgas1968: checks 
masquisiera: checks 
tanoun1: checks 
*** RIVER *** [3d Ah Td 4c] [Ks]
felgas1968: checks 
masquisiera: checks 
tanoun1: checks 
*** SHOW DOWN ***
felgas1968: shows [2h 2c] (a pair of Deuces)
masquisiera: mucks hand 
tanoun1: shows [As 9s] (a pair of Aces)
tanoun1 collected €0.37 from pot
*** SUMMARY ***
Total pot €0.39 | Rake €0.02 
Board [3d Ah Td 4c Ks]
Seat 1: LGC04 (button) folded before Flop (didn't bet)
Seat 2: felgas1968 (small blind) showed [2h 2c] and lost with a pair of Deuces
Seat 3: masquisiera (big blind) mucked [Jh 9h]
Seat 4: pipinoelbreve9 folded before Flop (didn't bet)
Seat 5: tanoun1 showed [As 9s] and won (€0.37) with a pair of Aces
Seat 6: Grilo9 folded before Flop (didn't bet)



PokerStars Zoom Hand #257563292394:  Hold'em No Limit (€0.01/€0.02) - 2025/08/31 23:00:35 CET [2025/08/31 17:00:35 ET]
Table 'Arneb' 6-max Seat #1 is the button
Seat 1: pucelazo (€2 in chips) 
Seat 2: AnxoGM (€3.41 in chips) 
Seat 3: pipinoelbreve9 (€5.11 in chips) 
Seat 4: WJSP (€2 in chips) 
Seat 5: felgas1968 (€2.33 in chips) 
Seat 6: cesarclown (€0.85 in chips) 
AnxoGM: posts small blind €0.01
pipinoelbreve9: posts big blind €0.02
*** HOLE CARDS ***
Dealt to pipinoelbreve9 [8d 2d]
WJSP: raises €0.02 to €0.04
felgas1968: folds 
cesarclown: folds 
pucelazo: raises €0.08 to €0.12
AnxoGM: folds 
pipinoelbreve9: folds 
WJSP: folds 
Uncalled bet (€0.08) returned to pucelazo
pucelazo collected €0.11 from pot
pucelazo: doesn't show hand 
*** SUMMARY ***
Total pot €0.11 | Rake €0 
Seat 1: pucelazo (button) collected (€0.11)
Seat 2: AnxoGM (small blind) folded before Flop
Seat 3: pipinoelbreve9 (big blind) folded before Flop
Seat 4: WJSP folded before Flop
Seat 5: felgas1968 folded before Flop (didn't bet)
Seat 6: cesarclown folded before Flop (didn't bet)



PokerStars Zoom Hand #257563293745:  Hold'em No Limit (€0.01/€0.02) - 2025/08/31 23:00:42 CET [2025/08/31 17:00:42 ET]
Table 'Arneb' 6-max Seat #1 is the button
Seat 1: maximus_powah (€4.27 in chips) 
Seat 2: pipinoelbreve9 (€5.09 in chips) 
Seat 3: tanoun1 (€5.80 in chips) 
Seat 4: cesarclown (€0.85 in chips) 
Seat 5: masquisiera (€1.19 in chips) 
Seat 6: elseneka-1 (€4.56 in chips) 
pipinoelbreve9: posts small blind €0.01
tanoun1: posts big blind €0.02
*** HOLE CARDS ***
Dealt to pipinoelbreve9 [9h Qc]
cesarclown: calls €0.02
masquisiera: folds 
elseneka-1: folds 
maximus_powah: folds 
pipinoelbreve9: calls €0.01
tanoun1: checks 
*** FLOP *** [6h Kh 2d]
pipinoelbreve9: checks 
tanoun1: checks 
cesarclown: checks 
*** TURN *** [6h Kh 2d] [Kc]
pipinoelbreve9: checks 
tanoun1: checks 
cesarclown: checks 
*** RIVER *** [6h Kh 2d Kc] [Ac]
pipinoelbreve9: checks 
tanoun1: checks 
cesarclown: checks 
*** SHOW DOWN ***
pipinoelbreve9: shows [9h Qc] (a pair of Kings)
tanoun1: shows [6s Qd] (two pair, Kings and Sixes)
cesarclown: mucks hand 
tanoun1 collected €0.06 from pot
*** SUMMARY ***
Total pot €0.06 | Rake €0 
Board [6h Kh 2d Kc Ac]
Seat 1: maximus_powah (button) folded before Flop (didn't bet)
Seat 2: pipinoelbreve9 (small blind) showed [9h Qc] and lost with a pair of Kings
Seat 3: tanoun1 (big blind) showed [6s Qd] and won (€0.06) with two pair, Kings and Sixes
Seat 4: cesarclown mucked [7d Jd]
Seat 5: masquisiera folded before Flop (didn't bet)
Seat 6: elseneka-1 folded before Flop (didn't bet)



PokerStars Zoom Hand #257563308274:  Hold'em No Limit (€0.01/€0.02) - 2025/08/31 23:01:44 CET [2025/08/31 17:01:44 ET]
Table 'Arneb' 6-max Seat #1 is the button
Seat 1: lorocontento (€1.48 in chips) 
Seat 2: aaronroxi (€2.73 in chips) 
Seat 3: LuisGR90 (€2.27 in chips) 
Seat 4: Grilo9 (€2 in chips) 
Seat 5: raptureman1 (€2.56 in chips) 
Seat 6: pipinoelbreve9 (€5.07 in chips) 
aaronroxi: posts small blind €0.01
LuisGR90: posts big blind €0.02
*** HOLE CARDS ***
Dealt to pipinoelbreve9 [8c Qd]
Grilo9: folds 
raptureman1: folds 
pipinoelbreve9: folds 
lorocontento: folds 
aaronroxi: folds 
Uncalled bet (€0.01) returned to LuisGR90
LuisGR90 collected €0.02 from pot
LuisGR90: doesn't show hand 
*** SUMMARY ***
Total pot €0.02 | Rake €0 
Seat 1: lorocontento (button) folded before Flop (didn't bet)
Seat 2: aaronroxi (small blind) folded before Flop
Seat 3: LuisGR90 (big blind) collected (€0.02)
Seat 4: Grilo9 folded before Flop (didn't bet)
Seat 5: raptureman1 folded before Flop (didn't bet)
Seat 6: pipinoelbreve9 folded before Flop (didn't bet)



PokerStars Zoom Hand #257563304623:  Hold'em No Limit (€0.01/€0.02) - 2025/08/31 23:01:30 CET [2025/08/31 17:01:30 ET]
Table 'Arneb' 6-max Seat #1 is the button
Seat 1: pipinoelbreve9 (€5.07 in chips) 
Seat 2: tanoun1 (€5.84 in chips) 
Seat 3: cesarclown (€0.83 in chips) 
Seat 4: RCSA2 (€1.46 in chips) 
Seat 5: Grilo9 (€3.74 in chips) 
Seat 6: jvilela007 (€2 in chips) 
tanoun1: posts small blind €0.01
cesarclown: posts big blind €0.02
*** HOLE CARDS ***
Dealt to pipinoelbreve9 [9h 6d]
RCSA2: calls €0.02
Grilo9: calls €0.02
jvilela007: folds 
pipinoelbreve9: folds 
tanoun1: folds 
cesarclown: checks 
*** FLOP *** [3h As Ad]
cesarclown: bets €0.02
RCSA2: folds 
Grilo9: folds 
Uncalled bet (€0.02) returned to cesarclown
cesarclown collected €0.07 from pot
cesarclown: doesn't show hand 
*** SUMMARY ***
Total pot €0.07 | Rake €0 
Board [3h As Ad]
Seat 1: pipinoelbreve9 (button) folded before Flop (didn't bet)
Seat 2: tanoun1 (small blind) folded before Flop
Seat 3: cesarclown (big blind) collected (€0.07)
Seat 4: RCSA2 folded on the Flop
Seat 5: Grilo9 folded on the Flop
Seat 6: jvilela007 folded before Flop (didn't bet)



PokerStars Zoom Hand #257563309129:  Hold'em No Limit (€0.01/€0.02) - 2025/08/31 23:01:47 CET [2025/08/31 17:01:47 ET]
Table 'Arneb' 6-max Seat #1 is the button
Seat 1: pucelazo (€2 in chips) 
Seat 2: lopo1187 (€2.07 in chips) 
Seat 3: aaronroxi (€2.72 in chips) 
Seat 4: tanoun1 (€2.03 in chips) 
Seat 5: pipinoelbreve9 (€5.07 in chips) 
Seat 6: PkBcN15 (€2.15 in chips) 
lopo1187: posts small blind €0.01
aaronroxi: posts big blind €0.02
*** HOLE CARDS ***
Dealt to pipinoelbreve9 [Qh Th]
tanoun1: folds 
pipinoelbreve9: raises €0.04 to €0.06
PkBcN15: folds 
pucelazo: folds 
lopo1187: folds 
aaronroxi: calls €0.04
*** FLOP *** [6c 7s 8d]
aaronroxi: checks 
pipinoelbreve9: checks 
*** TURN *** [6c 7s 8d] [9c]
aaronroxi: checks 
pipinoelbreve9: bets €0.04
aaronroxi: calls €0.04
*** RIVER *** [6c 7s 8d 9c] [Ac]
aaronroxi: bets €0.30
pipinoelbreve9: calls €0.30
*** SHOW DOWN ***
aaronroxi: shows [Kc Qc] (a flush, Ace high)
pipinoelbreve9: mucks hand 
aaronroxi collected €0.77 from pot
*** SUMMARY ***
Total pot €0.81 | Rake €0.04 
Board [6c 7s 8d 9c Ac]
Seat 1: pucelazo (button) folded before Flop (didn't bet)
Seat 2: lopo1187 (small blind) folded before Flop
Seat 3: aaronroxi (big blind) showed [Kc Qc] and won (€0.77) with a flush, Ace high
Seat 4: tanoun1 folded before Flop (didn't bet)
Seat 5: pipinoelbreve9 mucked [Qh Th]
Seat 6: PkBcN15 folded before Flop (didn't bet)



PokerStars Zoom Hand #257563323454:  Hold'em No Limit (€0.01/€0.02) - 2025/08/31 23:02:39 CET [2025/08/31 17:02:39 ET]
Table 'Arneb' 6-max Seat #1 is the button
Seat 1: Xoseanro510 (€2.73 in chips) 
Seat 2: Fulcrumm (€0.87 in chips) 
Seat 3: pipinoelbreve9 (€4.67 in chips) 
Seat 4: aaronroxi (€3.09 in chips) 
Seat 5: Belezaso21 (€1.18 in chips) 
Seat 6: maximus_powah (€4.21 in chips) 
Fulcrumm: posts small blind €0.01
pipinoelbreve9: posts big blind €0.02
*** HOLE CARDS ***
Dealt to pipinoelbreve9 [2h 3d]
aaronroxi: folds 
Belezaso21: folds 
maximus_powah: folds 
Xoseanro510: folds 
Fulcrumm: raises €0.04 to €0.06
pipinoelbreve9: folds 
Uncalled bet (€0.04) returned to Fulcrumm
Fulcrumm collected €0.04 from pot
Fulcrumm: doesn't show hand 
*** SUMMARY ***
Total pot €0.04 | Rake €0 
Seat 1: Xoseanro510 (button) folded before Flop (didn't bet)
Seat 2: Fulcrumm (small blind) collected (€0.04)
Seat 3: pipinoelbreve9 (big blind) folded before Flop
Seat 4: aaronroxi folded before Flop (didn't bet)
Seat 5: Belezaso21 folded before Flop (didn't bet)
Seat 6: maximus_powah folded before Flop (didn't bet)



PokerStars Zoom Hand #257563331989:  Hold'em No Limit (€0.01/€0.02) - 2025/08/31 23:03:06 CET [2025/08/31 17:03:06 ET]
Table 'Arneb' 6-max Seat #1 is the button
Seat 1: maximus_powah (€4.19 in chips) 
Seat 2: CheckMate1346 (€2.44 in chips) 
Seat 3: Ishouboi (€1.21 in chips) 
Seat 4: Fulcrumm (€0.89 in chips) 
Seat 5: Xoseanro510 (€2.67 in chips) 
Seat 6: pipinoelbreve9 (€4.65 in chips) 
CheckMate1346: posts small blind €0.01
Ishouboi: posts big blind €0.02
*** HOLE CARDS ***
Dealt to pipinoelbreve9 [9h 4h]
Fulcrumm: folds 
Xoseanro510: folds 
pipinoelbreve9: folds 
maximus_powah: folds 
CheckMate1346: folds 
Uncalled bet (€0.01) returned to Ishouboi
Ishouboi collected €0.02 from pot
Ishouboi: doesn't show hand 
*** SUMMARY ***
Total pot €0.02 | Rake €0 
Seat 1: maximus_powah (button) folded before Flop (didn't bet)
Seat 2: CheckMate1346 (small blind) folded before Flop
Seat 3: Ishouboi (big blind) collected (€0.02)
Seat 4: Fulcrumm folded before Flop (didn't bet)
Seat 5: Xoseanro510 folded before Flop (didn't bet)
Seat 6: pipinoelbreve9 folded before Flop (didn't bet)



PokerStars Zoom Hand #257563333600:  Hold'em No Limit (€0.01/€0.02) - 2025/08/31 23:03:11 CET [2025/08/31 17:03:11 ET]
Table 'Arneb' 6-max Seat #1 is the button
Seat 1: Grilo9 (€3.72 in chips) 
Seat 2: pipinoelbreve9 (€4.65 in chips) 
Seat 3: 350ZJHN (€2 in chips) 
Seat 4: sambupkr (€2.35 in chips) 
Seat 5: maximus_powah (€4.19 in chips) 
Seat 6: AnxoGM (€3.65 in chips) 
pipinoelbreve9: posts small blind €0.01
350ZJHN: posts big blind €0.02
*** HOLE CARDS ***
Dealt to pipinoelbreve9 [4d 5d]
sambupkr: folds 
maximus_powah: folds 
AnxoGM: folds 
Grilo9: raises €0.04 to €0.06
pipinoelbreve9: calls €0.05
350ZJHN: folds 
*** FLOP *** [Ac 9s 3c]
pipinoelbreve9: checks 
Grilo9: checks 
*** TURN *** [Ac 9s 3c] [Ah]
pipinoelbreve9: checks 
Grilo9: checks 
*** RIVER *** [Ac 9s 3c Ah] [5s]
pipinoelbreve9: checks 
Grilo9: checks 
*** SHOW DOWN ***
pipinoelbreve9: shows [4d 5d] (two pair, Aces and Fives)
Grilo9: mucks hand 
pipinoelbreve9 collected €0.13 from pot
*** SUMMARY ***
Total pot €0.14 | Rake €0.01 
Board [Ac 9s 3c Ah 5s]
Seat 1: Grilo9 (button) mucked [7h Th]
Seat 2: pipinoelbreve9 (small blind) showed [4d 5d] and won (€0.13) with two pair, Aces and Fives
Seat 3: 350ZJHN (big blind) folded before Flop
Seat 4: sambupkr folded before Flop (didn't bet)
Seat 5: maximus_powah folded before Flop (didn't bet)
Seat 6: AnxoGM folded before Flop (didn't bet)



PokerStars Zoom Hand #257563343482:  Hold'em No Limit (€0.01/€0.02) - 2025/08/31 23:03:44 CET [2025/08/31 17:03:44 ET]
Table 'Arneb' 6-max Seat #1 is the button
Seat 1: pipinoelbreve9 (€4.72 in chips) 
Seat 2: forinal (€0.64 in chips) 
Seat 3: winie66 (€3.20 in chips) 
Seat 4: LuisGR90 (€2.08 in chips) 
Seat 5: Manuxanxe78 (€2.07 in chips) 
Seat 6: Grilo9 (€3.66 in chips) 
forinal: posts small blind €0.01
winie66: posts big blind €0.02
*** HOLE CARDS ***
Dealt to pipinoelbreve9 [4c Td]
LuisGR90: folds 
Manuxanxe78: folds 
Grilo9: folds 
pipinoelbreve9: folds 
forinal: folds 
Uncalled bet (€0.01) returned to winie66
winie66 collected €0.02 from pot
winie66: doesn't show hand 
*** SUMMARY ***
Total pot €0.02 | Rake €0 
Seat 1: pipinoelbreve9 (button) folded before Flop (didn't bet)
Seat 2: forinal (small blind) folded before Flop
Seat 3: winie66 (big blind) collected (€0.02)
Seat 4: LuisGR90 folded before Flop (didn't bet)
Seat 5: Manuxanxe78 folded before Flop (didn't bet)
Seat 6: Grilo9 folded before Flop (didn't bet)



PokerStars Zoom Hand #257563345243:  Hold'em No Limit (€0.01/€0.02) - 2025/08/31 23:03:49 CET [2025/08/31 17:03:49 ET]
Table 'Arneb' 6-max Seat #1 is the button
Seat 1: RichyPozo (€2.70 in chips) 
Seat 2: correcamiños (€2.25 in chips) 
Seat 3: maximus_powah (€4.21 in chips) 
Seat 4: pipinoelbreve9 (€4.72 in chips) 
Seat 5: Jeffkijay (€4.85 in chips) 
Seat 6: masquisiera (€1 in chips) 
correcamiños: posts small blind €0.01
maximus_powah: posts big blind €0.02
*** HOLE CARDS ***
Dealt to pipinoelbreve9 [2d 6c]
pipinoelbreve9: folds 
Jeffkijay: folds 
masquisiera: folds 
RichyPozo: folds 
correcamiños: raises €0.04 to €0.06
maximus_powah: raises €0.12 to €0.18
correcamiños: folds 
Uncalled bet (€0.12) returned to maximus_powah
maximus_powah collected €0.12 from pot
maximus_powah: doesn't show hand 
*** SUMMARY ***
Total pot €0.12 | Rake €0 
Seat 1: RichyPozo (button) folded before Flop (didn't bet)
Seat 2: correcamiños (small blind) folded before Flop
Seat 3: maximus_powah (big blind) collected (€0.12)
Seat 4: pipinoelbreve9 folded before Flop (didn't bet)
Seat 5: Jeffkijay folded before Flop (didn't bet)
Seat 6: masquisiera folded before Flop (didn't bet)



PokerStars Zoom Hand #257563347281:  Hold'em No Limit (€0.01/€0.02) - 2025/08/31 23:03:56 CET [2025/08/31 17:03:56 ET]
Table 'Arneb' 6-max Seat #1 is the button
Seat 1: Bestiote (€0.23 in chips) 
Seat 2: RichyPozo (€2 in chips) 
Seat 3: LuisGR90 (€2.08 in chips) 
Seat 4: pipinoelbreve9 (€4.72 in chips) 
Seat 5: Belezaso21 (€1.16 in chips) 
Seat 6: Grilo9 (€2.09 in chips) 
RichyPozo: posts small blind €0.01
LuisGR90: posts big blind €0.02
*** HOLE CARDS ***
Dealt to pipinoelbreve9 [6d Ah]
pipinoelbreve9: folds 
Belezaso21: folds 
Grilo9: folds 
Bestiote: folds 
RichyPozo: folds 
Uncalled bet (€0.01) returned to LuisGR90
LuisGR90 collected €0.02 from pot
LuisGR90: doesn't show hand 
*** SUMMARY ***
Total pot €0.02 | Rake €0 
Seat 1: Bestiote (button) folded before Flop (didn't bet)
Seat 2: RichyPozo (small blind) folded before Flop
Seat 3: LuisGR90 (big blind) collected (€0.02)
Seat 4: pipinoelbreve9 folded before Flop (didn't bet)
Seat 5: Belezaso21 folded before Flop (didn't bet)
Seat 6: Grilo9 folded before Flop (didn't bet)



PokerStars Zoom Hand #257563351092:  Hold'em No Limit (€0.01/€0.02) - 2025/08/31 23:04:08 CET [2025/08/31 17:04:08 ET]
Table 'Arneb' 6-max Seat #1 is the button
Seat 1: Manuxanxe78 (€2.08 in chips) 
Seat 2: jaqgarcia (€0.84 in chips) 
Seat 3: pipinoelbreve9 (€4.72 in chips) 
Seat 4: MakesMeRich (€2 in chips) 
Seat 5: Jeffkijay (€4.84 in chips) 
Seat 6: ehbraga (€0.94 in chips) 
jaqgarcia: posts small blind €0.01
pipinoelbreve9: posts big blind €0.02
*** HOLE CARDS ***
Dealt to pipinoelbreve9 [Ac 4c]
MakesMeRich: folds 
Jeffkijay: folds 
ehbraga: folds 
Manuxanxe78: folds 
jaqgarcia: raises €0.82 to €0.84 and is all-in
pipinoelbreve9: calls €0.82
*** FLOP *** [2s Jc 8s]
*** TURN *** [2s Jc 8s] [Js]
*** RIVER *** [2s Jc 8s Js] [Jh]
*** SHOW DOWN ***
jaqgarcia: shows [5d 5c] (a full house, Jacks full of Fives)
pipinoelbreve9: shows [Ac 4c] (three of a kind, Jacks)
jaqgarcia collected €1.60 from pot
*** SUMMARY ***
Total pot €1.68 | Rake €0.08 
Board [2s Jc 8s Js Jh]
Seat 1: Manuxanxe78 (button) folded before Flop (didn't bet)
Seat 2: jaqgarcia (small blind) showed [5d 5c] and won (€1.60) with a full house, Jacks full of Fives
Seat 3: pipinoelbreve9 (big blind) showed [Ac 4c] and lost with three of a kind, Jacks
Seat 4: MakesMeRich folded before Flop (didn't bet)
Seat 5: Jeffkijay folded before Flop (didn't bet)
Seat 6: ehbraga folded before Flop (didn't bet)



PokerStars Zoom Hand #257563365252:  Hold'em No Limit (€0.01/€0.02) - 2025/08/31 23:04:53 CET [2025/08/31 17:04:53 ET]
Table 'Arneb' 6-max Seat #1 is the button
Seat 1: pucelazo (€2 in chips) 
Seat 2: pipinoelbreve9 (€3.88 in chips) 
Seat 3: Manuxanxe78 (€3.32 in chips) 
Seat 4: sn2025 (€0.82 in chips) 
Seat 5: lorocontento (€1.04 in chips) 
Seat 6: maximus_powah (€4.23 in chips) 
pipinoelbreve9: posts small blind €0.01
Manuxanxe78: posts big blind €0.02
*** HOLE CARDS ***
Dealt to pipinoelbreve9 [7h 7s]
sn2025: folds 
lorocontento: raises €0.04 to €0.06
maximus_powah: folds 
pucelazo: folds 
pipinoelbreve9: calls €0.05
Manuxanxe78: folds 
*** FLOP *** [Jd Ks 3s]
pipinoelbreve9: checks 
lorocontento: bets €0.06
pipinoelbreve9: calls €0.06
*** TURN *** [Jd Ks 3s] [Th]
pipinoelbreve9: checks 
lorocontento: checks 
*** RIVER *** [Jd Ks 3s Th] [9d]
pipinoelbreve9: bets €0.13
lorocontento: calls €0.13
*** SHOW DOWN ***
pipinoelbreve9: shows [7h 7s] (a pair of Sevens)
lorocontento: shows [Js As] (a pair of Jacks)
lorocontento collected €0.49 from pot
*** SUMMARY ***
Total pot €0.52 | Rake €0.03 
Board [Jd Ks 3s Th 9d]
Seat 1: pucelazo (button) folded before Flop (didn't bet)
Seat 2: pipinoelbreve9 (small blind) showed [7h 7s] and lost with a pair of Sevens
Seat 3: Manuxanxe78 (big blind) folded before Flop
Seat 4: sn2025 folded before Flop (didn't bet)
Seat 5: lorocontento showed [Js As] and won (€0.49) with a pair of Jacks
Seat 6: maximus_powah folded before Flop (didn't bet)



PokerStars Zoom Hand #257563380546:  Hold'em No Limit (€0.01/€0.02) - 2025/08/31 23:05:42 CET [2025/08/31 17:05:42 ET]
Table 'Arneb' 6-max Seat #1 is the button
Seat 1: Jeffkijay (€4.83 in chips) 
Seat 2: Xoco Cusco (€1.86 in chips) 
Seat 3: raptureman1 (€2.60 in chips) 
Seat 4: tanoun1 (€2.07 in chips) 
Seat 5: 28chan28 (€4.06 in chips) 
Seat 6: pipinoelbreve9 (€3.63 in chips) 
Xoco Cusco: posts small blind €0.01
raptureman1: posts big blind €0.02
*** HOLE CARDS ***
Dealt to pipinoelbreve9 [9c Qd]
tanoun1: folds 
28chan28: folds 
pipinoelbreve9: folds 
Jeffkijay: folds 
Xoco Cusco: folds 
Uncalled bet (€0.01) returned to raptureman1
raptureman1 collected €0.02 from pot
raptureman1: doesn't show hand 
*** SUMMARY ***
Total pot €0.02 | Rake €0 
Seat 1: Jeffkijay (button) folded before Flop (didn't bet)
Seat 2: Xoco Cusco (small blind) folded before Flop
Seat 3: raptureman1 (big blind) collected (€0.02)
Seat 4: tanoun1 folded before Flop (didn't bet)
Seat 5: 28chan28 folded before Flop (didn't bet)
Seat 6: pipinoelbreve9 folded before Flop (didn't bet)



PokerStars Zoom Hand #257563381771:  Hold'em No Limit (€0.01/€0.02) - 2025/08/31 23:05:46 CET [2025/08/31 17:05:46 ET]
Table 'Arneb' 6-max Seat #1 is the button
Seat 1: pipinoelbreve9 (€3.63 in chips) 
Seat 2: Manuxanxe78 (€3.79 in chips) 
Seat 3: Xoco Cusco (€1.85 in chips) 
Seat 4: Bestiote (€0.27 in chips) 
Seat 5: Jeffkijay (€4.83 in chips) 
Seat 6: tanoun1 (€2.07 in chips) 
Manuxanxe78: posts small blind €0.01
Xoco Cusco: posts big blind €0.02
*** HOLE CARDS ***
Dealt to pipinoelbreve9 [3h 6d]
Bestiote: folds 
Jeffkijay: folds 
tanoun1: folds 
pipinoelbreve9: folds 
Manuxanxe78: folds 
Uncalled bet (€0.01) returned to Xoco Cusco
Xoco Cusco collected €0.02 from pot
Xoco Cusco: doesn't show hand 
*** SUMMARY ***
Total pot €0.02 | Rake €0 
Seat 1: pipinoelbreve9 (button) folded before Flop (didn't bet)
Seat 2: Manuxanxe78 (small blind) folded before Flop
Seat 3: Xoco Cusco (big blind) collected (€0.02)
Seat 4: Bestiote folded before Flop (didn't bet)
Seat 5: Jeffkijay folded before Flop (didn't bet)
Seat 6: tanoun1 folded before Flop (didn't bet)



PokerStars Zoom Hand #257563383144:  Hold'em No Limit (€0.01/€0.02) - 2025/08/31 23:05:51 CET [2025/08/31 17:05:51 ET]
Table 'Arneb' 6-max Seat #1 is the button
Seat 1: Belezaso21 (€1.17 in chips) 
Seat 2: ehbraga (€0.95 in chips) 
Seat 3: 350ZJHN (€2.08 in chips) 
Seat 4: PkBcN15 (€2.07 in chips) 
Seat 5: pipinoelbreve9 (€3.63 in chips) 
Seat 6: hero_5455 (€2.36 in chips) 
ehbraga: posts small blind €0.01
350ZJHN: posts big blind €0.02
*** HOLE CARDS ***
Dealt to pipinoelbreve9 [Qd 4s]
PkBcN15: folds 
pipinoelbreve9: folds 
hero_5455: raises €0.02 to €0.04
Belezaso21: folds 
ehbraga: folds 
350ZJHN: folds 
Uncalled bet (€0.02) returned to hero_5455
hero_5455 collected €0.05 from pot
hero_5455: doesn't show hand 
*** SUMMARY ***
Total pot €0.05 | Rake €0 
Seat 1: Belezaso21 (button) folded before Flop (didn't bet)
Seat 2: ehbraga (small blind) folded before Flop
Seat 3: 350ZJHN (big blind) folded before Flop
Seat 4: PkBcN15 folded before Flop (didn't bet)
Seat 5: pipinoelbreve9 folded before Flop (didn't bet)
Seat 6: hero_5455 collected (€0.05)



PokerStars Zoom Hand #257563379153:  Hold'em No Limit (€0.01/€0.02) - 2025/08/31 23:05:38 CET [2025/08/31 17:05:38 ET]
Table 'Arneb' 6-max Seat #1 is the button
Seat 1: lopo1187 (€2.01 in chips) 
Seat 2: lilpapayaa (€1.07 in chips) 
Seat 3: PkBcN15 (€2 in chips) 
Seat 4: raptureman1 (€2.60 in chips) 
Seat 5: pipinoelbreve9 (€3.63 in chips) 
Seat 6: Grilo9 (€2 in chips) 
lilpapayaa: posts small blind €0.01
PkBcN15: posts big blind €0.02
*** HOLE CARDS ***
Dealt to pipinoelbreve9 [3d Jd]
raptureman1: folds 
pipinoelbreve9: folds 
Grilo9: folds 
lopo1187: folds 
lilpapayaa: calls €0.01
PkBcN15: checks 
*** FLOP *** [8d Ac 4c]
lilpapayaa: checks 
PkBcN15: checks 
*** TURN *** [8d Ac 4c] [Js]
lilpapayaa: bets €0.03
PkBcN15: folds 
Uncalled bet (€0.03) returned to lilpapayaa
lilpapayaa collected €0.04 from pot
lilpapayaa: doesn't show hand 
*** SUMMARY ***
Total pot €0.04 | Rake €0 
Board [8d Ac 4c Js]
Seat 1: lopo1187 (button) folded before Flop (didn't bet)
Seat 2: lilpapayaa (small blind) collected (€0.04)
Seat 3: PkBcN15 (big blind) folded on the Turn
Seat 4: raptureman1 folded before Flop (didn't bet)
Seat 5: pipinoelbreve9 folded before Flop (didn't bet)
Seat 6: Grilo9 folded before Flop (didn't bet)



PokerStars Zoom Hand #257563384256:  Hold'em No Limit (€0.01/€0.02) - 2025/08/31 23:05:54 CET [2025/08/31 17:05:54 ET]
Table 'Arneb' 6-max Seat #1 is the button
Seat 1: Xoco Cusco (€1.86 in chips) 
Seat 2: pucelazo (€2.18 in chips) 
Seat 3: masquisiera (€1.03 in chips) 
Seat 4: pipinoelbreve9 (€3.63 in chips) 
Seat 5: LuisGR90 (€2.50 in chips) 
Seat 6: Belezaso21 (€1.17 in chips) 
pucelazo: posts small blind €0.01
masquisiera: posts big blind €0.02
*** HOLE CARDS ***
Dealt to pipinoelbreve9 [Kd 7d]
pipinoelbreve9: folds 
LuisGR90: folds 
Belezaso21: calls €0.02
Xoco Cusco: raises €0.07 to €0.09
pucelazo: folds 
masquisiera: calls €0.07
Belezaso21: folds 
*** FLOP *** [4d 3h 7c]
masquisiera: checks 
Xoco Cusco: checks 
*** TURN *** [4d 3h 7c] [5c]
masquisiera: bets €0.13
Xoco Cusco: folds 
Uncalled bet (€0.13) returned to masquisiera
masquisiera collected €0.20 from pot
masquisiera: doesn't show hand 
*** SUMMARY ***
Total pot €0.21 | Rake €0.01 
Board [4d 3h 7c 5c]
Seat 1: Xoco Cusco (button) folded on the Turn
Seat 2: pucelazo (small blind) folded before Flop
Seat 3: masquisiera (big blind) collected (€0.20)
Seat 4: pipinoelbreve9 folded before Flop (didn't bet)
Seat 5: LuisGR90 folded before Flop (didn't bet)
Seat 6: Belezaso21 folded before Flop



PokerStars Zoom Hand #257563437426:  Hold'em No Limit (€0.01/€0.02) - 2025/08/31 23:08:48 CET [2025/08/31 17:08:48 ET]
Table 'Arneb' 6-max Seat #1 is the button
Seat 1: pingu_771 (€2.02 in chips) 
Seat 2: Belezaso21 (€1.25 in chips) 
Seat 3: pipinoelbreve9 (€3.63 in chips) 
Seat 4: LuisGR90 (€2.02 in chips) 
Seat 5: cesarclown (€1.15 in chips) 
Seat 6: NotClaudio1 (€4.13 in chips) 
Belezaso21: posts small blind €0.01
pipinoelbreve9: posts big blind €0.02
*** HOLE CARDS ***
Dealt to pipinoelbreve9 [Tc Td]
LuisGR90: folds 
cesarclown: folds 
NotClaudio1: raises €0.02 to €0.04
pingu_771: raises €0.09 to €0.13
Belezaso21: folds 
pipinoelbreve9: calls €0.11
NotClaudio1: calls €0.09
*** FLOP *** [Qc 8d 6h]
pipinoelbreve9: checks 
NotClaudio1: checks 
pingu_771: bets €0.12
pipinoelbreve9: calls €0.12
NotClaudio1: calls €0.12
*** TURN *** [Qc 8d 6h] [Kd]
pipinoelbreve9: checks 
NotClaudio1: checks 
pingu_771: bets €0.48
pipinoelbreve9: folds 
NotClaudio1: calls €0.48
*** RIVER *** [Qc 8d 6h Kd] [2c]
NotClaudio1: checks 
pingu_771: bets €1.29 and is all-in
NotClaudio1: folds 
Uncalled bet (€1.29) returned to pingu_771
pingu_771 collected €1.63 from pot
pingu_771: doesn't show hand 
*** SUMMARY ***
Total pot €1.72 | Rake €0.09 
Board [Qc 8d 6h Kd 2c]
Seat 1: pingu_771 (button) collected (€1.63)
Seat 2: Belezaso21 (small blind) folded before Flop
Seat 3: pipinoelbreve9 (big blind) folded on the Turn
Seat 4: LuisGR90 folded before Flop (didn't bet)
Seat 5: cesarclown folded before Flop (didn't bet)
Seat 6: NotClaudio1 folded on the River



PokerStars Zoom Hand #257563462391:  Hold'em No Limit (€0.01/€0.02) - 2025/08/31 23:10:10 CET [2025/08/31 17:10:10 ET]
Table 'Arneb' 6-max Seat #1 is the button
Seat 1: Manuxanxe78 (€3.10 in chips) 
Seat 2: pipinoelbreve9 (€3.38 in chips) 
Seat 3: PkBcN15 (€2 in chips) 
Seat 4: Grilo9 (€2.02 in chips) 
Seat 5: simply_slike (€1.09 in chips) 
Seat 6: ratomi (€0.64 in chips) 
pipinoelbreve9: posts small blind €0.01
PkBcN15: posts big blind €0.02
*** HOLE CARDS ***
Dealt to pipinoelbreve9 [6s 9s]
Grilo9: folds 
simply_slike: calls €0.02
ratomi: folds 
Manuxanxe78: folds 
pipinoelbreve9: calls €0.01
PkBcN15: checks 
*** FLOP *** [8c 5c 6c]
pipinoelbreve9: checks 
PkBcN15: checks 
simply_slike: checks 
*** TURN *** [8c 5c 6c] [Jd]
pipinoelbreve9: checks 
PkBcN15: checks 
simply_slike: checks 
*** RIVER *** [8c 5c 6c Jd] [7s]
pipinoelbreve9: bets €0.06
PkBcN15: folds 
simply_slike: folds 
Uncalled bet (€0.06) returned to pipinoelbreve9
pipinoelbreve9 collected €0.06 from pot
pipinoelbreve9: doesn't show hand 
*** SUMMARY ***
Total pot €0.06 | Rake €0 
Board [8c 5c 6c Jd 7s]
Seat 1: Manuxanxe78 (button) folded before Flop (didn't bet)
Seat 2: pipinoelbreve9 (small blind) collected (€0.06)
Seat 3: PkBcN15 (big blind) folded on the River
Seat 4: Grilo9 folded before Flop (didn't bet)
Seat 5: simply_slike folded on the River
Seat 6: ratomi folded before Flop (didn't bet)



PokerStars Zoom Hand #257563476642:  Hold'em No Limit (€0.01/€0.02) - 2025/08/31 23:10:57 CET [2025/08/31 17:10:57 ET]
Table 'Arneb' 6-max Seat #1 is the button
Seat 1: pipinoelbreve9 (€3.42 in chips) 
Seat 2: XXXJAVIXXX14 (€1.73 in chips) 
Seat 3: PkBcN15 (€2.13 in chips) 
Seat 4: Jeffkijay (€4.77 in chips) 
Seat 5: wilbor123 (€1.97 in chips) 
Seat 6: LuisGR90 (€2 in chips) 
XXXJAVIXXX14: posts small blind €0.01
PkBcN15: posts big blind €0.02
*** HOLE CARDS ***
Dealt to pipinoelbreve9 [7s Kd]
Jeffkijay: raises €0.04 to €0.06
wilbor123: folds 
LuisGR90: folds 
pipinoelbreve9: folds 
XXXJAVIXXX14: calls €0.05
PkBcN15: folds 
*** FLOP *** [9d 3d 7d]
XXXJAVIXXX14: checks 
Jeffkijay: bets €0.06
XXXJAVIXXX14: calls €0.06
*** TURN *** [9d 3d 7d] [4s]
XXXJAVIXXX14: checks 
Jeffkijay: bets €0.11
XXXJAVIXXX14: calls €0.11
*** RIVER *** [9d 3d 7d 4s] [2s]
XXXJAVIXXX14: checks 
Jeffkijay: checks 
*** SHOW DOWN ***
XXXJAVIXXX14: shows [6d Td] (a flush, Ten high)
Jeffkijay: mucks hand 
XXXJAVIXXX14 collected €0.46 from pot
*** SUMMARY ***
Total pot €0.48 | Rake €0.02 
Board [9d 3d 7d 4s 2s]
Seat 1: pipinoelbreve9 (button) folded before Flop (didn't bet)
Seat 2: XXXJAVIXXX14 (small blind) showed [6d Td] and won (€0.46) with a flush, Ten high
Seat 3: PkBcN15 (big blind) folded before Flop
Seat 4: Jeffkijay mucked [Tc Th]
Seat 5: wilbor123 folded before Flop (didn't bet)
Seat 6: LuisGR90 folded before Flop (didn't bet)



PokerStars Zoom Hand #257563479546:  Hold'em No Limit (€0.01/€0.02) - 2025/08/31 23:11:07 CET [2025/08/31 17:11:07 ET]
Table 'Arneb' 6-max Seat #1 is the button
Seat 1: MakesMeRich (€2.97 in chips) 
Seat 2: correcamiños (€2.94 in chips) 
Seat 3: pipinoelbreve9 (€3.42 in chips) 
Seat 4: sambupkr (€2.64 in chips) 
Seat 5: Grilo9 (€2.92 in chips) 
Seat 6: pucelazo (€3.56 in chips) 
correcamiños: posts small blind €0.01
pipinoelbreve9: posts big blind €0.02
*** HOLE CARDS ***
Dealt to pipinoelbreve9 [6h 6c]
sambupkr: folds 
Grilo9: raises €0.04 to €0.06
pucelazo: folds 
MakesMeRich: folds 
correcamiños: folds 
pipinoelbreve9: calls €0.04
*** FLOP *** [7d 7h 2d]
pipinoelbreve9: checks 
Grilo9: bets €0.06
pipinoelbreve9: calls €0.06
*** TURN *** [7d 7h 2d] [Jd]
pipinoelbreve9: checks 
Grilo9: checks 
*** RIVER *** [7d 7h 2d Jd] [Th]
pipinoelbreve9: checks 
Grilo9: checks 
*** SHOW DOWN ***
pipinoelbreve9: shows [6h 6c] (two pair, Sevens and Sixes)
Grilo9: mucks hand 
pipinoelbreve9 collected €0.24 from pot
*** SUMMARY ***
Total pot €0.25 | Rake €0.01 
Board [7d 7h 2d Jd Th]
Seat 1: MakesMeRich (button) folded before Flop (didn't bet)
Seat 2: correcamiños (small blind) folded before Flop
Seat 3: pipinoelbreve9 (big blind) showed [6h 6c] and won (€0.24) with two pair, Sevens and Sixes
Seat 4: sambupkr folded before Flop (didn't bet)
Seat 5: Grilo9 mucked [4s 4c]
Seat 6: pucelazo folded before Flop (didn't bet)



PokerStars Zoom Hand #257563475290:  Hold'em No Limit (€0.01/€0.02) - 2025/08/31 23:10:53 CET [2025/08/31 17:10:53 ET]
Table 'Arneb' 6-max Seat #1 is the button
Seat 1: Grilo9 (€2.07 in chips) 
Seat 2: correcamiños (€2 in chips) 
Seat 3: ehbraga (€0.89 in chips) 
Seat 4: Lauranve (€1.68 in chips) 
Seat 5: pipinoelbreve9 (€3.42 in chips) 
Seat 6: cesarclown (€1.38 in chips) 
correcamiños: posts small blind €0.01
ehbraga: posts big blind €0.02
*** HOLE CARDS ***
Dealt to pipinoelbreve9 [4h 9h]
Lauranve: folds 
pipinoelbreve9: folds 
cesarclown: calls €0.02
Grilo9: folds 
correcamiños: calls €0.01
ehbraga: checks 
*** FLOP *** [Ad 8d Th]
correcamiños: checks 
ehbraga: bets €0.06
cesarclown: calls €0.06
correcamiños: calls €0.06
*** TURN *** [Ad 8d Th] [7h]
correcamiños: checks 
ehbraga: checks 
cesarclown: checks 
*** RIVER *** [Ad 8d Th 7h] [Ts]
correcamiños: checks 
ehbraga: checks 
cesarclown: checks 
*** SHOW DOWN ***
correcamiños: shows [Qd Js] (a pair of Tens)
ehbraga: shows [Kh 5d] (a pair of Tens - Ace+King kicker)
cesarclown: shows [9d 8h] (two pair, Tens and Eights)
cesarclown collected €0.23 from pot
*** SUMMARY ***
Total pot €0.24 | Rake €0.01 
Board [Ad 8d Th 7h Ts]
Seat 1: Grilo9 (button) folded before Flop (didn't bet)
Seat 2: correcamiños (small blind) showed [Qd Js] and lost with a pair of Tens
Seat 3: ehbraga (big blind) showed [Kh 5d] and lost with a pair of Tens
Seat 4: Lauranve folded before Flop (didn't bet)
Seat 5: pipinoelbreve9 folded before Flop (didn't bet)
Seat 6: cesarclown showed [9d 8h] and won (€0.23) with two pair, Tens and Eights



PokerStars Zoom Hand #257563493930:  Hold'em No Limit (€0.01/€0.02) - 2025/08/31 23:11:54 CET [2025/08/31 17:11:54 ET]
Table 'Arneb' 6-max Seat #1 is the button
Seat 1: pipinoelbreve9 (€3.54 in chips) 
Seat 2: tanoun1 (€2.63 in chips) 
Seat 3: michoude (€1.72 in chips) 
Seat 4: sambupkr (€2.02 in chips) 
Seat 5: pucelazo (€2.23 in chips) 
Seat 6: PkBcN15 (€2 in chips) 
tanoun1: posts small blind €0.01
michoude: posts big blind €0.02
*** HOLE CARDS ***
Dealt to pipinoelbreve9 [Jc 6s]
sambupkr: folds 
pucelazo: folds 
PkBcN15: folds 
pipinoelbreve9: folds 
tanoun1: folds 
Uncalled bet (€0.01) returned to michoude
michoude collected €0.02 from pot
michoude: doesn't show hand 
*** SUMMARY ***
Total pot €0.02 | Rake €0 
Seat 1: pipinoelbreve9 (button) folded before Flop (didn't bet)
Seat 2: tanoun1 (small blind) folded before Flop
Seat 3: michoude (big blind) collected (€0.02)
Seat 4: sambupkr folded before Flop (didn't bet)
Seat 5: pucelazo folded before Flop (didn't bet)
Seat 6: PkBcN15 folded before Flop (didn't bet)



PokerStars Zoom Hand #257563491841:  Hold'em No Limit (€0.01/€0.02) - 2025/08/31 23:11:47 CET [2025/08/31 17:11:47 ET]
Table 'Arneb' 6-max Seat #1 is the button
Seat 1: sambupkr (€2.61 in chips) 
Seat 2: LuisGR90 (€2 in chips) 
Seat 3: lopo1187 (€2 in chips) 
Seat 4: RCSA2 (€2.80 in chips) 
Seat 5: trinityandme (€3.13 in chips) 
Seat 6: pipinoelbreve9 (€3.54 in chips) 
LuisGR90: posts small blind €0.01
lopo1187: posts big blind €0.02
*** HOLE CARDS ***
Dealt to pipinoelbreve9 [Jd 4d]
RCSA2: folds 
trinityandme: folds 
pipinoelbreve9: folds 
sambupkr: folds 
LuisGR90: raises €0.04 to €0.06
lopo1187: folds 
Uncalled bet (€0.04) returned to LuisGR90
LuisGR90 collected €0.04 from pot
LuisGR90: doesn't show hand 
*** SUMMARY ***
Total pot €0.04 | Rake €0 
Seat 1: sambupkr (button) folded before Flop (didn't bet)
Seat 2: LuisGR90 (small blind) collected (€0.04)
Seat 3: lopo1187 (big blind) folded before Flop
Seat 4: RCSA2 folded before Flop (didn't bet)
Seat 5: trinityandme folded before Flop (didn't bet)
Seat 6: pipinoelbreve9 folded before Flop (didn't bet)



PokerStars Zoom Hand #257563489448:  Hold'em No Limit (€0.01/€0.02) - 2025/08/31 23:11:39 CET [2025/08/31 17:11:39 ET]
Table 'Arneb' 6-max Seat #1 is the button
Seat 1: Xoco Cusco (€3.01 in chips) 
Seat 2: maximus_powah (€5.59 in chips) 
Seat 3: AnxoGM (€3.98 in chips) 
Seat 4: cinqneufzero (€1.34 in chips) 
Seat 5: Sportacus911 (€1.93 in chips) 
Seat 6: pipinoelbreve9 (€3.54 in chips) 
maximus_powah: posts small blind €0.01
AnxoGM: posts big blind €0.02
*** HOLE CARDS ***
Dealt to pipinoelbreve9 [6h Ks]
cinqneufzero: folds 
Sportacus911: folds 
pipinoelbreve9: folds 
Xoco Cusco: folds 
maximus_powah: raises €0.04 to €0.06
AnxoGM: calls €0.04
*** FLOP *** [2d 9h 8c]
maximus_powah: bets €0.04
AnxoGM: calls €0.04
*** TURN *** [2d 9h 8c] [4h]
maximus_powah: checks 
AnxoGM: bets €0.15
maximus_powah: calls €0.15
*** RIVER *** [2d 9h 8c 4h] [2c]
maximus_powah: checks 
AnxoGM: checks 
*** SHOW DOWN ***
maximus_powah: shows [9d Js] (two pair, Nines and Deuces)
AnxoGM: mucks hand 
maximus_powah collected €0.48 from pot
*** SUMMARY ***
Total pot €0.50 | Rake €0.02 
Board [2d 9h 8c 4h 2c]
Seat 1: Xoco Cusco (button) folded before Flop (didn't bet)
Seat 2: maximus_powah (small blind) showed [9d Js] and won (€0.48) with two pair, Nines and Deuces
Seat 3: AnxoGM (big blind) mucked [6c 9c]
Seat 4: cinqneufzero folded before Flop (didn't bet)
Seat 5: Sportacus911 folded before Flop (didn't bet)
Seat 6: pipinoelbreve9 folded before Flop (didn't bet)



PokerStars Zoom Hand #257563495345:  Hold'em No Limit (€0.01/€0.02) - 2025/08/31 23:11:59 CET [2025/08/31 17:11:59 ET]
Table 'Arneb' 6-max Seat #1 is the button
Seat 1: felgas1968 (€5.87 in chips) 
Seat 2: ehbraga (€0.60 in chips) 
Seat 3: tanoun1 (€2.30 in chips) 
Seat 4: Strlen83 (€2.23 in chips) 
Seat 5: pipinoelbreve9 (€3.54 in chips) 
Seat 6: correcamiños (€2 in chips) 
ehbraga: posts small blind €0.01
tanoun1: posts big blind €0.02
*** HOLE CARDS ***
Dealt to pipinoelbreve9 [9s 6c]
Strlen83: folds 
pipinoelbreve9: folds 
correcamiños: raises €0.04 to €0.06
felgas1968: folds 
ehbraga: calls €0.05
tanoun1: folds 
*** FLOP *** [4c Kd 6d]
ehbraga: bets €0.13
correcamiños: folds 
Uncalled bet (€0.13) returned to ehbraga
ehbraga collected €0.13 from pot
ehbraga: doesn't show hand 
*** SUMMARY ***
Total pot €0.14 | Rake €0.01 
Board [4c Kd 6d]
Seat 1: felgas1968 (button) folded before Flop (didn't bet)
Seat 2: ehbraga (small blind) collected (€0.13)
Seat 3: tanoun1 (big blind) folded before Flop
Seat 4: Strlen83 folded before Flop (didn't bet)
Seat 5: pipinoelbreve9 folded before Flop (didn't bet)
Seat 6: correcamiños folded on the Flop



PokerStars Zoom Hand #257563503199:  Hold'em No Limit (€0.01/€0.02) - 2025/08/31 23:12:25 CET [2025/08/31 17:12:25 ET]
Table 'Arneb' 6-max Seat #1 is the button
Seat 1: vinipats83 (€2.16 in chips) 
Seat 2: Romeo22901 (€1.57 in chips) 
Seat 3: pucelazo (€2 in chips) 
Seat 4: pipinoelbreve9 (€3.53 in chips) 
Seat 5: Grilo9 (€2 in chips) 
Seat 6: Mai SA135 (€1.65 in chips) 
Romeo22901: posts small blind €0.01
pucelazo: posts big blind €0.02
*** HOLE CARDS ***
Dealt to pipinoelbreve9 [7d 7s]
pipinoelbreve9: raises €0.04 to €0.06
Grilo9: folds 
Mai SA135: folds 
vinipats83: folds 
Romeo22901: folds 
pucelazo: folds 
Uncalled bet (€0.04) returned to pipinoelbreve9
pipinoelbreve9 collected €0.05 from pot
pipinoelbreve9: doesn't show hand 
*** SUMMARY ***
Total pot €0.05 | Rake €0 
Seat 1: vinipats83 (button) folded before Flop (didn't bet)
Seat 2: Romeo22901 (small blind) folded before Flop
Seat 3: pucelazo (big blind) folded before Flop
Seat 4: pipinoelbreve9 collected (€0.05)
Seat 5: Grilo9 folded before Flop (didn't bet)
Seat 6: Mai SA135 folded before Flop (didn't bet)



PokerStars Zoom Hand #257563499910:  Hold'em No Limit (€0.01/€0.02) - 2025/08/31 23:12:14 CET [2025/08/31 17:12:14 ET]
Table 'Arneb' 6-max Seat #1 is the button
Seat 1: RichyPozo (€2.65 in chips) 
Seat 2: pipinoelbreve9 (€3.54 in chips) 
Seat 3: Manuxanxe78 (€3.09 in chips) 
Seat 4: juanlu2000china (€2.34 in chips) 
Seat 5: wilbor123 (€2 in chips) 
Seat 6: Strlen83 (€2.02 in chips) 
pipinoelbreve9: posts small blind €0.01
Manuxanxe78: posts big blind €0.02
*** HOLE CARDS ***
Dealt to pipinoelbreve9 [9c 6c]
juanlu2000china: folds 
wilbor123: folds 
Strlen83: folds 
RichyPozo: raises €0.03 to €0.05
pipinoelbreve9: folds 
Manuxanxe78: folds 
Uncalled bet (€0.03) returned to RichyPozo
RichyPozo collected €0.05 from pot
RichyPozo: doesn't show hand 
*** SUMMARY ***
Total pot €0.05 | Rake €0 
Seat 1: RichyPozo (button) collected (€0.05)
Seat 2: pipinoelbreve9 (small blind) folded before Flop
Seat 3: Manuxanxe78 (big blind) folded before Flop
Seat 4: juanlu2000china folded before Flop (didn't bet)
Seat 5: wilbor123 folded before Flop (didn't bet)
Seat 6: Strlen83 folded before Flop (didn't bet)



PokerStars Zoom Hand #257563507394:  Hold'em No Limit (€0.01/€0.02) - 2025/08/31 23:12:39 CET [2025/08/31 17:12:39 ET]
Table 'Arneb' 6-max Seat #1 is the button
Seat 1: maximus_powah (€5.82 in chips) 
Seat 2: lopo1187 (€2.31 in chips) 
Seat 3: pipinoelbreve9 (€3.56 in chips) 
Seat 4: ehbraga (€0.67 in chips) 
Seat 5: tanoun1 (€6.41 in chips) 
Seat 6: vinipats83 (€2.16 in chips) 
lopo1187: posts small blind €0.01
pipinoelbreve9: posts big blind €0.02
*** HOLE CARDS ***
Dealt to pipinoelbreve9 [5s 6d]
ehbraga: calls €0.02
tanoun1: folds 
vinipats83: folds 
maximus_powah: raises €0.08 to €0.10
lopo1187: folds 
pipinoelbreve9: folds 
ehbraga: folds 
Uncalled bet (€0.08) returned to maximus_powah
maximus_powah collected €0.07 from pot
maximus_powah: doesn't show hand 
*** SUMMARY ***
Total pot €0.07 | Rake €0 
Seat 1: maximus_powah (button) collected (€0.07)
Seat 2: lopo1187 (small blind) folded before Flop
Seat 3: pipinoelbreve9 (big blind) folded before Flop
Seat 4: ehbraga folded before Flop
Seat 5: tanoun1 folded before Flop (didn't bet)
Seat 6: vinipats83 folded before Flop (didn't bet)



PokerStars Zoom Hand #257563510898:  Hold'em No Limit (€0.01/€0.02) - 2025/08/31 23:12:50 CET [2025/08/31 17:12:50 ET]
Table 'Arneb' 6-max Seat #1 is the button
Seat 1: maximus_powah (€2.87 in chips) 
Seat 2: simply_slike (€1.42 in chips) 
Seat 3: tanoun1 (€6.41 in chips) 
Seat 4: marcosbalsaa (€2 in chips) 
Seat 5: Xoco Cusco (€3.09 in chips) 
Seat 6: pipinoelbreve9 (€3.54 in chips) 
simply_slike: posts small blind €0.01
tanoun1: posts big blind €0.02
*** HOLE CARDS ***
Dealt to pipinoelbreve9 [Jd 3h]
marcosbalsaa: folds 
Xoco Cusco: raises €0.04 to €0.06
pipinoelbreve9: folds 
maximus_powah: folds 
simply_slike: calls €0.05
tanoun1: folds 
*** FLOP *** [6h 7c 8h]
simply_slike: checks 
Xoco Cusco: checks 
*** TURN *** [6h 7c 8h] [5h]
simply_slike: checks 
Xoco Cusco: checks 
*** RIVER *** [6h 7c 8h 5h] [Kd]
simply_slike: bets €0.02
Xoco Cusco: calls €0.02
*** SHOW DOWN ***
simply_slike: shows [Kc Qs] (a pair of Kings)
Xoco Cusco: mucks hand 
simply_slike collected €0.17 from pot
*** SUMMARY ***
Total pot €0.18 | Rake €0.01 
Board [6h 7c 8h 5h Kd]
Seat 1: maximus_powah (button) folded before Flop (didn't bet)
Seat 2: simply_slike (small blind) showed [Kc Qs] and won (€0.17) with a pair of Kings
Seat 3: tanoun1 (big blind) folded before Flop
Seat 4: marcosbalsaa folded before Flop (didn't bet)
Seat 5: Xoco Cusco mucked [Tc Ac]
Seat 6: pipinoelbreve9 folded before Flop (didn't bet)



PokerStars Zoom Hand #257563513614:  Hold'em No Limit (€0.01/€0.02) - 2025/08/31 23:12:59 CET [2025/08/31 17:12:59 ET]
Table 'Arneb' 6-max Seat #1 is the button
Seat 1: pipinoelbreve9 (€3.53 in chips) 
Seat 2: sambupkr (€2.51 in chips) 
Seat 3: Fulcrumm (€0.96 in chips) 
Seat 4: correcamiños (€2.61 in chips) 
Seat 5: felgas1968 (€2.33 in chips) 
Seat 6: tanoun1 (€6.93 in chips) 
sambupkr: posts small blind €0.01
Fulcrumm: posts big blind €0.02
*** HOLE CARDS ***
Dealt to pipinoelbreve9 [8c 8d]
correcamiños: folds 
felgas1968: folds 
tanoun1: folds 
pipinoelbreve9: raises €0.04 to €0.06
sambupkr: folds 
Fulcrumm: calls €0.04
*** FLOP *** [9s Td 9c]
Fulcrumm: checks 
pipinoelbreve9: checks 
*** TURN *** [9s Td 9c] [7h]
Fulcrumm: checks 
pipinoelbreve9: bets €0.06
Fulcrumm: folds 
Uncalled bet (€0.06) returned to pipinoelbreve9
pipinoelbreve9 collected €0.12 from pot
pipinoelbreve9: doesn't show hand 
*** SUMMARY ***
Total pot €0.13 | Rake €0.01 
Board [9s Td 9c 7h]
Seat 1: pipinoelbreve9 (button) collected (€0.12)
Seat 2: sambupkr (small blind) folded before Flop
Seat 3: Fulcrumm (big blind) folded on the Turn
Seat 4: correcamiños folded before Flop (didn't bet)
Seat 5: felgas1968 folded before Flop (didn't bet)
Seat 6: tanoun1 folded before Flop (didn't bet)



PokerStars Zoom Hand #257563523517:  Hold'em No Limit (€0.01/€0.02) - 2025/08/31 23:13:32 CET [2025/08/31 17:13:32 ET]
Table 'Arneb' 6-max Seat #1 is the button
Seat 1: ehbraga (€0.62 in chips) 
Seat 2: Sportacus911 (€1.38 in chips) 
Seat 3: vinipats83 (€2.19 in chips) 
Seat 4: XXXJAVIXXX14 (€2.67 in chips) 
Seat 5: pipinoelbreve9 (€3.59 in chips) 
Seat 6: claret505 (€1.13 in chips) 
Sportacus911: posts small blind €0.01
vinipats83: posts big blind €0.02
*** HOLE CARDS ***
Dealt to pipinoelbreve9 [3c 5s]
XXXJAVIXXX14: raises €0.02 to €0.04
pipinoelbreve9: folds 
claret505: folds 
ehbraga: folds 
Sportacus911: calls €0.03
vinipats83: folds 
*** FLOP *** [Kc 6d 9c]
Sportacus911: checks 
XXXJAVIXXX14: bets €0.02
Sportacus911: calls €0.02
*** TURN *** [Kc 6d 9c] [2h]
Sportacus911: checks 
XXXJAVIXXX14: bets €0.13
Sportacus911: calls €0.13
*** RIVER *** [Kc 6d 9c 2h] [9d]
Sportacus911: checks 
XXXJAVIXXX14: bets €0.38
Sportacus911: folds 
Uncalled bet (€0.38) returned to XXXJAVIXXX14
XXXJAVIXXX14 collected €0.38 from pot
XXXJAVIXXX14: doesn't show hand 
*** SUMMARY ***
Total pot €0.40 | Rake €0.02 
Board [Kc 6d 9c 2h 9d]
Seat 1: ehbraga (button) folded before Flop (didn't bet)
Seat 2: Sportacus911 (small blind) folded on the River
Seat 3: vinipats83 (big blind) folded before Flop
Seat 4: XXXJAVIXXX14 collected (€0.38)
Seat 5: pipinoelbreve9 folded before Flop (didn't bet)
Seat 6: claret505 folded before Flop (didn't bet)



PokerStars Zoom Hand #257563524594:  Hold'em No Limit (€0.01/€0.02) - 2025/08/31 23:13:35 CET [2025/08/31 17:13:35 ET]
Table 'Arneb' 6-max Seat #1 is the button
Seat 1: elseneka-1 (€8.85 in chips) 
Seat 2: sambupkr (€3.37 in chips) 
Seat 3: claret505 (€1.13 in chips) 
Seat 4: pipinoelbreve9 (€3.59 in chips) 
Seat 5: pingu_771 (€2.90 in chips) 
Seat 6: AnxoGM (€2 in chips) 
sambupkr: posts small blind €0.01
claret505: posts big blind €0.02
*** HOLE CARDS ***
Dealt to pipinoelbreve9 [Kh 5c]
pipinoelbreve9: folds 
pingu_771: folds 
AnxoGM: folds 
elseneka-1: calls €0.02
sambupkr: folds 
claret505: checks 
*** FLOP *** [Ah 2c Kc]
claret505: bets €0.02
elseneka-1: calls €0.02
*** TURN *** [Ah 2c Kc] [Tc]
claret505: bets €0.02
elseneka-1: calls €0.02
*** RIVER *** [Ah 2c Kc Tc] [8s]
claret505: bets €0.02
elseneka-1: calls €0.02
*** SHOW DOWN ***
claret505: shows [5s Ad] (a pair of Aces)
elseneka-1: shows [Kd Ts] (two pair, Kings and Tens)
elseneka-1 collected €0.16 from pot
*** SUMMARY ***
Total pot €0.17 | Rake €0.01 
Board [Ah 2c Kc Tc 8s]
Seat 1: elseneka-1 (button) showed [Kd Ts] and won (€0.16) with two pair, Kings and Tens
Seat 2: sambupkr (small blind) folded before Flop
Seat 3: claret505 (big blind) showed [5s Ad] and lost with a pair of Aces
Seat 4: pipinoelbreve9 folded before Flop (didn't bet)
Seat 5: pingu_771 folded before Flop (didn't bet)
Seat 6: AnxoGM folded before Flop (didn't bet)



PokerStars Zoom Hand #257563512294:  Hold'em No Limit (€0.01/€0.02) - 2025/08/31 23:12:55 CET [2025/08/31 17:12:55 ET]
Table 'Arneb' 6-max Seat #1 is the button
Seat 1: forinal (€1.35 in chips) 
Seat 2: pipinoelbreve9 (€3.54 in chips) 
Seat 3: LuisGR90 (€2.08 in chips) 
Seat 4: Fulcrumm (€0.96 in chips) 
Seat 5: pucelazo (€2 in chips) 
Seat 6: Manuxanxe78 (€3.06 in chips) 
pipinoelbreve9: posts small blind €0.01
LuisGR90: posts big blind €0.02
*** HOLE CARDS ***
Dealt to pipinoelbreve9 [6c 4h]
Fulcrumm: folds 
pucelazo: folds 
Manuxanxe78: raises €0.03 to €0.05
forinal: calls €0.05
pipinoelbreve9: folds 
LuisGR90: calls €0.03
*** FLOP *** [8h 5h 9h]
LuisGR90: checks 
Manuxanxe78: checks 
forinal: checks 
*** TURN *** [8h 5h 9h] [Js]
LuisGR90: checks 
Manuxanxe78: bets €0.15
forinal: folds 
LuisGR90: calls €0.15
*** RIVER *** [8h 5h 9h Js] [4d]
LuisGR90: checks 
Manuxanxe78: bets €2.86 and is all-in
LuisGR90: folds 
Uncalled bet (€2.86) returned to Manuxanxe78
Manuxanxe78 collected €0.44 from pot
Manuxanxe78: doesn't show hand 
*** SUMMARY ***
Total pot €0.46 | Rake €0.02 
Board [8h 5h 9h Js 4d]
Seat 1: forinal (button) folded on the Turn
Seat 2: pipinoelbreve9 (small blind) folded before Flop
Seat 3: LuisGR90 (big blind) folded on the River
Seat 4: Fulcrumm folded before Flop (didn't bet)
Seat 5: pucelazo folded before Flop (didn't bet)
Seat 6: Manuxanxe78 collected (€0.44)



PokerStars Zoom Hand #257563526352:  Hold'em No Limit (€0.01/€0.02) - 2025/08/31 23:13:41 CET [2025/08/31 17:13:41 ET]
Table 'Arneb' 6-max Seat #1 is the button
Seat 1: PkBcN15 (€2.09 in chips) 
Seat 2: winie66 (€3.33 in chips) 
Seat 3: pipinoelbreve9 (€3.59 in chips) 
Seat 4: kurikutela53 (€0.95 in chips) 
Seat 5: marcosbalsaa (€2.53 in chips) 
Seat 6: lopo1187 (€2.28 in chips) 
winie66: posts small blind €0.01
pipinoelbreve9: posts big blind €0.02
*** HOLE CARDS ***
Dealt to pipinoelbreve9 [Jd Ts]
kurikutela53 has timed out
kurikutela53: folds 
marcosbalsaa: folds 
lopo1187: folds 
PkBcN15: folds 
winie66: calls €0.01
pipinoelbreve9: raises €0.04 to €0.06
winie66: calls €0.04
*** FLOP *** [3s 3h 3c]
winie66: checks 
pipinoelbreve9: checks 
*** TURN *** [3s 3h 3c] [6d]
winie66: checks 
pipinoelbreve9: checks 
*** RIVER *** [3s 3h 3c 6d] [As]
winie66: checks 
pipinoelbreve9: checks 
*** SHOW DOWN ***
winie66: shows [Ah Jc] (a full house, Threes full of Aces)
pipinoelbreve9: mucks hand 
winie66 collected €0.11 from pot
*** SUMMARY ***
Total pot €0.12 | Rake €0.01 
Board [3s 3h 3c 6d As]
Seat 1: PkBcN15 (button) folded before Flop (didn't bet)
Seat 2: winie66 (small blind) showed [Ah Jc] and won (€0.11) with a full house, Threes full of Aces
Seat 3: pipinoelbreve9 (big blind) mucked [Jd Ts]
Seat 4: kurikutela53 folded before Flop (didn't bet)
Seat 5: marcosbalsaa folded before Flop (didn't bet)
Seat 6: lopo1187 folded before Flop (didn't bet)



PokerStars Zoom Hand #257563545925:  Hold'em No Limit (€0.01/€0.02) - 2025/08/31 23:14:46 CET [2025/08/31 17:14:46 ET]
Table 'Arneb' 6-max Seat #1 is the button
Seat 1: sambupkr (€3.33 in chips) 
Seat 2: NotClaudio1 (€3.59 in chips) 
Seat 3: PkBcN15 (€2 in chips) 
Seat 4: pipinoelbreve9 (€3.53 in chips) 
Seat 5: forinal (€1.22 in chips) 
Seat 6: lopo1187 (€2.28 in chips) 
NotClaudio1: posts small blind €0.01
PkBcN15: posts big blind €0.02
*** HOLE CARDS ***
Dealt to pipinoelbreve9 [4h 8h]
pipinoelbreve9: folds 
forinal: folds 
lopo1187: folds 
sambupkr: folds 
NotClaudio1: raises €0.05 to €0.07
PkBcN15: folds 
Uncalled bet (€0.05) returned to NotClaudio1
NotClaudio1 collected €0.04 from pot
NotClaudio1: doesn't show hand 
*** SUMMARY ***
Total pot €0.04 | Rake €0 
Seat 1: sambupkr (button) folded before Flop (didn't bet)
Seat 2: NotClaudio1 (small blind) collected (€0.04)
Seat 3: PkBcN15 (big blind) folded before Flop
Seat 4: pipinoelbreve9 folded before Flop (didn't bet)
Seat 5: forinal folded before Flop (didn't bet)
Seat 6: lopo1187 folded before Flop (didn't bet)



PokerStars Zoom Hand #257563544326:  Hold'em No Limit (€0.01/€0.02) - 2025/08/31 23:14:41 CET [2025/08/31 17:14:41 ET]
Table 'Arneb' 6-max Seat #1 is the button
Seat 1: ZoasHein (€2.18 in chips) 
Seat 2: RichyPozo (€2 in chips) 
Seat 3: maximus_powah (€5.87 in chips) 
Seat 4: vinipats83 (€2.16 in chips) 
Seat 5: pipinoelbreve9 (€3.53 in chips) 
Seat 6: 34pluto (€1.37 in chips) 
RichyPozo: posts small blind €0.01
maximus_powah: posts big blind €0.02
*** HOLE CARDS ***
Dealt to pipinoelbreve9 [6c 4s]
vinipats83: folds 
pipinoelbreve9: folds 
34pluto has timed out
34pluto: folds 
ZoasHein: raises €0.04 to €0.06
RichyPozo: folds 
maximus_powah: folds 
Uncalled bet (€0.04) returned to ZoasHein
ZoasHein collected €0.05 from pot
ZoasHein: doesn't show hand 
*** SUMMARY ***
Total pot €0.05 | Rake €0 
Seat 1: ZoasHein (button) collected (€0.05)
Seat 2: RichyPozo (small blind) folded before Flop
Seat 3: maximus_powah (big blind) folded before Flop
Seat 4: vinipats83 folded before Flop (didn't bet)
Seat 5: pipinoelbreve9 folded before Flop (didn't bet)
Seat 6: 34pluto folded before Flop (didn't bet)



PokerStars Zoom Hand #257563551606:  Hold'em No Limit (€0.01/€0.02) - 2025/08/31 23:15:04 CET [2025/08/31 17:15:04 ET]
Table 'Arneb' 6-max Seat #1 is the button
Seat 1: lilpapayaa (€0.52 in chips) 
Seat 2: minisusy (€2.02 in chips) 
Seat 3: pipinoelbreve9 (€3.52 in chips) 
Seat 4: eneko83 (€3.16 in chips) 
Seat 5: LuisGR90 (€2 in chips) 
Seat 6: ZoasHein (€2.21 in chips) 
minisusy: posts small blind €0.01
pipinoelbreve9: posts big blind €0.02
*** HOLE CARDS ***
Dealt to pipinoelbreve9 [Kh As]
eneko83: folds 
LuisGR90: folds 
ZoasHein: folds 
lilpapayaa: raises €0.50 to €0.52 and is all-in
minisusy: folds 
pipinoelbreve9: calls €0.50
*** FLOP *** [Th 2c 4d]
*** TURN *** [Th 2c 4d] [Jh]
*** RIVER *** [Th 2c 4d Jh] [9c]
*** SHOW DOWN ***
pipinoelbreve9: shows [Kh As] (high card Ace)
lilpapayaa: shows [Ks Ah] (high card Ace)
pipinoelbreve9 collected €0.50 from pot
lilpapayaa collected €0.50 from pot
*** SUMMARY ***
Total pot €1.05 | Rake €0.05 
Board [Th 2c 4d Jh 9c]
Seat 1: lilpapayaa (button) showed [Ks Ah] and won (€0.50) with high card Ace
Seat 2: minisusy (small blind) folded before Flop
Seat 3: pipinoelbreve9 (big blind) showed [Kh As] and won (€0.50) with high card Ace
Seat 4: eneko83 folded before Flop (didn't bet)
Seat 5: LuisGR90 folded before Flop (didn't bet)
Seat 6: ZoasHein folded before Flop (didn't bet)



PokerStars Zoom Hand #257563550217:  Hold'em No Limit (€0.01/€0.02) - 2025/08/31 23:15:00 CET [2025/08/31 17:15:00 ET]
Table 'Arneb' 6-max Seat #1 is the button
Seat 1: pipinoelbreve9 (€3.52 in chips) 
Seat 2: 34pluto (€2.01 in chips) 
Seat 3: seriomarkos (€1.93 in chips) 
Seat 4: sambupkr (€2.61 in chips) 
Seat 5: PkBcN15 (€2 in chips) 
Seat 6: Manuxanxe78 (€2.20 in chips) 
34pluto: posts small blind €0.01
seriomarkos: posts big blind €0.02
*** HOLE CARDS ***
Dealt to pipinoelbreve9 [Tc 7c]
sambupkr: folds 
PkBcN15: folds 
Manuxanxe78: folds 
pipinoelbreve9: folds 
34pluto: raises €0.02 to €0.04
seriomarkos: calls €0.02
*** FLOP *** [Ad Kh 3d]
34pluto: checks 
seriomarkos: checks 
*** TURN *** [Ad Kh 3d] [3h]
34pluto: checks 
seriomarkos: checks 
*** RIVER *** [Ad Kh 3d 3h] [6d]
34pluto: checks 
seriomarkos: checks 
*** SHOW DOWN ***
34pluto: shows [4c 4d] (two pair, Fours and Threes)
seriomarkos: mucks hand 
34pluto collected €0.08 from pot
*** SUMMARY ***
Total pot €0.08 | Rake €0 
Board [Ad Kh 3d 3h 6d]
Seat 1: pipinoelbreve9 (button) folded before Flop (didn't bet)
Seat 2: 34pluto (small blind) showed [4c 4d] and won (€0.08) with two pair, Fours and Threes
Seat 3: seriomarkos (big blind) mucked [Qs 5s]
Seat 4: sambupkr folded before Flop (didn't bet)
Seat 5: PkBcN15 folded before Flop (didn't bet)
Seat 6: Manuxanxe78 folded before Flop (didn't bet)



PokerStars Zoom Hand #257563548305:  Hold'em No Limit (€0.01/€0.02) - 2025/08/31 23:14:54 CET [2025/08/31 17:14:54 ET]
Table 'Arneb' 6-max Seat #1 is the button
Seat 1: wilbor123 (€1.91 in chips) 
Seat 2: pipinoelbreve9 (€3.53 in chips) 
Seat 3: pucelazo (€2 in chips) 
Seat 4: tanoun1 (€6.92 in chips) 
Seat 5: claret505 (€1.09 in chips) 
Seat 6: correcamiños (€2.32 in chips) 
pipinoelbreve9: posts small blind €0.01
pucelazo: posts big blind €0.02
*** HOLE CARDS ***
Dealt to pipinoelbreve9 [9s 8d]
tanoun1: folds 
claret505: calls €0.02
correcamiños: folds 
wilbor123: folds 
pipinoelbreve9: folds 
pucelazo: checks 
*** FLOP *** [7s 5h Ah]
pucelazo: checks 
claret505: checks 
*** TURN *** [7s 5h Ah] [3d]
pucelazo: checks 
claret505: checks 
*** RIVER *** [7s 5h Ah 3d] [9d]
pucelazo: checks 
claret505: checks 
*** SHOW DOWN ***
pucelazo: shows [4s 5d] (a pair of Fives)
claret505: mucks hand 
pucelazo collected €0.05 from pot
*** SUMMARY ***
Total pot €0.05 | Rake €0 
Board [7s 5h Ah 3d 9d]
Seat 1: wilbor123 (button) folded before Flop (didn't bet)
Seat 2: pipinoelbreve9 (small blind) folded before Flop
Seat 3: pucelazo (big blind) showed [4s 5d] and won (€0.05) with a pair of Fives
Seat 4: tanoun1 folded before Flop (didn't bet)
Seat 5: claret505 mucked [Qh Tc]
Seat 6: correcamiños folded before Flop (didn't bet)



PokerStars Zoom Hand #257563563352:  Hold'em No Limit (€0.01/€0.02) - 2025/08/31 23:15:43 CET [2025/08/31 17:15:43 ET]
Table 'Arneb' 6-max Seat #1 is the button
Seat 1: correcamiños (€3.63 in chips) 
Seat 2: pipinoelbreve9 (€3.50 in chips) 
Seat 3: Fulcrumm (€0.95 in chips) 
Seat 4: michoude (€1.59 in chips) 
Seat 5: ehbraga (€0.78 in chips) 
Seat 6: sambupkr (€2.60 in chips) 
pipinoelbreve9: posts small blind €0.01
Fulcrumm: posts big blind €0.02
*** HOLE CARDS ***
Dealt to pipinoelbreve9 [8s 9s]
michoude: folds 
ehbraga: folds 
sambupkr: folds 
correcamiños: folds 
pipinoelbreve9: raises €0.04 to €0.06
Fulcrumm: folds 
Uncalled bet (€0.04) returned to pipinoelbreve9
pipinoelbreve9 collected €0.04 from pot
pipinoelbreve9: doesn't show hand 
*** SUMMARY ***
Total pot €0.04 | Rake €0 
Seat 1: correcamiños (button) folded before Flop (didn't bet)
Seat 2: pipinoelbreve9 (small blind) collected (€0.04)
Seat 3: Fulcrumm (big blind) folded before Flop
Seat 4: michoude folded before Flop (didn't bet)
Seat 5: ehbraga folded before Flop (didn't bet)
Seat 6: sambupkr folded before Flop (didn't bet)



PokerStars Zoom Hand #257563569516:  Hold'em No Limit (€0.01/€0.02) - 2025/08/31 23:16:03 CET [2025/08/31 17:16:03 ET]
Table 'Arneb' 6-max Seat #1 is the button
Seat 1: lopo1187 (€2 in chips) 
Seat 2: MakesMeRich (€3.02 in chips) 
Seat 3: Calamusemoi (€2.54 in chips) 
Seat 4: Mai SA135 (€1.63 in chips) 
Seat 5: pipinoelbreve9 (€3.52 in chips) 
Seat 6: trinityandme (€1.60 in chips) 
MakesMeRich: posts small blind €0.01
Calamusemoi: posts big blind €0.02
*** HOLE CARDS ***
Dealt to pipinoelbreve9 [8h 9s]
Mai SA135: folds 
pipinoelbreve9: folds 
trinityandme: folds 
lopo1187: folds 
MakesMeRich: raises €0.03 to €0.05
Calamusemoi: folds 
Uncalled bet (€0.03) returned to MakesMeRich
MakesMeRich collected €0.04 from pot
MakesMeRich: doesn't show hand 
*** SUMMARY ***
Total pot €0.04 | Rake €0 
Seat 1: lopo1187 (button) folded before Flop (didn't bet)
Seat 2: MakesMeRich (small blind) collected (€0.04)
Seat 3: Calamusemoi (big blind) folded before Flop
Seat 4: Mai SA135 folded before Flop (didn't bet)
Seat 5: pipinoelbreve9 folded before Flop (didn't bet)
Seat 6: trinityandme folded before Flop (didn't bet)



PokerStars Zoom Hand #257563562372:  Hold'em No Limit (€0.01/€0.02) - 2025/08/31 23:15:39 CET [2025/08/31 17:15:39 ET]
Table 'Arneb' 6-max Seat #1 is the button
Seat 1: Romeo22901 (€1.67 in chips) 
Seat 2: 34pluto (€1.91 in chips) 
Seat 3: wilbor123 (€1.94 in chips) 
Seat 4: minisusy (€2.01 in chips) 
Seat 5: winie66 (€3.20 in chips) 
Seat 6: pipinoelbreve9 (€3.50 in chips) 
34pluto: posts small blind €0.01
wilbor123: posts big blind €0.02
*** HOLE CARDS ***
Dealt to pipinoelbreve9 [Jd 4h]
minisusy: folds 
winie66: calls €0.02
pipinoelbreve9: folds 
Romeo22901: folds 
34pluto: folds 
wilbor123: checks 
*** FLOP *** [9h 3h 9s]
wilbor123: checks 
winie66: checks 
*** TURN *** [9h 3h 9s] [2s]
wilbor123: checks 
winie66: checks 
*** RIVER *** [9h 3h 9s 2s] [Kh]
wilbor123: checks 
winie66: checks 
*** SHOW DOWN ***
wilbor123: shows [6c Tc] (a pair of Nines)
winie66: shows [Ad 3s] (two pair, Nines and Threes)
winie66 collected €0.05 from pot
*** SUMMARY ***
Total pot €0.05 | Rake €0 
Board [9h 3h 9s 2s Kh]
Seat 1: Romeo22901 (button) folded before Flop (didn't bet)
Seat 2: 34pluto (small blind) folded before Flop
Seat 3: wilbor123 (big blind) showed [6c Tc] and lost with a pair of Nines
Seat 4: minisusy folded before Flop (didn't bet)
Seat 5: winie66 showed [Ad 3s] and won (€0.05) with two pair, Nines and Threes
Seat 6: pipinoelbreve9 folded before Flop (didn't bet)



PokerStars Zoom Hand #257563558597:  Hold'em No Limit (€0.01/€0.02) - 2025/08/31 23:15:27 CET [2025/08/31 17:15:27 ET]
Table 'Arneb' 6-max Seat #1 is the button
Seat 1: Manuxanxe78 (€3.23 in chips) 
Seat 2: dimag444 (€2.01 in chips) 
Seat 3: tanoun1 (€6.36 in chips) 
Seat 4: maximus_powah (€5.84 in chips) 
Seat 5: ratomi (€0.59 in chips) 
Seat 6: pipinoelbreve9 (€3.50 in chips) 
dimag444: posts small blind €0.01
tanoun1: posts big blind €0.02
*** HOLE CARDS ***
Dealt to pipinoelbreve9 [8h Qd]
maximus_powah: folds 
ratomi: folds 
pipinoelbreve9: folds 
Manuxanxe78: raises €0.04 to €0.06
dimag444: raises €0.12 to €0.18
tanoun1: folds 
Manuxanxe78: raises €0.23 to €0.41
dimag444: folds 
Uncalled bet (€0.23) returned to Manuxanxe78
Manuxanxe78 collected €0.38 from pot
Manuxanxe78: doesn't show hand 
*** SUMMARY ***
Total pot €0.38 | Rake €0 
Seat 1: Manuxanxe78 (button) collected (€0.38)
Seat 2: dimag444 (small blind) folded before Flop
Seat 3: tanoun1 (big blind) folded before Flop
Seat 4: maximus_powah folded before Flop (didn't bet)
Seat 5: ratomi folded before Flop (didn't bet)
Seat 6: pipinoelbreve9 folded before Flop (didn't bet)



PokerStars Zoom Hand #257563571199:  Hold'em No Limit (€0.01/€0.02) - 2025/08/31 23:16:08 CET [2025/08/31 17:16:08 ET]
Table 'Arneb' 6-max Seat #1 is the button
Seat 1: AnxoGM (€2.83 in chips) 
Seat 2: sambupkr (€3.31 in chips) 
Seat 3: Bestiote (€0.94 in chips) 
Seat 4: tanoun1 (€6.34 in chips) 
Seat 5: pipinoelbreve9 (€3.52 in chips) 
Seat 6: Xoseanro510 (€2.61 in chips) 
sambupkr: posts small blind €0.01
Bestiote: posts big blind €0.02
*** HOLE CARDS ***
Dealt to pipinoelbreve9 [2s 7d]
tanoun1: folds 
pipinoelbreve9: folds 
Xoseanro510: raises €0.04 to €0.06
AnxoGM: folds 
sambupkr: raises €0.12 to €0.18
Bestiote: folds 
Xoseanro510: folds 
Uncalled bet (€0.12) returned to sambupkr
sambupkr collected €0.14 from pot
sambupkr: doesn't show hand 
*** SUMMARY ***
Total pot €0.14 | Rake €0 
Seat 1: AnxoGM (button) folded before Flop (didn't bet)
Seat 2: sambupkr (small blind) collected (€0.14)
Seat 3: Bestiote (big blind) folded before Flop
Seat 4: tanoun1 folded before Flop (didn't bet)
Seat 5: pipinoelbreve9 folded before Flop (didn't bet)
Seat 6: Xoseanro510 folded before Flop



PokerStars Zoom Hand #257563575551:  Hold'em No Limit (€0.01/€0.02) - 2025/08/31 23:16:23 CET [2025/08/31 17:16:23 ET]
Table 'Arneb' 6-max Seat #1 is the button
Seat 1: tanoun1 (€2.74 in chips) 
Seat 2: PkBcN15 (€2.01 in chips) 
Seat 3: pipinoelbreve9 (€3.52 in chips) 
Seat 4: LuisGR90 (€2 in chips) 
Seat 5: marcosbalsaa (€2.82 in chips) 
Seat 6: lilpapayaa (€0.45 in chips) 
PkBcN15: posts small blind €0.01
pipinoelbreve9: posts big blind €0.02
*** HOLE CARDS ***
Dealt to pipinoelbreve9 [As 9d]
LuisGR90: folds 
marcosbalsaa: folds 
lilpapayaa: folds 
tanoun1: raises €0.02 to €0.04
PkBcN15: folds 
pipinoelbreve9: calls €0.02
*** FLOP *** [4d 4h 3s]
pipinoelbreve9: checks 
tanoun1: checks 
*** TURN *** [4d 4h 3s] [Jc]
pipinoelbreve9: checks 
tanoun1: checks 
*** RIVER *** [4d 4h 3s Jc] [5s]
pipinoelbreve9: checks 
tanoun1: checks 
*** SHOW DOWN ***
pipinoelbreve9: shows [As 9d] (a pair of Fours)
tanoun1: mucks hand 
pipinoelbreve9 collected €0.09 from pot
*** SUMMARY ***
Total pot €0.09 | Rake €0 
Board [4d 4h 3s Jc 5s]
Seat 1: tanoun1 (button) mucked [Qd Th]
Seat 2: PkBcN15 (small blind) folded before Flop
Seat 3: pipinoelbreve9 (big blind) showed [As 9d] and won (€0.09) with a pair of Fours
Seat 4: LuisGR90 folded before Flop (didn't bet)
Seat 5: marcosbalsaa folded before Flop (didn't bet)
Seat 6: lilpapayaa folded before Flop (didn't bet)



PokerStars Zoom Hand #257563574370:  Hold'em No Limit (€0.01/€0.02) - 2025/08/31 23:16:19 CET [2025/08/31 17:16:19 ET]
Table 'Arneb' 6-max Seat #1 is the button
Seat 1: pipinoelbreve9 (€3.52 in chips) 
Seat 2: Calamusemoi (€2.52 in chips) 
Seat 3: Romeo22901 (€1.70 in chips) 
Seat 4: tanoun1 (€2.74 in chips) 
Seat 5: MakesMeRich (€3.04 in chips) 
Seat 6: NotClaudio1 (€2.47 in chips) 
Calamusemoi: posts small blind €0.01
Romeo22901: posts big blind €0.02
*** HOLE CARDS ***
Dealt to pipinoelbreve9 [8d Kh]
tanoun1: folds 
MakesMeRich: folds 
NotClaudio1: folds 
pipinoelbreve9: folds 
Calamusemoi: raises €0.02 to €0.04
Romeo22901: calls €0.02
*** FLOP *** [7d Ah 4c]
Calamusemoi: checks 
Romeo22901: checks 
*** TURN *** [7d Ah 4c] [Ad]
Calamusemoi: bets €0.04
Romeo22901: calls €0.04
*** RIVER *** [7d Ah 4c Ad] [Kd]
Calamusemoi: checks 
Romeo22901: bets €1.62 and is all-in
Calamusemoi: folds 
Uncalled bet (€1.62) returned to Romeo22901
Romeo22901 collected €0.15 from pot
Romeo22901: doesn't show hand 
*** SUMMARY ***
Total pot €0.16 | Rake €0.01 
Board [7d Ah 4c Ad Kd]
Seat 1: pipinoelbreve9 (button) folded before Flop (didn't bet)
Seat 2: Calamusemoi (small blind) folded on the River
Seat 3: Romeo22901 (big blind) collected (€0.15)
Seat 4: tanoun1 folded before Flop (didn't bet)
Seat 5: MakesMeRich folded before Flop (didn't bet)
Seat 6: NotClaudio1 folded before Flop (didn't bet)



PokerStars Zoom Hand #257563584722:  Hold'em No Limit (€0.01/€0.02) - 2025/08/31 23:16:53 CET [2025/08/31 17:16:53 ET]
Table 'Arneb' 6-max Seat #1 is the button
Seat 1: QuerlyHiHi (€2.47 in chips) 
Seat 2: pipinoelbreve9 (€3.57 in chips) 
Seat 3: michoude (€1.56 in chips) 
Seat 4: tanoun1 (€2.70 in chips) 
Seat 5: Manuxanxe78 (€2 in chips) 
Seat 6: charlie67100 (€1.12 in chips) 
pipinoelbreve9: posts small blind €0.01
michoude: posts big blind €0.02
*** HOLE CARDS ***
Dealt to pipinoelbreve9 [Ad 9d]
tanoun1: folds 
Manuxanxe78: folds 
charlie67100: folds 
QuerlyHiHi: raises €0.03 to €0.05
pipinoelbreve9: calls €0.04
michoude: calls €0.03
*** FLOP *** [7c 9c 9s]
pipinoelbreve9: checks 
michoude: checks 
QuerlyHiHi: checks 
*** TURN *** [7c 9c 9s] [As]
pipinoelbreve9: bets €0.04
michoude: calls €0.04
QuerlyHiHi: folds 
*** RIVER *** [7c 9c 9s As] [5s]
pipinoelbreve9: bets €0.22
michoude: calls €0.22
*** SHOW DOWN ***
pipinoelbreve9: shows [Ad 9d] (a full house, Nines full of Aces)
michoude: mucks hand 
pipinoelbreve9 collected €0.64 from pot
*** SUMMARY ***
Total pot €0.67 | Rake €0.03 
Board [7c 9c 9s As 5s]
Seat 1: QuerlyHiHi (button) folded on the Turn
Seat 2: pipinoelbreve9 (small blind) showed [Ad 9d] and won (€0.64) with a full house, Nines full of Aces
Seat 3: michoude (big blind) mucked [Ac 5c]
Seat 4: tanoun1 folded before Flop (didn't bet)
Seat 5: Manuxanxe78 folded before Flop (didn't bet)
Seat 6: charlie67100 folded before Flop (didn't bet)



PokerStars Zoom Hand #257563601217:  Hold'em No Limit (€0.01/€0.02) - 2025/08/31 23:17:48 CET [2025/08/31 17:17:48 ET]
Table 'Arneb' 6-max Seat #1 is the button
Seat 1: Xoco Cusco (€2.93 in chips) 
Seat 2: michoude (€1.25 in chips) 
Seat 3: trinityandme (€1.57 in chips) 
Seat 4: pipinoelbreve9 (€3.90 in chips) 
Seat 5: NotClaudio1 (€1.97 in chips) 
Seat 6: 28chan28 (€2.05 in chips) 
michoude: posts small blind €0.01
trinityandme: posts big blind €0.02
*** HOLE CARDS ***
Dealt to pipinoelbreve9 [Ah Js]
pipinoelbreve9 has timed out
pipinoelbreve9: folds 
NotClaudio1: folds 
28chan28: raises €0.02 to €0.04
Xoco Cusco: calls €0.04
michoude: folds 
trinityandme: folds 
*** FLOP *** [6d 4c 9s]
28chan28: checks 
Xoco Cusco: bets €0.07
28chan28: calls €0.07
*** TURN *** [6d 4c 9s] [2c]
28chan28: checks 
Xoco Cusco: checks 
*** RIVER *** [6d 4c 9s 2c] [6c]
28chan28: bets €0.20
Xoco Cusco: raises €0.20 to €0.40
28chan28: raises €1.54 to €1.94 and is all-in
Xoco Cusco: folds 
Uncalled bet (€1.54) returned to 28chan28
28chan28 collected €1 from pot
28chan28: doesn't show hand 
*** SUMMARY ***
Total pot €1.05 | Rake €0.05 
Board [6d 4c 9s 2c 6c]
Seat 1: Xoco Cusco (button) folded on the River
Seat 2: michoude (small blind) folded before Flop
Seat 3: trinityandme (big blind) folded before Flop
Seat 4: pipinoelbreve9 folded before Flop (didn't bet)
Seat 5: NotClaudio1 folded before Flop (didn't bet)
Seat 6: 28chan28 collected (€1)



PokerStars Zoom Hand #257563605557:  Hold'em No Limit (€0.01/€0.02) - 2025/08/31 23:18:02 CET [2025/08/31 17:18:02 ET]
Table 'Arneb' 6-max Seat #1 is the button
Seat 1: MakesMeRich (€3.02 in chips) 
Seat 2: felgas1968 (€5.96 in chips) 
Seat 3: pipinoelbreve9 (€3.90 in chips) 
Seat 4: sambupkr (€4.43 in chips) 
Seat 5: Strlen83 (€2.22 in chips) 
Seat 6: correcamiños (€2 in chips) 
felgas1968: posts small blind €0.01
pipinoelbreve9: posts big blind €0.02
*** HOLE CARDS ***
Dealt to pipinoelbreve9 [2s As]
sambupkr has timed out
sambupkr: folds 
Strlen83: raises €0.04 to €0.06
correcamiños: folds 
MakesMeRich: folds 
felgas1968: folds 
pipinoelbreve9: calls €0.04
*** FLOP *** [2h 3s 7s]
pipinoelbreve9: checks 
Strlen83: bets €0.06
pipinoelbreve9: calls €0.06
*** TURN *** [2h 3s 7s] [9d]
pipinoelbreve9: checks 
Strlen83: bets €0.22
pipinoelbreve9: calls €0.22
*** RIVER *** [2h 3s 7s 9d] [8h]
pipinoelbreve9: checks 
Strlen83: bets €0.58
pipinoelbreve9: folds 
Uncalled bet (€0.58) returned to Strlen83
Strlen83 collected €0.66 from pot
Strlen83: doesn't show hand 
*** SUMMARY ***
Total pot €0.69 | Rake €0.03 
Board [2h 3s 7s 9d 8h]
Seat 1: MakesMeRich (button) folded before Flop (didn't bet)
Seat 2: felgas1968 (small blind) folded before Flop
Seat 3: pipinoelbreve9 (big blind) folded on the River
Seat 4: sambupkr folded before Flop (didn't bet)
Seat 5: Strlen83 collected (€0.66)
Seat 6: correcamiños folded before Flop (didn't bet)



PokerStars Zoom Hand #257563628129:  Hold'em No Limit (€0.01/€0.02) - 2025/08/31 23:19:18 CET [2025/08/31 17:19:18 ET]
Table 'Arneb' 6-max Seat #1 is the button
Seat 1: trinityandme (€1.52 in chips) 
Seat 2: RCSA2 (€2.90 in chips) 
Seat 3: correcamiños (€2.97 in chips) 
Seat 4: tanoun1 (€7.28 in chips) 
Seat 5: Grilo9 (€2.06 in chips) 
Seat 6: pipinoelbreve9 (€3.56 in chips) 
RCSA2: posts small blind €0.01
correcamiños: posts big blind €0.02
*** HOLE CARDS ***
Dealt to pipinoelbreve9 [3h 8h]
tanoun1: folds 
Grilo9: folds 
pipinoelbreve9: folds 
trinityandme: folds 
RCSA2: folds 
Uncalled bet (€0.01) returned to correcamiños
correcamiños collected €0.02 from pot
correcamiños: doesn't show hand 
*** SUMMARY ***
Total pot €0.02 | Rake €0 
Seat 1: trinityandme (button) folded before Flop (didn't bet)
Seat 2: RCSA2 (small blind) folded before Flop
Seat 3: correcamiños (big blind) collected (€0.02)
Seat 4: tanoun1 folded before Flop (didn't bet)
Seat 5: Grilo9 folded before Flop (didn't bet)
Seat 6: pipinoelbreve9 folded before Flop (didn't bet)



PokerStars Zoom Hand #257563629473:  Hold'em No Limit (€0.01/€0.02) - 2025/08/31 23:19:22 CET [2025/08/31 17:19:22 ET]
Table 'Arneb' 6-max Seat #1 is the button
Seat 1: pipinoelbreve9 (€3.56 in chips) 
Seat 2: juanlu2000china (€2.55 in chips) 
Seat 3: LuisGR90 (€2 in chips) 
Seat 4: PkBcN15 (€2.01 in chips) 
Seat 5: ehbraga (€0.76 in chips) 
Seat 6: charlie67100 (€1.04 in chips) 
juanlu2000china: posts small blind €0.01
LuisGR90: posts big blind €0.02
*** HOLE CARDS ***
Dealt to pipinoelbreve9 [Tc Th]
PkBcN15: folds 
ehbraga: raises €0.74 to €0.76 and is all-in
charlie67100: folds 
pipinoelbreve9: raises €2.80 to €3.56 and is all-in
juanlu2000china: folds 
LuisGR90: folds 
Uncalled bet (€2.80) returned to pipinoelbreve9
*** FLOP *** [7d 7c 2s]
*** TURN *** [7d 7c 2s] [6d]
*** RIVER *** [7d 7c 2s 6d] [3c]
*** SHOW DOWN ***
ehbraga: shows [Ah Kh] (a pair of Sevens)
pipinoelbreve9: shows [Tc Th] (two pair, Tens and Sevens)
pipinoelbreve9 collected €1.47 from pot
*** SUMMARY ***
Total pot €1.55 | Rake €0.08 
Board [7d 7c 2s 6d 3c]
Seat 1: pipinoelbreve9 (button) showed [Tc Th] and won (€1.47) with two pair, Tens and Sevens
Seat 2: juanlu2000china (small blind) folded before Flop
Seat 3: LuisGR90 (big blind) folded before Flop
Seat 4: PkBcN15 folded before Flop (didn't bet)
Seat 5: ehbraga showed [Ah Kh] and lost with a pair of Sevens
Seat 6: charlie67100 folded before Flop (didn't bet)



PokerStars Zoom Hand #257563641492:  Hold'em No Limit (€0.01/€0.02) - 2025/08/31 23:20:02 CET [2025/08/31 17:20:02 ET]
Table 'Arneb' 6-max Seat #1 is the button
Seat 1: Xoseanro510 (€2.02 in chips) 
Seat 2: pipinoelbreve9 (€4.27 in chips) 
Seat 3: Lauranve (€1.34 in chips) 
Seat 4: tanoun1 (€3.79 in chips) 
Seat 5: Bestiote (€0.73 in chips) 
Seat 6: raptureman1 (€2.66 in chips) 
pipinoelbreve9: posts small blind €0.01
Lauranve: posts big blind €0.02
*** HOLE CARDS ***
Dealt to pipinoelbreve9 [2h 9h]
tanoun1: folds 
Bestiote: raises €0.02 to €0.04
raptureman1: folds 
Xoseanro510: folds 
pipinoelbreve9: folds 
Lauranve: folds 
Uncalled bet (€0.02) returned to Bestiote
Bestiote collected €0.05 from pot
Bestiote: doesn't show hand 
*** SUMMARY ***
Total pot €0.05 | Rake €0 
Seat 1: Xoseanro510 (button) folded before Flop (didn't bet)
Seat 2: pipinoelbreve9 (small blind) folded before Flop
Seat 3: Lauranve (big blind) folded before Flop
Seat 4: tanoun1 folded before Flop (didn't bet)
Seat 5: Bestiote collected (€0.05)
Seat 6: raptureman1 folded before Flop (didn't bet)



PokerStars Zoom Hand #257563638343:  Hold'em No Limit (€0.01/€0.02) - 2025/08/31 23:19:52 CET [2025/08/31 17:19:52 ET]
Table 'Arneb' 6-max Seat #1 is the button
Seat 1: Manuxanxe78 (€2.10 in chips) 
Seat 2: Jah2U (€0.87 in chips) 
Seat 3: PkBcN15 (€2 in chips) 
Seat 4: dimag444 (€2 in chips) 
Seat 5: pipinoelbreve9 (€4.27 in chips) 
Seat 6: Bestiote (€0.73 in chips) 
Jah2U: posts small blind €0.01
PkBcN15: posts big blind €0.02
*** HOLE CARDS ***
Dealt to pipinoelbreve9 [3c 6s]
dimag444: folds 
pipinoelbreve9: folds 
Bestiote: folds 
Manuxanxe78: folds 
Jah2U: calls €0.01
PkBcN15: checks 
*** FLOP *** [6d 6h 2h]
Jah2U: checks 
PkBcN15: checks 
*** TURN *** [6d 6h 2h] [Ts]
Jah2U: bets €0.04
PkBcN15: folds 
Uncalled bet (€0.04) returned to Jah2U
Jah2U collected €0.04 from pot
Jah2U: doesn't show hand 
*** SUMMARY ***
Total pot €0.04 | Rake €0 
Board [6d 6h 2h Ts]
Seat 1: Manuxanxe78 (button) folded before Flop (didn't bet)
Seat 2: Jah2U (small blind) collected (€0.04)
Seat 3: PkBcN15 (big blind) folded on the Turn
Seat 4: dimag444 folded before Flop (didn't bet)
Seat 5: pipinoelbreve9 folded before Flop (didn't bet)
Seat 6: Bestiote folded before Flop (didn't bet)



PokerStars Zoom Hand #257563644759:  Hold'em No Limit (€0.01/€0.02) - 2025/08/31 23:20:13 CET [2025/08/31 17:20:13 ET]
Table 'Arneb' 6-max Seat #1 is the button
Seat 1: Strlen83 (€2.54 in chips) 
Seat 2: AnxoGM (€2.67 in chips) 
Seat 3: pipinoelbreve9 (€4.26 in chips) 
Seat 4: LuisGR90 (€2 in chips) 
Seat 5: nometoquesloshu (€1.01 in chips) 
Seat 6: minisusy (€1.84 in chips) 
AnxoGM: posts small blind €0.01
pipinoelbreve9: posts big blind €0.02
*** HOLE CARDS ***
Dealt to pipinoelbreve9 [Qd Ks]
LuisGR90: folds 
nometoquesloshu: folds 
minisusy: folds 
Strlen83: folds 
AnxoGM: raises €0.04 to €0.06
pipinoelbreve9: raises €0.12 to €0.18
AnxoGM: folds 
Uncalled bet (€0.12) returned to pipinoelbreve9
pipinoelbreve9 collected €0.12 from pot
pipinoelbreve9: doesn't show hand 
*** SUMMARY ***
Total pot €0.12 | Rake €0 
Seat 1: Strlen83 (button) folded before Flop (didn't bet)
Seat 2: AnxoGM (small blind) folded before Flop
Seat 3: pipinoelbreve9 (big blind) collected (€0.12)
Seat 4: LuisGR90 folded before Flop (didn't bet)
Seat 5: nometoquesloshu folded before Flop (didn't bet)
Seat 6: minisusy folded before Flop (didn't bet)



PokerStars Zoom Hand #257563643229:  Hold'em No Limit (€0.01/€0.02) - 2025/08/31 23:20:08 CET [2025/08/31 17:20:08 ET]
Table 'Arneb' 6-max Seat #1 is the button
Seat 1: GleQbenny (€1.71 in chips) 
Seat 2: raptureman1 (€2.66 in chips) 
Seat 3: XXXJAVIXXX14 (€2.88 in chips) 
Seat 4: pipinoelbreve9 (€4.26 in chips) 
Seat 5: sambupkr (€2.48 in chips) 
Seat 6: pucelazo (€2.21 in chips) 
raptureman1: posts small blind €0.01
XXXJAVIXXX14: posts big blind €0.02
*** HOLE CARDS ***
Dealt to pipinoelbreve9 [Td 4h]
pipinoelbreve9: folds 
sambupkr: folds 
pucelazo: raises €0.04 to €0.06
GleQbenny: folds 
raptureman1: folds 
XXXJAVIXXX14: calls €0.04
*** FLOP *** [As Th 3h]
XXXJAVIXXX14: checks 
pucelazo: checks 
*** TURN *** [As Th 3h] [Ts]
XXXJAVIXXX14: bets €0.02
pucelazo: folds 
Uncalled bet (€0.02) returned to XXXJAVIXXX14
XXXJAVIXXX14 collected €0.12 from pot
XXXJAVIXXX14: doesn't show hand 
*** SUMMARY ***
Total pot €0.13 | Rake €0.01 
Board [As Th 3h Ts]
Seat 1: GleQbenny (button) folded before Flop (didn't bet)
Seat 2: raptureman1 (small blind) folded before Flop
Seat 3: XXXJAVIXXX14 (big blind) collected (€0.12)
Seat 4: pipinoelbreve9 folded before Flop (didn't bet)
Seat 5: sambupkr folded before Flop (didn't bet)
Seat 6: pucelazo folded on the Turn



PokerStars Zoom Hand #257563640034:  Hold'em No Limit (€0.01/€0.02) - 2025/08/31 23:19:57 CET [2025/08/31 17:19:57 ET]
Table 'Arneb' 6-max Seat #1 is the button
Seat 1: pipinoelbreve9 (€4.27 in chips) 
Seat 2: sambupkr (€2.49 in chips) 
Seat 3: Manuxanxe78 (€2.10 in chips) 
Seat 4: RCSA2 (€2.89 in chips) 
Seat 5: raptureman1 (€2.66 in chips) 
Seat 6: mariaantunes20 (€2.79 in chips) 
sambupkr: posts small blind €0.01
Manuxanxe78: posts big blind €0.02
*** HOLE CARDS ***
Dealt to pipinoelbreve9 [4c 2c]
RCSA2: calls €0.02
raptureman1: folds 
mariaantunes20: folds 
pipinoelbreve9: folds 
sambupkr: folds 
Manuxanxe78: checks 
*** FLOP *** [Qh Kc 2d]
Manuxanxe78: checks 
RCSA2: checks 
*** TURN *** [Qh Kc 2d] [2s]
Manuxanxe78: checks 
RCSA2: checks 
*** RIVER *** [Qh Kc 2d 2s] [Qs]
Manuxanxe78: checks 
RCSA2: checks 
*** SHOW DOWN ***
Manuxanxe78: shows [6c 3h] (two pair, Queens and Deuces)
RCSA2: shows [3s Js] (two pair, Queens and Deuces)
Manuxanxe78 collected €0.03 from pot
RCSA2 collected €0.02 from pot
*** SUMMARY ***
Total pot €0.05 | Rake €0 
Board [Qh Kc 2d 2s Qs]
Seat 1: pipinoelbreve9 (button) folded before Flop (didn't bet)
Seat 2: sambupkr (small blind) folded before Flop
Seat 3: Manuxanxe78 (big blind) showed [6c 3h] and won (€0.03) with two pair, Queens and Deuces
Seat 4: RCSA2 showed [3s Js] and won (€0.02) with two pair, Queens and Deuces
Seat 5: raptureman1 folded before Flop (didn't bet)
Seat 6: mariaantunes20 folded before Flop (didn't bet)



PokerStars Zoom Hand #257563655682:  Hold'em No Limit (€0.01/€0.02) - 2025/08/31 23:20:50 CET [2025/08/31 17:20:50 ET]
Table 'Arneb' 6-max Seat #1 is the button
Seat 1: aliner34j (€1.73 in chips) 
Seat 2: lilpapayaa (€0.51 in chips) 
Seat 3: LuisGR90 (€2 in chips) 
Seat 4: ZoasHein (€4.72 in chips) 
Seat 5: Xoco Cusco (€2.55 in chips) 
Seat 6: pipinoelbreve9 (€4.32 in chips) 
lilpapayaa: posts small blind €0.01
LuisGR90: posts big blind €0.02
*** HOLE CARDS ***
Dealt to pipinoelbreve9 [9s Jd]
ZoasHein: raises €0.04 to €0.06
Xoco Cusco: calls €0.06
pipinoelbreve9: folds 
aliner34j: folds 
lilpapayaa: folds 
LuisGR90: folds 
*** FLOP *** [7h 8s 9d]
ZoasHein: bets €0.07
Xoco Cusco: folds 
Uncalled bet (€0.07) returned to ZoasHein
ZoasHein collected €0.14 from pot
ZoasHein: doesn't show hand 
*** SUMMARY ***
Total pot €0.15 | Rake €0.01 
Board [7h 8s 9d]
Seat 1: aliner34j (button) folded before Flop (didn't bet)
Seat 2: lilpapayaa (small blind) folded before Flop
Seat 3: LuisGR90 (big blind) folded before Flop
Seat 4: ZoasHein collected (€0.14)
Seat 5: Xoco Cusco folded on the Flop
Seat 6: pipinoelbreve9 folded before Flop (didn't bet)



PokerStars Zoom Hand #257563657004:  Hold'em No Limit (€0.01/€0.02) - 2025/08/31 23:20:54 CET [2025/08/31 17:20:54 ET]
Table 'Arneb' 6-max Seat #1 is the button
Seat 1: Strlen83 (€2.53 in chips) 
Seat 2: ratomi (€1.04 in chips) 
Seat 3: ecuinas (€0.50 in chips) 
Seat 4: pipinoelbreve9 (€4.32 in chips) 
Seat 5: sambupkr (€2.05 in chips) 
Seat 6: elpinkysharky (€1.85 in chips) 
ratomi: posts small blind €0.01
ecuinas: posts big blind €0.02
*** HOLE CARDS ***
Dealt to pipinoelbreve9 [6c 7d]
pipinoelbreve9: folds 
sambupkr: folds 
elpinkysharky: folds 
Strlen83: folds 
ratomi: calls €0.01
ecuinas: checks 
*** FLOP *** [Kh 7c Ks]
ratomi: checks 
ecuinas: checks 
*** TURN *** [Kh 7c Ks] [Kd]
ratomi: checks 
ecuinas: checks 
*** RIVER *** [Kh 7c Ks Kd] [2d]
ratomi: checks 
ecuinas: checks 
*** SHOW DOWN ***
ratomi: shows [Qc 5c] (three of a kind, Kings)
ecuinas: mucks hand 
ratomi collected €0.04 from pot
*** SUMMARY ***
Total pot €0.04 | Rake €0 
Board [Kh 7c Ks Kd 2d]
Seat 1: Strlen83 (button) folded before Flop (didn't bet)
Seat 2: ratomi (small blind) showed [Qc 5c] and won (€0.04) with three of a kind, Kings
Seat 3: ecuinas (big blind) mucked [Th Jd]
Seat 4: pipinoelbreve9 folded before Flop (didn't bet)
Seat 5: sambupkr folded before Flop (didn't bet)
Seat 6: elpinkysharky folded before Flop (didn't bet)



PokerStars Zoom Hand #257563652212:  Hold'em No Limit (€0.01/€0.02) - 2025/08/31 23:20:38 CET [2025/08/31 17:20:38 ET]
Table 'Arneb' 6-max Seat #1 is the button
Seat 1: LuisGR90 (€2 in chips) 
Seat 2: 666poker455 (€1.98 in chips) 
Seat 3: ehbraga (€1 in chips) 
Seat 4: Xoseanro510 (€2.71 in chips) 
Seat 5: GleQbenny (€1.69 in chips) 
Seat 6: pipinoelbreve9 (€4.32 in chips) 
666poker455: posts small blind €0.01
ehbraga: posts big blind €0.02
*** HOLE CARDS ***
Dealt to pipinoelbreve9 [3s Qs]
Xoseanro510: folds 
GleQbenny: calls €0.02
pipinoelbreve9: folds 
LuisGR90: folds 
666poker455: calls €0.01
ehbraga: checks 
*** FLOP *** [Js 7s 4s]
666poker455: checks 
ehbraga: checks 
GleQbenny: checks 
*** TURN *** [Js 7s 4s] [Jh]
666poker455: checks 
ehbraga: checks 
GleQbenny: checks 
*** RIVER *** [Js 7s 4s Jh] [5c]
666poker455: checks 
ehbraga: checks 
GleQbenny: checks 
*** SHOW DOWN ***
666poker455: shows [4h Th] (two pair, Jacks and Fours)
ehbraga: mucks hand 
GleQbenny: mucks hand 
666poker455 collected €0.06 from pot
*** SUMMARY ***
Total pot €0.06 | Rake €0 
Board [Js 7s 4s Jh 5c]
Seat 1: LuisGR90 (button) folded before Flop (didn't bet)
Seat 2: 666poker455 (small blind) showed [4h Th] and won (€0.06) with two pair, Jacks and Fours
Seat 3: ehbraga (big blind) mucked [2c 2d]
Seat 4: Xoseanro510 folded before Flop (didn't bet)
Seat 5: GleQbenny mucked [Qd Kh]
Seat 6: pipinoelbreve9 folded before Flop (didn't bet)



PokerStars Zoom Hand #257563659422:  Hold'em No Limit (€0.01/€0.02) - 2025/08/31 23:21:02 CET [2025/08/31 17:21:02 ET]
Table 'Arneb' 6-max Seat #1 is the button
Seat 1: Romeo22901 (€1.56 in chips) 
Seat 2: pipinoelbreve9 (€4.32 in chips) 
Seat 3: sambupkr (€2.50 in chips) 
Seat 4: Sportacus911 (€2.65 in chips) 
Seat 5: Grokuyu (€2.07 in chips) 
Seat 6: lilpapayaa (€0.50 in chips) 
pipinoelbreve9: posts small blind €0.01
sambupkr: posts big blind €0.02
*** HOLE CARDS ***
Dealt to pipinoelbreve9 [2c 2s]
Sportacus911: folds 
Grokuyu: folds 
lilpapayaa: raises €0.02 to €0.04
Romeo22901: calls €0.04
pipinoelbreve9: calls €0.03
sambupkr: folds 
*** FLOP *** [4s 6c Ah]
pipinoelbreve9: checks 
lilpapayaa: checks 
Romeo22901: checks 
*** TURN *** [4s 6c Ah] [7s]
pipinoelbreve9: checks 
lilpapayaa: bets €0.04
Romeo22901: folds 
pipinoelbreve9: folds 
Uncalled bet (€0.04) returned to lilpapayaa
lilpapayaa collected €0.13 from pot
lilpapayaa: doesn't show hand 
*** SUMMARY ***
Total pot €0.14 | Rake €0.01 
Board [4s 6c Ah 7s]
Seat 1: Romeo22901 (button) folded on the Turn
Seat 2: pipinoelbreve9 (small blind) folded on the Turn
Seat 3: sambupkr (big blind) folded before Flop
Seat 4: Sportacus911 folded before Flop (didn't bet)
Seat 5: Grokuyu folded before Flop (didn't bet)
Seat 6: lilpapayaa collected (€0.13)



PokerStars Zoom Hand #257563672306:  Hold'em No Limit (€0.01/€0.02) - 2025/08/31 23:21:45 CET [2025/08/31 17:21:45 ET]
Table 'Arneb' 6-max Seat #1 is the button
Seat 1: Manuxanxe78 (€3.10 in chips) 
Seat 2: AnxoGM (€2.70 in chips) 
Seat 3: tijolon (€2.35 in chips) 
Seat 4: vinipats83 (€2.28 in chips) 
Seat 5: pipinoelbreve9 (€4.28 in chips) 
Seat 6: marcosbalsaa (€1.39 in chips) 
AnxoGM: posts small blind €0.01
tijolon: posts big blind €0.02
*** HOLE CARDS ***
Dealt to pipinoelbreve9 [6c 7d]
vinipats83: folds 
pipinoelbreve9: folds 
marcosbalsaa: folds 
Manuxanxe78: folds 
AnxoGM: folds 
Uncalled bet (€0.01) returned to tijolon
tijolon collected €0.02 from pot
tijolon: doesn't show hand 
*** SUMMARY ***
Total pot €0.02 | Rake €0 
Seat 1: Manuxanxe78 (button) folded before Flop (didn't bet)
Seat 2: AnxoGM (small blind) folded before Flop
Seat 3: tijolon (big blind) collected (€0.02)
Seat 4: vinipats83 folded before Flop (didn't bet)
Seat 5: pipinoelbreve9 folded before Flop (didn't bet)
Seat 6: marcosbalsaa folded before Flop (didn't bet)



PokerStars Zoom Hand #257563679851:  Hold'em No Limit (€0.01/€0.02) - 2025/08/31 23:22:10 CET [2025/08/31 17:22:10 ET]
Table 'Arneb' 6-max Seat #1 is the button
Seat 1: Bestiote (€0.63 in chips) 
Seat 2: pipinoelbreve9 (€4.26 in chips) 
Seat 3: LuisGR90 (€2.34 in chips) 
Seat 4: MakesMeRich (€2 in chips) 
Seat 5: tijolon (€2 in chips) 
Seat 6: tanoun1 (€7.09 in chips) 
pipinoelbreve9: posts small blind €0.01
LuisGR90: posts big blind €0.02
*** HOLE CARDS ***
Dealt to pipinoelbreve9 [4s 3h]
MakesMeRich: raises €0.02 to €0.04
tijolon: folds 
tanoun1: folds 
Bestiote: folds 
pipinoelbreve9: folds 
LuisGR90: calls €0.02
*** FLOP *** [Ah Jd 8c]
LuisGR90: checks 
MakesMeRich: bets €0.03
LuisGR90: folds 
Uncalled bet (€0.03) returned to MakesMeRich
MakesMeRich collected €0.09 from pot
MakesMeRich: doesn't show hand 
*** SUMMARY ***
Total pot €0.09 | Rake €0 
Board [Ah Jd 8c]
Seat 1: Bestiote (button) folded before Flop (didn't bet)
Seat 2: pipinoelbreve9 (small blind) folded before Flop
Seat 3: LuisGR90 (big blind) folded on the Flop
Seat 4: MakesMeRich collected (€0.09)
Seat 5: tijolon folded before Flop (didn't bet)
Seat 6: tanoun1 folded before Flop (didn't bet)



PokerStars Zoom Hand #257563676232:  Hold'em No Limit (€0.01/€0.02) - 2025/08/31 23:21:58 CET [2025/08/31 17:21:58 ET]
Table 'Arneb' 6-max Seat #1 is the button
Seat 1: tanoun1 (€6.10 in chips) 
Seat 2: Romeo22901 (€1.53 in chips) 
Seat 3: pipinoelbreve9 (€4.28 in chips) 
Seat 4: felgas1968 (€5.69 in chips) 
Seat 5: QuerlyHiHi (€2.10 in chips) 
Seat 6: correcamiños (€2.91 in chips) 
Romeo22901: posts small blind €0.01
pipinoelbreve9: posts big blind €0.02
*** HOLE CARDS ***
Dealt to pipinoelbreve9 [Js 2c]
felgas1968: raises €0.02 to €0.04
QuerlyHiHi: calls €0.04
correcamiños: calls €0.04
tanoun1: folds 
Romeo22901: calls €0.03
pipinoelbreve9: folds 
*** FLOP *** [6d 5c Ks]
Romeo22901: checks 
felgas1968: checks 
QuerlyHiHi: checks 
correcamiños: checks 
*** TURN *** [6d 5c Ks] [Kd]
Romeo22901: checks 
felgas1968: checks 
QuerlyHiHi: checks 
correcamiños: bets €0.13
Romeo22901: folds 
felgas1968: folds 
QuerlyHiHi: folds 
Uncalled bet (€0.13) returned to correcamiños
correcamiños collected €0.17 from pot
correcamiños: doesn't show hand 
*** SUMMARY ***
Total pot €0.18 | Rake €0.01 
Board [6d 5c Ks Kd]
Seat 1: tanoun1 (button) folded before Flop (didn't bet)
Seat 2: Romeo22901 (small blind) folded on the Turn
Seat 3: pipinoelbreve9 (big blind) folded before Flop
Seat 4: felgas1968 folded on the Turn
Seat 5: QuerlyHiHi folded on the Turn
Seat 6: correcamiños collected (€0.17)



PokerStars Zoom Hand #257563674297:  Hold'em No Limit (€0.01/€0.02) - 2025/08/31 23:21:52 CET [2025/08/31 17:21:52 ET]
Table 'Arneb' 6-max Seat #1 is the button
Seat 1: PavoN_PT (€2 in chips) 
Seat 2: jvilela007 (€2.54 in chips) 
Seat 3: vinipats83 (€2.28 in chips) 
Seat 4: pipinoelbreve9 (€4.28 in chips) 
Seat 5: PkBcN15 (€2 in chips) 
Seat 6: Fulcrumm (€0.47 in chips) 
jvilela007: posts small blind €0.01
vinipats83: posts big blind €0.02
*** HOLE CARDS ***
Dealt to pipinoelbreve9 [3c 2s]
pipinoelbreve9: folds 
PkBcN15: calls €0.02
Fulcrumm: calls €0.02
PavoN_PT: calls €0.02
jvilela007: calls €0.01
vinipats83: checks 
*** FLOP *** [6s 3h Qc]
jvilela007: checks 
vinipats83: checks 
PkBcN15: checks 
Fulcrumm: checks 
PavoN_PT: checks 
*** TURN *** [6s 3h Qc] [5h]
jvilela007: checks 
vinipats83: checks 
PkBcN15: checks 
Fulcrumm: checks 
PavoN_PT: checks 
*** RIVER *** [6s 3h Qc 5h] [5d]
jvilela007: checks 
vinipats83: checks 
PkBcN15: checks 
Fulcrumm: checks 
PavoN_PT: checks 
*** SHOW DOWN ***
jvilela007: shows [Kc Jh] (a pair of Fives)
vinipats83: shows [3s Ah] (two pair, Fives and Threes)
PkBcN15: shows [6h 7h] (two pair, Sixes and Fives)
Fulcrumm: mucks hand 
PavoN_PT: mucks hand 
PkBcN15 collected €0.10 from pot
*** SUMMARY ***
Total pot €0.10 | Rake €0 
Board [6s 3h Qc 5h 5d]
Seat 1: PavoN_PT (button) mucked [4d 4s]
Seat 2: jvilela007 (small blind) showed [Kc Jh] and lost with a pair of Fives
Seat 3: vinipats83 (big blind) showed [3s Ah] and lost with two pair, Fives and Threes
Seat 4: pipinoelbreve9 folded before Flop (didn't bet)
Seat 5: PkBcN15 showed [6h 7h] and won (€0.10) with two pair, Sixes and Fives
Seat 6: Fulcrumm mucked [9d 8c]



PokerStars Zoom Hand #257563682430:  Hold'em No Limit (€0.01/€0.02) - 2025/08/31 23:22:19 CET [2025/08/31 17:22:19 ET]
Table 'Arneb' 6-max Seat #1 is the button
Seat 1: pipinoelbreve9 (€4.25 in chips) 
Seat 2: aliner34j (€1.81 in chips) 
Seat 3: charlie67100 (€1.13 in chips) 
Seat 4: 28chan28 (€2.54 in chips) 
Seat 5: minisusy (€1.80 in chips) 
Seat 6: ehbraga (€1 in chips) 
aliner34j: posts small blind €0.01
charlie67100: posts big blind €0.02
*** HOLE CARDS ***
Dealt to pipinoelbreve9 [Kh 6s]
28chan28: raises €0.02 to €0.04
minisusy: folds 
ehbraga: folds 
pipinoelbreve9: folds 
aliner34j: raises €0.06 to €0.10
charlie67100: folds 
28chan28: raises €2.44 to €2.54 and is all-in
aliner34j: calls €1.71 and is all-in
Uncalled bet (€0.73) returned to 28chan28
*** FLOP *** [Tc Ks 9d]
*** TURN *** [Tc Ks 9d] [7h]
*** RIVER *** [Tc Ks 9d 7h] [Ts]
*** SHOW DOWN ***
aliner34j: shows [Qd Ah] (a pair of Tens)
28chan28: shows [Qc Qh] (two pair, Queens and Tens)
28chan28 collected €3.46 from pot
*** SUMMARY ***
Total pot €3.64 | Rake €0.18 
Board [Tc Ks 9d 7h Ts]
Seat 1: pipinoelbreve9 (button) folded before Flop (didn't bet)
Seat 2: aliner34j (small blind) showed [Qd Ah] and lost with a pair of Tens
Seat 3: charlie67100 (big blind) folded before Flop
Seat 4: 28chan28 showed [Qc Qh] and won (€3.46) with two pair, Queens and Tens
Seat 5: minisusy folded before Flop (didn't bet)
Seat 6: ehbraga folded before Flop (didn't bet)



PokerStars Zoom Hand #257563685145:  Hold'em No Limit (€0.01/€0.02) - 2025/08/31 23:22:28 CET [2025/08/31 17:22:28 ET]
Table 'Arneb' 6-max Seat #1 is the button
Seat 1: pipinoelbreve9 (€4.25 in chips) 
Seat 2: Xoseanro510 (€2.75 in chips) 
Seat 3: tanoun1 (€7.09 in chips) 
Seat 4: tijolon (€2 in chips) 
Seat 5: poteaarte (€2.08 in chips) 
Seat 6: Grilo9 (€2 in chips) 
Xoseanro510: posts small blind €0.01
tanoun1: posts big blind €0.02
*** HOLE CARDS ***
Dealt to pipinoelbreve9 [8d Ad]
tijolon: raises €0.04 to €0.06
poteaarte: folds 
Grilo9: folds 
pipinoelbreve9: calls €0.06
Xoseanro510: folds 
tanoun1: raises €0.18 to €0.24
tijolon: calls €0.18
pipinoelbreve9: folds 
*** FLOP *** [Ts 5s 7c]
tanoun1: bets €0.52
tijolon: folds 
Uncalled bet (€0.52) returned to tanoun1
tanoun1 collected €0.52 from pot
tanoun1: doesn't show hand 
*** SUMMARY ***
Total pot €0.55 | Rake €0.03 
Board [Ts 5s 7c]
Seat 1: pipinoelbreve9 (button) folded before Flop
Seat 2: Xoseanro510 (small blind) folded before Flop
Seat 3: tanoun1 (big blind) collected (€0.52)
Seat 4: tijolon folded on the Flop
Seat 5: poteaarte folded before Flop (didn't bet)
Seat 6: Grilo9 folded before Flop (didn't bet)



PokerStars Zoom Hand #257563690619:  Hold'em No Limit (€0.01/€0.02) - 2025/08/31 23:22:47 CET [2025/08/31 17:22:47 ET]
Table 'Arneb' 6-max Seat #1 is the button
Seat 1: ZoasHein (€4.43 in chips) 
Seat 2: sambupkr (€3.11 in chips) 
Seat 3: LuisGR90 (€2.16 in chips) 
Seat 4: italiano125 (€1.56 in chips) 
Seat 5: pipinoelbreve9 (€4.19 in chips) 
Seat 6: lopo1187 (€2.19 in chips) 
sambupkr: posts small blind €0.01
LuisGR90: posts big blind €0.02
*** HOLE CARDS ***
Dealt to pipinoelbreve9 [8d 2s]
italiano125: folds 
pipinoelbreve9: folds 
lopo1187: folds 
ZoasHein: folds 
sambupkr: raises €0.04 to €0.06
LuisGR90: folds 
Uncalled bet (€0.04) returned to sambupkr
sambupkr collected €0.04 from pot
sambupkr: doesn't show hand 
*** SUMMARY ***
Total pot €0.04 | Rake €0 
Seat 1: ZoasHein (button) folded before Flop (didn't bet)
Seat 2: sambupkr (small blind) collected (€0.04)
Seat 3: LuisGR90 (big blind) folded before Flop
Seat 4: italiano125 folded before Flop (didn't bet)
Seat 5: pipinoelbreve9 folded before Flop (didn't bet)
Seat 6: lopo1187 folded before Flop (didn't bet)



PokerStars Zoom Hand #257563689324:  Hold'em No Limit (€0.01/€0.02) - 2025/08/31 23:22:42 CET [2025/08/31 17:22:42 ET]
Table 'Arneb' 6-max Seat #1 is the button
Seat 1: tanoun1 (€3.58 in chips) 
Seat 2: Manuxanxe78 (€2.04 in chips) 
Seat 3: correcamiños (€2.06 in chips) 
Seat 4: GleQbenny (€2.02 in chips) 
Seat 5: ZoasHein (€4.43 in chips) 
Seat 6: pipinoelbreve9 (€4.19 in chips) 
Manuxanxe78: posts small blind €0.01
correcamiños: posts big blind €0.02
*** HOLE CARDS ***
Dealt to pipinoelbreve9 [6s 8h]
GleQbenny is disconnected 
GleQbenny has timed out while disconnected
GleQbenny: folds 
ZoasHein: folds 
pipinoelbreve9: folds 
tanoun1: folds 
Manuxanxe78: folds 
Uncalled bet (€0.01) returned to correcamiños
correcamiños collected €0.02 from pot
correcamiños: doesn't show hand 
*** SUMMARY ***
Total pot €0.02 | Rake €0 
Seat 1: tanoun1 (button) folded before Flop (didn't bet)
Seat 2: Manuxanxe78 (small blind) folded before Flop
Seat 3: correcamiños (big blind) collected (€0.02)
Seat 4: GleQbenny folded before Flop (didn't bet)
Seat 5: ZoasHein folded before Flop (didn't bet)
Seat 6: pipinoelbreve9 folded before Flop (didn't bet)



PokerStars Zoom Hand #257563692441:  Hold'em No Limit (€0.01/€0.02) - 2025/08/31 23:22:53 CET [2025/08/31 17:22:53 ET]
Table 'Arneb' 6-max Seat #1 is the button
Seat 1: PkBcN15 (€2.07 in chips) 
Seat 2: lopo1187 (€2.19 in chips) 
Seat 3: pipinoelbreve9 (€4.19 in chips) 
Seat 4: PavoN_PT (€2 in chips) 
Seat 5: ehbraga (€0.94 in chips) 
Seat 6: ZoasHein (€4.43 in chips) 
lopo1187: posts small blind €0.01
pipinoelbreve9: posts big blind €0.02
*** HOLE CARDS ***
Dealt to pipinoelbreve9 [Ks 6h]
PavoN_PT: folds 
ehbraga: folds 
ZoasHein: folds 
PkBcN15: calls €0.02
lopo1187: folds 
pipinoelbreve9: checks 
*** FLOP *** [Qs Qh 9d]
pipinoelbreve9: checks 
PkBcN15: bets €0.03
pipinoelbreve9: folds 
Uncalled bet (€0.03) returned to PkBcN15
PkBcN15 collected €0.05 from pot
PkBcN15: doesn't show hand 
*** SUMMARY ***
Total pot €0.05 | Rake €0 
Board [Qs Qh 9d]
Seat 1: PkBcN15 (button) collected (€0.05)
Seat 2: lopo1187 (small blind) folded before Flop
Seat 3: pipinoelbreve9 (big blind) folded on the Flop
Seat 4: PavoN_PT folded before Flop (didn't bet)
Seat 5: ehbraga folded before Flop (didn't bet)
Seat 6: ZoasHein folded before Flop (didn't bet)



PokerStars Zoom Hand #257563700742:  Hold'em No Limit (€0.01/€0.02) - 2025/08/31 23:23:20 CET [2025/08/31 17:23:20 ET]
Table 'Arneb' 6-max Seat #1 is the button
Seat 1: wilbor123 (€2 in chips) 
Seat 2: pipinoelbreve9 (€4.17 in chips) 
Seat 3: sambupkr (€5.29 in chips) 
Seat 4: Manuxanxe78 (€2.74 in chips) 
Seat 5: MakesMeRich (€3.10 in chips) 
Seat 6: PkBcN15 (€2 in chips) 
pipinoelbreve9: posts small blind €0.01
sambupkr: posts big blind €0.02
*** HOLE CARDS ***
Dealt to pipinoelbreve9 [6s 6h]
Manuxanxe78: folds 
MakesMeRich: folds 
PkBcN15: folds 
wilbor123: raises €0.04 to €0.06
pipinoelbreve9: calls €0.05
sambupkr: folds 
*** FLOP *** [4d Ac 9s]
pipinoelbreve9: checks 
wilbor123: bets €0.04
pipinoelbreve9: calls €0.04
*** TURN *** [4d Ac 9s] [Ah]
pipinoelbreve9: checks 
wilbor123: checks 
*** RIVER *** [4d Ac 9s Ah] [5s]
pipinoelbreve9: bets €0.04
wilbor123: calls €0.04
*** SHOW DOWN ***
pipinoelbreve9: shows [6s 6h] (two pair, Aces and Sixes)
wilbor123: shows [Kc Ks] (two pair, Aces and Kings)
wilbor123 collected €0.28 from pot
*** SUMMARY ***
Total pot €0.30 | Rake €0.02 
Board [4d Ac 9s Ah 5s]
Seat 1: wilbor123 (button) showed [Kc Ks] and won (€0.28) with two pair, Aces and Kings
Seat 2: pipinoelbreve9 (small blind) showed [6s 6h] and lost with two pair, Aces and Sixes
Seat 3: sambupkr (big blind) folded before Flop
Seat 4: Manuxanxe78 folded before Flop (didn't bet)
Seat 5: MakesMeRich folded before Flop (didn't bet)
Seat 6: PkBcN15 folded before Flop (didn't bet)



PokerStars Zoom Hand #257563714382:  Hold'em No Limit (€0.01/€0.02) - 2025/08/31 23:24:07 CET [2025/08/31 17:24:07 ET]
Table 'Arneb' 6-max Seat #1 is the button
Seat 1: sambupkr (€5.27 in chips) 
Seat 2: PkBcN15 (€2 in chips) 
Seat 3: ehbraga (€0.97 in chips) 
Seat 4: pipinoelbreve9 (€4.03 in chips) 
Seat 5: Manuxanxe78 (€2.74 in chips) 
Seat 6: felgas1968 (€5.81 in chips) 
PkBcN15: posts small blind €0.01
ehbraga: posts big blind €0.02
*** HOLE CARDS ***
Dealt to pipinoelbreve9 [As Ts]
pipinoelbreve9: raises €0.04 to €0.06
Manuxanxe78: folds 
felgas1968: folds 
sambupkr: folds 
PkBcN15: folds 
ehbraga: folds 
Uncalled bet (€0.04) returned to pipinoelbreve9
pipinoelbreve9 collected €0.05 from pot
pipinoelbreve9: doesn't show hand 
*** SUMMARY ***
Total pot €0.05 | Rake €0 
Seat 1: sambupkr (button) folded before Flop (didn't bet)
Seat 2: PkBcN15 (small blind) folded before Flop
Seat 3: ehbraga (big blind) folded before Flop
Seat 4: pipinoelbreve9 collected (€0.05)
Seat 5: Manuxanxe78 folded before Flop (didn't bet)
Seat 6: felgas1968 folded before Flop (didn't bet)



PokerStars Zoom Hand #257563712697:  Hold'em No Limit (€0.01/€0.02) - 2025/08/31 23:24:01 CET [2025/08/31 17:24:01 ET]
Table 'Arneb' 6-max Seat #1 is the button
Seat 1: Manuxanxe78 (€2.74 in chips) 
Seat 2: BancaRota33 (€2.12 in chips) 
Seat 3: lopo1187 (€2.08 in chips) 
Seat 4: ehbraga (€0.97 in chips) 
Seat 5: pipinoelbreve9 (€4.03 in chips) 
Seat 6: tanoun1 (€7.86 in chips) 
BancaRota33: posts small blind €0.01
lopo1187: posts big blind €0.02
*** HOLE CARDS ***
Dealt to pipinoelbreve9 [6c Ks]
ehbraga: folds 
pipinoelbreve9: folds 
tanoun1: folds 
Manuxanxe78: folds 
BancaRota33: raises €0.04 to €0.06
lopo1187: calls €0.04
*** FLOP *** [5d 8h Qd]
BancaRota33: bets €0.04
lopo1187: folds 
Uncalled bet (€0.04) returned to BancaRota33
BancaRota33 collected €0.11 from pot
BancaRota33: doesn't show hand 
*** SUMMARY ***
Total pot €0.12 | Rake €0.01 
Board [5d 8h Qd]
Seat 1: Manuxanxe78 (button) folded before Flop (didn't bet)
Seat 2: BancaRota33 (small blind) collected (€0.11)
Seat 3: lopo1187 (big blind) folded on the Flop
Seat 4: ehbraga folded before Flop (didn't bet)
Seat 5: pipinoelbreve9 folded before Flop (didn't bet)
Seat 6: tanoun1 folded before Flop (didn't bet)



PokerStars Zoom Hand #257563720034:  Hold'em No Limit (€0.01/€0.02) - 2025/08/31 23:24:26 CET [2025/08/31 17:24:26 ET]
Table 'Arneb' 6-max Seat #1 is the button
Seat 1: Xoco Cusco (€3.22 in chips) 
Seat 2: sambupkr (€3.45 in chips) 
Seat 3: MakesMeRich (€2.18 in chips) 
Seat 4: ehbraga (€0.57 in chips) 
Seat 5: ZoasHein (€4.48 in chips) 
Seat 6: pipinoelbreve9 (€4.06 in chips) 
sambupkr: posts small blind €0.01
MakesMeRich: posts big blind €0.02
*** HOLE CARDS ***
Dealt to pipinoelbreve9 [3h 2s]
ehbraga: folds 
ZoasHein: raises €0.04 to €0.06
pipinoelbreve9: folds 
Xoco Cusco: folds 
sambupkr: folds 
MakesMeRich: folds 
Uncalled bet (€0.04) returned to ZoasHein
ZoasHein collected €0.05 from pot
ZoasHein: doesn't show hand 
*** SUMMARY ***
Total pot €0.05 | Rake €0 
Seat 1: Xoco Cusco (button) folded before Flop (didn't bet)
Seat 2: sambupkr (small blind) folded before Flop
Seat 3: MakesMeRich (big blind) folded before Flop
Seat 4: ehbraga folded before Flop (didn't bet)
Seat 5: ZoasHein collected (€0.05)
Seat 6: pipinoelbreve9 folded before Flop (didn't bet)



PokerStars Zoom Hand #257563724226:  Hold'em No Limit (€0.01/€0.02) - 2025/08/31 23:24:40 CET [2025/08/31 17:24:40 ET]
Table 'Arneb' 6-max Seat #1 is the button
Seat 1: sambupkr (€2.45 in chips) 
Seat 2: Xoco Cusco (€3.22 in chips) 
Seat 3: pipinoelbreve9 (€4.06 in chips) 
Seat 4: MakesMeRich (€2.16 in chips) 
Seat 5: Manuxanxe78 (€2.79 in chips) 
Seat 6: tanoun1 (€5.95 in chips) 
Xoco Cusco: posts small blind €0.01
pipinoelbreve9: posts big blind €0.02
*** HOLE CARDS ***
Dealt to pipinoelbreve9 [5s 7c]
MakesMeRich: folds 
Manuxanxe78: folds 
tanoun1: folds 
sambupkr: raises €0.04 to €0.06
Xoco Cusco: folds 
pipinoelbreve9: folds 
Uncalled bet (€0.04) returned to sambupkr
sambupkr collected €0.05 from pot
sambupkr: doesn't show hand 
*** SUMMARY ***
Total pot €0.05 | Rake €0 
Seat 1: sambupkr (button) collected (€0.05)
Seat 2: Xoco Cusco (small blind) folded before Flop
Seat 3: pipinoelbreve9 (big blind) folded before Flop
Seat 4: MakesMeRich folded before Flop (didn't bet)
Seat 5: Manuxanxe78 folded before Flop (didn't bet)
Seat 6: tanoun1 folded before Flop (didn't bet)



PokerStars Zoom Hand #257563722731:  Hold'em No Limit (€0.01/€0.02) - 2025/08/31 23:24:35 CET [2025/08/31 17:24:35 ET]
Table 'Arneb' 6-max Seat #1 is the button
Seat 1: pipinoelbreve9 (€4.06 in chips) 
Seat 2: Romeo22901 (€1.58 in chips) 
Seat 3: Strlen83 (€2.46 in chips) 
Seat 4: correcamiños (€2.09 in chips) 
Seat 5: tanoun1 (€3.52 in chips) 
Seat 6: Xoseanro510 (€2.83 in chips) 
Romeo22901: posts small blind €0.01
Strlen83: posts big blind €0.02
*** HOLE CARDS ***
Dealt to pipinoelbreve9 [Tc 5c]
correcamiños: raises €0.04 to €0.06
tanoun1: folds 
Xoseanro510: folds 
pipinoelbreve9: folds 
Romeo22901: folds 
Strlen83: folds 
Uncalled bet (€0.04) returned to correcamiños
correcamiños collected €0.05 from pot
correcamiños: doesn't show hand 
*** SUMMARY ***
Total pot €0.05 | Rake €0 
Seat 1: pipinoelbreve9 (button) folded before Flop (didn't bet)
Seat 2: Romeo22901 (small blind) folded before Flop
Seat 3: Strlen83 (big blind) folded before Flop
Seat 4: correcamiños collected (€0.05)
Seat 5: tanoun1 folded before Flop (didn't bet)
Seat 6: Xoseanro510 folded before Flop (didn't bet)



PokerStars Zoom Hand #257563728391:  Hold'em No Limit (€0.01/€0.02) - 2025/08/31 23:24:54 CET [2025/08/31 17:24:54 ET]
Table 'Arneb' 6-max Seat #1 is the button
Seat 1: sambupkr (€3.45 in chips) 
Seat 2: pipinoelbreve9 (€4.04 in chips) 
Seat 3: Ismael 77751 (€2.25 in chips) 
Seat 4: seriomarkos (€1.97 in chips) 
Seat 5: felgas1968 (€5.36 in chips) 
Seat 6: top101 (€1.99 in chips) 
pipinoelbreve9: posts small blind €0.01
Ismael 77751: posts big blind €0.02
*** HOLE CARDS ***
Dealt to pipinoelbreve9 [9s Ah]
seriomarkos: folds 
felgas1968: folds 
top101: folds 
sambupkr: raises €0.04 to €0.06
pipinoelbreve9: calls €0.05
Ismael 77751: folds 
*** FLOP *** [Qc 3d 7s]
pipinoelbreve9: checks 
sambupkr: bets €0.04
pipinoelbreve9: folds 
Uncalled bet (€0.04) returned to sambupkr
sambupkr collected €0.13 from pot
sambupkr: doesn't show hand 
*** SUMMARY ***
Total pot €0.14 | Rake €0.01 
Board [Qc 3d 7s]
Seat 1: sambupkr (button) collected (€0.13)
Seat 2: pipinoelbreve9 (small blind) folded on the Flop
Seat 3: Ismael 77751 (big blind) folded before Flop
Seat 4: seriomarkos folded before Flop (didn't bet)
Seat 5: felgas1968 folded before Flop (didn't bet)
Seat 6: top101 folded before Flop (didn't bet)



PokerStars Zoom Hand #257563721369:  Hold'em No Limit (€0.01/€0.02) - 2025/08/31 23:24:30 CET [2025/08/31 17:24:30 ET]
Table 'Arneb' 6-max Seat #1 is the button
Seat 1: Ismael 77751 (€2.26 in chips) 
Seat 2: Belezaso21 (€1.72 in chips) 
Seat 3: lopo1187 (€2 in chips) 
Seat 4: pipinoelbreve9 (€4.06 in chips) 
Seat 5: ehbraga (€1.01 in chips) 
Seat 6: tijolon (€2.18 in chips) 
Belezaso21: posts small blind €0.01
lopo1187: posts big blind €0.02
*** HOLE CARDS ***
Dealt to pipinoelbreve9 [9c 8c]
pipinoelbreve9: folds 
ehbraga: folds 
tijolon: folds 
Ismael 77751: folds 
Belezaso21: calls €0.01
lopo1187: checks 
*** FLOP *** [7s Kd Ts]
Belezaso21: checks 
lopo1187: bets €0.02
Belezaso21: raises €0.06 to €0.08
lopo1187: calls €0.06
*** TURN *** [7s Kd Ts] [4h]
Belezaso21: bets €0.19
lopo1187: folds 
Uncalled bet (€0.19) returned to Belezaso21
Belezaso21 collected €0.19 from pot
Belezaso21: doesn't show hand 
*** SUMMARY ***
Total pot €0.20 | Rake €0.01 
Board [7s Kd Ts 4h]
Seat 1: Ismael 77751 (button) folded before Flop (didn't bet)
Seat 2: Belezaso21 (small blind) collected (€0.19)
Seat 3: lopo1187 (big blind) folded on the Turn
Seat 4: pipinoelbreve9 folded before Flop (didn't bet)
Seat 5: ehbraga folded before Flop (didn't bet)
Seat 6: tijolon folded before Flop (didn't bet)



PokerStars Zoom Hand #257563735914:  Hold'em No Limit (€0.01/€0.02) - 2025/08/31 23:25:19 CET [2025/08/31 17:25:19 ET]
Table 'Arneb' 6-max Seat #1 is the button
Seat 1: tanoun1 (€5.92 in chips) 
Seat 2: correcamiños (€3.09 in chips) 
Seat 3: felgas1968 (€5.36 in chips) 
Seat 4: Sportacus911 (€2.79 in chips) 
Seat 5: Grilo9 (€2.06 in chips) 
Seat 6: pipinoelbreve9 (€3.98 in chips) 
correcamiños: posts small blind €0.01
felgas1968: posts big blind €0.02
*** HOLE CARDS ***
Dealt to pipinoelbreve9 [Kh 8c]
Sportacus911: raises €0.04 to €0.06
Grilo9: folds 
pipinoelbreve9: folds 
tanoun1: raises €0.12 to €0.18
correcamiños: folds 
felgas1968: folds 
Sportacus911: folds 
Uncalled bet (€0.12) returned to tanoun1
tanoun1 collected €0.15 from pot
tanoun1: doesn't show hand 
*** SUMMARY ***
Total pot €0.15 | Rake €0 
Seat 1: tanoun1 (button) collected (€0.15)
Seat 2: correcamiños (small blind) folded before Flop
Seat 3: felgas1968 (big blind) folded before Flop
Seat 4: Sportacus911 folded before Flop
Seat 5: Grilo9 folded before Flop (didn't bet)
Seat 6: pipinoelbreve9 folded before Flop (didn't bet)



PokerStars Zoom Hand #257563739285:  Hold'em No Limit (€0.01/€0.02) - 2025/08/31 23:25:30 CET [2025/08/31 17:25:30 ET]
Table 'Arneb' 6-max Seat #1 is the button
Seat 1: RCSA2 (€2.74 in chips) 
Seat 2: lopo1187 (€2 in chips) 
Seat 3: forinal (€1.42 in chips) 
Seat 4: pipinoelbreve9 (€3.98 in chips) 
Seat 5: Bestiote (€0.68 in chips) 
Seat 6: Manuxanxe78 (€2 in chips) 
lopo1187: posts small blind €0.01
forinal: posts big blind €0.02
*** HOLE CARDS ***
Dealt to pipinoelbreve9 [Qs 4h]
pipinoelbreve9: folds 
Bestiote: folds 
Manuxanxe78: folds 
RCSA2: folds 
lopo1187: folds 
Uncalled bet (€0.01) returned to forinal
forinal collected €0.02 from pot
forinal: doesn't show hand 
*** SUMMARY ***
Total pot €0.02 | Rake €0 
Seat 1: RCSA2 (button) folded before Flop (didn't bet)
Seat 2: lopo1187 (small blind) folded before Flop
Seat 3: forinal (big blind) collected (€0.02)
Seat 4: pipinoelbreve9 folded before Flop (didn't bet)
Seat 5: Bestiote folded before Flop (didn't bet)
Seat 6: Manuxanxe78 folded before Flop (didn't bet)



PokerStars Zoom Hand #257563737297:  Hold'em No Limit (€0.01/€0.02) - 2025/08/31 23:25:23 CET [2025/08/31 17:25:23 ET]
Table 'Arneb' 6-max Seat #1 is the button
Seat 1: italiano125 (€0.41 in chips) 
Seat 2: Bestiote (€0.69 in chips) 
Seat 3: Grilo9 (€2.06 in chips) 
Seat 4: RCSA2 (€2.74 in chips) 
Seat 5: pipinoelbreve9 (€3.98 in chips) 
Seat 6: PkBcN15 (€2.18 in chips) 
Bestiote: posts small blind €0.01
Grilo9: posts big blind €0.02
*** HOLE CARDS ***
Dealt to pipinoelbreve9 [Kc 7s]
RCSA2: folds 
pipinoelbreve9: folds 
PkBcN15: calls €0.02
italiano125: calls €0.02
Bestiote: folds 
Grilo9: raises €0.10 to €0.12
PkBcN15: calls €0.10
italiano125: calls €0.10
*** FLOP *** [4d Qc 6c]
Grilo9: bets €0.18
PkBcN15: folds 
italiano125: folds 
Uncalled bet (€0.18) returned to Grilo9
Grilo9 collected €0.35 from pot
Grilo9: doesn't show hand 
*** SUMMARY ***
Total pot €0.37 | Rake €0.02 
Board [4d Qc 6c]
Seat 1: italiano125 (button) folded on the Flop
Seat 2: Bestiote (small blind) folded before Flop
Seat 3: Grilo9 (big blind) collected (€0.35)
Seat 4: RCSA2 folded before Flop (didn't bet)
Seat 5: pipinoelbreve9 folded before Flop (didn't bet)
Seat 6: PkBcN15 folded on the Flop



PokerStars Zoom Hand #257563740570:  Hold'em No Limit (€0.01/€0.02) - 2025/08/31 23:25:35 CET [2025/08/31 17:25:35 ET]
Table 'Arneb' 6-max Seat #1 is the button
Seat 1: vinipats83 (€2.46 in chips) 
Seat 2: Grilo9 (€2.10 in chips) 
Seat 3: pipinoelbreve9 (€3.98 in chips) 
Seat 4: sambupkr (€2.53 in chips) 
Seat 5: correcamiños (€2.89 in chips) 
Seat 6: eneko83 (€3.13 in chips) 
Grilo9: posts small blind €0.01
pipinoelbreve9: posts big blind €0.02
*** HOLE CARDS ***
Dealt to pipinoelbreve9 [8h Kh]
sambupkr: folds 
correcamiños: raises €0.04 to €0.06
eneko83: folds 
vinipats83: folds 
Grilo9: folds 
pipinoelbreve9: calls €0.04
*** FLOP *** [6h 9c Js]
pipinoelbreve9: checks 
correcamiños: bets €0.04
pipinoelbreve9: folds 
Uncalled bet (€0.04) returned to correcamiños
correcamiños collected €0.12 from pot
correcamiños: doesn't show hand 
*** SUMMARY ***
Total pot €0.13 | Rake €0.01 
Board [6h 9c Js]
Seat 1: vinipats83 (button) folded before Flop (didn't bet)
Seat 2: Grilo9 (small blind) folded before Flop
Seat 3: pipinoelbreve9 (big blind) folded on the Flop
Seat 4: sambupkr folded before Flop (didn't bet)
Seat 5: correcamiños collected (€0.12)
Seat 6: eneko83 folded before Flop (didn't bet)



PokerStars Zoom Hand #257563747248:  Hold'em No Limit (€0.01/€0.02) - 2025/08/31 23:25:57 CET [2025/08/31 17:25:57 ET]
Table 'Arneb' 6-max Seat #1 is the button
Seat 1: pipinoelbreve9 (€3.92 in chips) 
Seat 2: PkBcN15 (€2.08 in chips) 
Seat 3: Davidsancheez16 (€1.87 in chips) 
Seat 4: Manuxanxe78 (€2.76 in chips) 
Seat 5: Sportacus911 (€2.70 in chips) 
Seat 6: pingu_771 (€3.70 in chips) 
PkBcN15: posts small blind €0.01
Davidsancheez16: posts big blind €0.02
*** HOLE CARDS ***
Dealt to pipinoelbreve9 [9h 3h]
Manuxanxe78: folds 
Sportacus911: raises €0.04 to €0.06
pingu_771: folds 
pipinoelbreve9: folds 
PkBcN15: folds 
Davidsancheez16: folds 
Uncalled bet (€0.04) returned to Sportacus911
Sportacus911 collected €0.05 from pot
Sportacus911: doesn't show hand 
*** SUMMARY ***
Total pot €0.05 | Rake €0 
Seat 1: pipinoelbreve9 (button) folded before Flop (didn't bet)
Seat 2: PkBcN15 (small blind) folded before Flop
Seat 3: Davidsancheez16 (big blind) folded before Flop
Seat 4: Manuxanxe78 folded before Flop (didn't bet)
Seat 5: Sportacus911 collected (€0.05)
Seat 6: pingu_771 folded before Flop (didn't bet)



PokerStars Zoom Hand #257563749186:  Hold'em No Limit (€0.01/€0.02) - 2025/08/31 23:26:04 CET [2025/08/31 17:26:04 ET]
Table 'Arneb' 6-max Seat #1 is the button
Seat 1: Manuxanxe78 (€2.76 in chips) 
Seat 2: pipinoelbreve9 (€3.92 in chips) 
Seat 3: wilbor123 (€1.99 in chips) 
Seat 4: lilpapayaa (€0.59 in chips) 
Seat 5: tanoun1 (€2.32 in chips) 
Seat 6: MakesMeRich (€3.18 in chips) 
pipinoelbreve9: posts small blind €0.01
wilbor123: posts big blind €0.02
*** HOLE CARDS ***
Dealt to pipinoelbreve9 [6s 4h]
lilpapayaa: folds 
tanoun1: folds 
MakesMeRich: folds 
Manuxanxe78: folds 
pipinoelbreve9: folds 
Uncalled bet (€0.01) returned to wilbor123
wilbor123 collected €0.02 from pot
wilbor123: doesn't show hand 
*** SUMMARY ***
Total pot €0.02 | Rake €0 
Seat 1: Manuxanxe78 (button) folded before Flop (didn't bet)
Seat 2: pipinoelbreve9 (small blind) folded before Flop
Seat 3: wilbor123 (big blind) collected (€0.02)
Seat 4: lilpapayaa folded before Flop (didn't bet)
Seat 5: tanoun1 folded before Flop (didn't bet)
Seat 6: MakesMeRich folded before Flop (didn't bet)



PokerStars Zoom Hand #257563753021:  Hold'em No Limit (€0.01/€0.02) - 2025/08/31 23:26:17 CET [2025/08/31 17:26:17 ET]
Table 'Arneb' 6-max Seat #1 is the button
Seat 1: pipinoelbreve9 (€3.91 in chips) 
Seat 2: correcamiños (€2.95 in chips) 
Seat 3: Sportacus911 (€2.17 in chips) 
Seat 4: Strlen83 (€2.35 in chips) 
Seat 5: Jah2U (€1.53 in chips) 
Seat 6: ehbraga (€0.57 in chips) 
correcamiños: posts small blind €0.01
Sportacus911: posts big blind €0.02
*** HOLE CARDS ***
Dealt to pipinoelbreve9 [2c Kh]
Strlen83: folds 
Jah2U: folds 
ehbraga: folds 
pipinoelbreve9: folds 
correcamiños: raises €0.04 to €0.06
Sportacus911: folds 
Uncalled bet (€0.04) returned to correcamiños
correcamiños collected €0.04 from pot
correcamiños: doesn't show hand 
*** SUMMARY ***
Total pot €0.04 | Rake €0 
Seat 1: pipinoelbreve9 (button) folded before Flop (didn't bet)
Seat 2: correcamiños (small blind) collected (€0.04)
Seat 3: Sportacus911 (big blind) folded before Flop
Seat 4: Strlen83 folded before Flop (didn't bet)
Seat 5: Jah2U folded before Flop (didn't bet)
Seat 6: ehbraga folded before Flop (didn't bet)



PokerStars Zoom Hand #257563756201:  Hold'em No Limit (€0.01/€0.02) - 2025/08/31 23:26:28 CET [2025/08/31 17:26:28 ET]
Table 'Arneb' 6-max Seat #1 is the button
Seat 1: correcamiños (€3.08 in chips) 
Seat 2: pipinoelbreve9 (€3.91 in chips) 
Seat 3: Jah2U (€1.53 in chips) 
Seat 4: marcosbalsaa (€2 in chips) 
Seat 5: LuisGR90 (€2.50 in chips) 
Seat 6: ehbraga (€0.74 in chips) 
pipinoelbreve9: posts small blind €0.01
Jah2U: posts big blind €0.02
*** HOLE CARDS ***
Dealt to pipinoelbreve9 [Qs 2d]
marcosbalsaa: folds 
LuisGR90: folds 
ehbraga: folds 
correcamiños: folds 
pipinoelbreve9: folds 
Uncalled bet (€0.01) returned to Jah2U
Jah2U collected €0.02 from pot
Jah2U: doesn't show hand 
*** SUMMARY ***
Total pot €0.02 | Rake €0 
Seat 1: correcamiños (button) folded before Flop (didn't bet)
Seat 2: pipinoelbreve9 (small blind) folded before Flop
Seat 3: Jah2U (big blind) collected (€0.02)
Seat 4: marcosbalsaa folded before Flop (didn't bet)
Seat 5: LuisGR90 folded before Flop (didn't bet)
Seat 6: ehbraga folded before Flop (didn't bet)



PokerStars Zoom Hand #257563754979:  Hold'em No Limit (€0.01/€0.02) - 2025/08/31 23:26:24 CET [2025/08/31 17:26:24 ET]
Table 'Arneb' 6-max Seat #1 is the button
Seat 1: Bestiote (€0.69 in chips) 
Seat 2: Manuxanxe78 (€2 in chips) 
Seat 3: RCSA2 (€2.68 in chips) 
Seat 4: tijolon (€2 in chips) 
Seat 5: pipinoelbreve9 (€3.91 in chips) 
Seat 6: Phenon33 (€1.55 in chips) 
Manuxanxe78: posts small blind €0.01
RCSA2: posts big blind €0.02
*** HOLE CARDS ***
Dealt to pipinoelbreve9 [3h 6s]
tijolon: folds 
pipinoelbreve9: folds 
Phenon33: calls €0.02
Bestiote: folds 
Manuxanxe78: folds 
RCSA2: checks 
*** FLOP *** [Js Th 4d]
RCSA2: bets €0.05
Phenon33: calls €0.05
*** TURN *** [Js Th 4d] [Qh]
RCSA2: checks 
Phenon33: bets €0.07
RCSA2: folds 
Uncalled bet (€0.07) returned to Phenon33
Phenon33 collected €0.14 from pot
Phenon33: doesn't show hand 
*** SUMMARY ***
Total pot €0.15 | Rake €0.01 
Board [Js Th 4d Qh]
Seat 1: Bestiote (button) folded before Flop (didn't bet)
Seat 2: Manuxanxe78 (small blind) folded before Flop
Seat 3: RCSA2 (big blind) folded on the Turn
Seat 4: tijolon folded before Flop (didn't bet)
Seat 5: pipinoelbreve9 folded before Flop (didn't bet)
Seat 6: Phenon33 collected (€0.14)



PokerStars Zoom Hand #257563760887:  Hold'em No Limit (€0.01/€0.02) - 2025/08/31 23:26:44 CET [2025/08/31 17:26:44 ET]
Table 'Arneb' 6-max Seat #1 is the button
Seat 1: Sportacus911 (€2.14 in chips) 
Seat 2: Mai SA135 (€4.60 in chips) 
Seat 3: BancaRota33 (€4.10 in chips) 
Seat 4: LuisGR90 (€2.13 in chips) 
Seat 5: ehbraga (€0.74 in chips) 
Seat 6: pipinoelbreve9 (€3.88 in chips) 
Mai SA135: posts small blind €0.01
BancaRota33: posts big blind €0.02
*** HOLE CARDS ***
Dealt to pipinoelbreve9 [Td 3d]
LuisGR90: folds 
ehbraga: folds 
pipinoelbreve9: folds 
Sportacus911: folds 
Mai SA135: raises €0.06 to €0.08
BancaRota33: folds 
Uncalled bet (€0.06) returned to Mai SA135
Mai SA135 collected €0.04 from pot
Mai SA135: doesn't show hand 
*** SUMMARY ***
Total pot €0.04 | Rake €0 
Seat 1: Sportacus911 (button) folded before Flop (didn't bet)
Seat 2: Mai SA135 (small blind) collected (€0.04)
Seat 3: BancaRota33 (big blind) folded before Flop
Seat 4: LuisGR90 folded before Flop (didn't bet)
Seat 5: ehbraga folded before Flop (didn't bet)
Seat 6: pipinoelbreve9 folded before Flop (didn't bet)



PokerStars Zoom Hand #257563759378:  Hold'em No Limit (€0.01/€0.02) - 2025/08/31 23:26:39 CET [2025/08/31 17:26:39 ET]
Table 'Arneb' 6-max Seat #1 is the button
Seat 1: tanoun1 (€7.97 in chips) 
Seat 2: Sportacus911 (€2.15 in chips) 
Seat 3: juanlu2000china (€2.35 in chips) 
Seat 4: Grilo9 (€2 in chips) 
Seat 5: pipinoelbreve9 (€3.88 in chips) 
Seat 6: mariaantunes20 (€2.75 in chips) 
Sportacus911: posts small blind €0.01
juanlu2000china: posts big blind €0.02
*** HOLE CARDS ***
Dealt to pipinoelbreve9 [3s Ah]
Grilo9: folds 
pipinoelbreve9: folds 
mariaantunes20 has timed out while disconnected
mariaantunes20: folds 
tanoun1: raises €0.03 to €0.05
Sportacus911: folds 
juanlu2000china: folds 
Uncalled bet (€0.03) returned to tanoun1
tanoun1 collected €0.05 from pot
tanoun1: doesn't show hand 
*** SUMMARY ***
Total pot €0.05 | Rake €0 
Seat 1: tanoun1 (button) collected (€0.05)
Seat 2: Sportacus911 (small blind) folded before Flop
Seat 3: juanlu2000china (big blind) folded before Flop
Seat 4: Grilo9 folded before Flop (didn't bet)
Seat 5: pipinoelbreve9 folded before Flop (didn't bet)
Seat 6: mariaantunes20 folded before Flop (didn't bet)



PokerStars Zoom Hand #257563750949:  Hold'em No Limit (€0.01/€0.02) - 2025/08/31 23:26:10 CET [2025/08/31 17:26:10 ET]
Table 'Arneb' 6-max Seat #1 is the button
Seat 1: Romeo22901 (€1.12 in chips) 
Seat 2: XXXJAVIXXX14 (€2.90 in chips) 
Seat 3: Xoco Cusco (€3.10 in chips) 
Seat 4: pingu_771 (€3.70 in chips) 
Seat 5: PkBcN15 (€2.07 in chips) 
Seat 6: pipinoelbreve9 (€3.91 in chips) 
XXXJAVIXXX14: posts small blind €0.01
Xoco Cusco: posts big blind €0.02
*** HOLE CARDS ***
Dealt to pipinoelbreve9 [Qh 7d]
pingu_771: folds 
PkBcN15: calls €0.02
pipinoelbreve9: folds 
Romeo22901: calls €0.02
XXXJAVIXXX14: calls €0.01
Xoco Cusco: checks 
*** FLOP *** [8s Qd 4s]
XXXJAVIXXX14: checks 
Xoco Cusco: checks 
PkBcN15: checks 
Romeo22901: checks 
*** TURN *** [8s Qd 4s] [5d]
XXXJAVIXXX14: bets €0.02
Xoco Cusco: calls €0.02
PkBcN15: calls €0.02
Romeo22901: calls €0.02
*** RIVER *** [8s Qd 4s 5d] [Ks]
XXXJAVIXXX14: checks 
Xoco Cusco: checks 
PkBcN15: checks 
Romeo22901: checks 
*** SHOW DOWN ***
XXXJAVIXXX14: shows [Ah 8d] (a pair of Eights)
Xoco Cusco: shows [Td Kc] (a pair of Kings)
PkBcN15: mucks hand 
Romeo22901: mucks hand 
Xoco Cusco collected €0.15 from pot
*** SUMMARY ***
Total pot €0.16 | Rake €0.01 
Board [8s Qd 4s 5d Ks]
Seat 1: Romeo22901 (button) mucked [As 5c]
Seat 2: XXXJAVIXXX14 (small blind) showed [Ah 8d] and lost with a pair of Eights
Seat 3: Xoco Cusco (big blind) showed [Td Kc] and won (€0.15) with a pair of Kings
Seat 4: pingu_771 folded before Flop (didn't bet)
Seat 5: PkBcN15 mucked [Jh 8h]
Seat 6: pipinoelbreve9 folded before Flop (didn't bet)



PokerStars Zoom Hand #257563768055:  Hold'em No Limit (€0.01/€0.02) - 2025/08/31 23:27:09 CET [2025/08/31 17:27:09 ET]
Table 'Arneb' 6-max Seat #1 is the button
Seat 1: NazaSilva (€1 in chips) 
Seat 2: PkBcN15 (€2 in chips) 
Seat 3: pipinoelbreve9 (€3.88 in chips) 
Seat 4: trinityandme (€1.18 in chips) 
Seat 5: mariaantunes20 (€2.75 in chips) 
Seat 6: 34pluto (€2.06 in chips) 
PkBcN15: posts small blind €0.01
pipinoelbreve9: posts big blind €0.02
*** HOLE CARDS ***
Dealt to pipinoelbreve9 [Jd 2s]
trinityandme: folds 
mariaantunes20: folds 
34pluto: folds 
NazaSilva: folds 
PkBcN15: raises €0.02 to €0.04
pipinoelbreve9: folds 
Uncalled bet (€0.02) returned to PkBcN15
PkBcN15 collected €0.04 from pot
PkBcN15: doesn't show hand 
*** SUMMARY ***
Total pot €0.04 | Rake €0 
Seat 1: NazaSilva (button) folded before Flop (didn't bet)
Seat 2: PkBcN15 (small blind) collected (€0.04)
Seat 3: pipinoelbreve9 (big blind) folded before Flop
Seat 4: trinityandme folded before Flop (didn't bet)
Seat 5: mariaantunes20 folded before Flop (didn't bet)
Seat 6: 34pluto folded before Flop (didn't bet)



PokerStars Zoom Hand #257563757366:  Hold'em No Limit (€0.01/€0.02) - 2025/08/31 23:26:32 CET [2025/08/31 17:26:32 ET]
Table 'Arneb' 6-max Seat #1 is the button
Seat 1: 28chan28 (€4.32 in chips) 
Seat 2: Bestiote (€0.69 in chips) 
Seat 3: pipinoelbreve9 (€3.90 in chips) 
Seat 4: minisusy (€0.84 in chips) 
Seat 5: aliner34j (€2.62 in chips) 
Seat 6: raptureman1 (€2.24 in chips) 
Bestiote: posts small blind €0.01
pipinoelbreve9: posts big blind €0.02
*** HOLE CARDS ***
Dealt to pipinoelbreve9 [7d 2h]
minisusy: raises €0.04 to €0.06
aliner34j: folds 
raptureman1: folds 
28chan28: raises €0.14 to €0.20
Bestiote: calls €0.19
pipinoelbreve9: folds 
minisusy: calls €0.14
*** FLOP *** [Tc 2s Qd]
Bestiote: checks 
minisusy: bets €0.64 and is all-in
28chan28: calls €0.64
Bestiote: folds 
*** TURN *** [Tc 2s Qd] [6d]
*** RIVER *** [Tc 2s Qd 6d] [Jc]
*** SHOW DOWN ***
minisusy: shows [Th Ad] (a pair of Tens)
28chan28: shows [Qc Qh] (three of a kind, Queens)
28chan28 collected €1.80 from pot
*** SUMMARY ***
Total pot €1.90 | Rake €0.10 
Board [Tc 2s Qd 6d Jc]
Seat 1: 28chan28 (button) showed [Qc Qh] and won (€1.80) with three of a kind, Queens
Seat 2: Bestiote (small blind) folded on the Flop
Seat 3: pipinoelbreve9 (big blind) folded before Flop
Seat 4: minisusy showed [Th Ad] and lost with a pair of Tens
Seat 5: aliner34j folded before Flop (didn't bet)
Seat 6: raptureman1 folded before Flop (didn't bet)



PokerStars Zoom Hand #257563765822:  Hold'em No Limit (€0.01/€0.02) - 2025/08/31 23:27:01 CET [2025/08/31 17:27:01 ET]
Table 'Arneb' 6-max Seat #1 is the button
Seat 1: pipinoelbreve9 (€3.88 in chips) 
Seat 2: tanoun1 (€3.45 in chips) 
Seat 3: felgas1968 (€6.69 in chips) 
Seat 4: tijolon (€2.30 in chips) 
Seat 5: Grilo9 (€2 in chips) 
Seat 6: Manuxanxe78 (€2.66 in chips) 
tanoun1: posts small blind €0.01
felgas1968: posts big blind €0.02
*** HOLE CARDS ***
Dealt to pipinoelbreve9 [8h 3s]
tijolon: folds 
Grilo9: folds 
Manuxanxe78 has timed out
Manuxanxe78: folds 
pipinoelbreve9: folds 
tanoun1: raises €0.04 to €0.06
felgas1968: folds 
Uncalled bet (€0.04) returned to tanoun1
tanoun1 collected €0.04 from pot
tanoun1: doesn't show hand 
*** SUMMARY ***
Total pot €0.04 | Rake €0 
Seat 1: pipinoelbreve9 (button) folded before Flop (didn't bet)
Seat 2: tanoun1 (small blind) collected (€0.04)
Seat 3: felgas1968 (big blind) folded before Flop
Seat 4: tijolon folded before Flop (didn't bet)
Seat 5: Grilo9 folded before Flop (didn't bet)
Seat 6: Manuxanxe78 folded before Flop (didn't bet)



PokerStars Zoom Hand #257563762899:  Hold'em No Limit (€0.01/€0.02) - 2025/08/31 23:26:51 CET [2025/08/31 17:26:51 ET]
Table 'Arneb' 6-max Seat #1 is the button
Seat 1: sambupkr (€3.68 in chips) 
Seat 2: marcosbalsaa (€1.94 in chips) 
Seat 3: Belezaso21 (€1.81 in chips) 
Seat 4: pipinoelbreve9 (€3.88 in chips) 
Seat 5: correcamiños (€2.25 in chips) 
Seat 6: RichyPozo (€2.73 in chips) 
marcosbalsaa: posts small blind €0.01
Belezaso21: posts big blind €0.02
*** HOLE CARDS ***
Dealt to pipinoelbreve9 [6h Ac]
pipinoelbreve9: folds 
correcamiños: folds 
RichyPozo: folds 
sambupkr: raises €0.04 to €0.06
marcosbalsaa: folds 
Belezaso21: calls €0.04
*** FLOP *** [4c 3d 8h]
Belezaso21: bets €0.06
sambupkr: folds 
Uncalled bet (€0.06) returned to Belezaso21
Belezaso21 collected €0.12 from pot
Belezaso21: doesn't show hand 
*** SUMMARY ***
Total pot €0.13 | Rake €0.01 
Board [4c 3d 8h]
Seat 1: sambupkr (button) folded on the Flop
Seat 2: marcosbalsaa (small blind) folded before Flop
Seat 3: Belezaso21 (big blind) collected (€0.12)
Seat 4: pipinoelbreve9 folded before Flop (didn't bet)
Seat 5: correcamiños folded before Flop (didn't bet)
Seat 6: RichyPozo folded before Flop (didn't bet)



PokerStars Zoom Hand #257563770752:  Hold'em No Limit (€0.01/€0.02) - 2025/08/31 23:27:18 CET [2025/08/31 17:27:18 ET]
Table 'Arneb' 6-max Seat #1 is the button
Seat 1: nyko2a (€1.95 in chips) 
Seat 2: pipinoelbreve9 (€3.86 in chips) 
Seat 3: PkBcN15 (€2.02 in chips) 
Seat 4: lilpapayaa (€0.50 in chips) 
Seat 5: wilbor123 (€2 in chips) 
Seat 6: Manuxanxe78 (€2.85 in chips) 
pipinoelbreve9: posts small blind €0.01
PkBcN15: posts big blind €0.02
*** HOLE CARDS ***
Dealt to pipinoelbreve9 [6h 8s]
lilpapayaa: raises €0.04 to €0.06
wilbor123: calls €0.06
Manuxanxe78: folds 
nyko2a: folds 
pipinoelbreve9: folds 
PkBcN15: folds 
*** FLOP *** [9c As 4c]
lilpapayaa: bets €0.07
wilbor123: folds 
Uncalled bet (€0.07) returned to lilpapayaa
lilpapayaa collected €0.14 from pot
lilpapayaa: doesn't show hand 
*** SUMMARY ***
Total pot €0.15 | Rake €0.01 
Board [9c As 4c]
Seat 1: nyko2a (button) folded before Flop (didn't bet)
Seat 2: pipinoelbreve9 (small blind) folded before Flop
Seat 3: PkBcN15 (big blind) folded before Flop
Seat 4: lilpapayaa collected (€0.14)
Seat 5: wilbor123 folded on the Flop
Seat 6: Manuxanxe78 folded before Flop (didn't bet)



PokerStars Zoom Hand #257563772576:  Hold'em No Limit (€0.01/€0.02) - 2025/08/31 23:27:25 CET [2025/08/31 17:27:25 ET]
Table 'Arneb' 6-max Seat #1 is the button
Seat 1: Grilo9 (€2.20 in chips) 
Seat 2: Mai SA135 (€4.60 in chips) 
Seat 3: minisusy (€2 in chips) 
Seat 4: jvilela007 (€2.55 in chips) 
Seat 5: pipinoelbreve9 (€3.85 in chips) 
Seat 6: Diamondsdogs (€2 in chips) 
Mai SA135: posts small blind €0.01
minisusy: posts big blind €0.02
*** HOLE CARDS ***
Dealt to pipinoelbreve9 [Jc Ts]
jvilela007: folds 
pipinoelbreve9: raises €0.04 to €0.06
Diamondsdogs: folds 
Grilo9: calls €0.06
Mai SA135: folds 
minisusy: folds 
*** FLOP *** [Qd 7c 3s]
pipinoelbreve9: checks 
Grilo9: checks 
*** TURN *** [Qd 7c 3s] [7h]
pipinoelbreve9: checks 
Grilo9: checks 
*** RIVER *** [Qd 7c 3s 7h] [Kh]
pipinoelbreve9: checks 
Grilo9: checks 
*** SHOW DOWN ***
pipinoelbreve9: shows [Jc Ts] (a pair of Sevens)
Grilo9: shows [Td Ad] (a pair of Sevens - Ace kicker)
Grilo9 collected €0.14 from pot
*** SUMMARY ***
Total pot €0.15 | Rake €0.01 
Board [Qd 7c 3s 7h Kh]
Seat 1: Grilo9 (button) showed [Td Ad] and won (€0.14) with a pair of Sevens
Seat 2: Mai SA135 (small blind) folded before Flop
Seat 3: minisusy (big blind) folded before Flop
Seat 4: jvilela007 folded before Flop (didn't bet)
Seat 5: pipinoelbreve9 showed [Jc Ts] and lost with a pair of Sevens
Seat 6: Diamondsdogs folded before Flop (didn't bet)



PokerStars Zoom Hand #257563766942:  Hold'em No Limit (€0.01/€0.02) - 2025/08/31 23:27:05 CET [2025/08/31 17:27:05 ET]
Table 'Arneb' 6-max Seat #1 is the button
Seat 1: sambupkr (€5.18 in chips) 
Seat 2: vinipats83 (€2.37 in chips) 
Seat 3: nyko2a (€1.71 in chips) 
Seat 4: wilbor123 (€2.18 in chips) 
Seat 5: ecuinas (€2.80 in chips) 
Seat 6: pipinoelbreve9 (€3.88 in chips) 
vinipats83: posts small blind €0.01
nyko2a: posts big blind €0.02
*** HOLE CARDS ***
Dealt to pipinoelbreve9 [Jc 4c]
wilbor123: folds 
ecuinas: raises €0.04 to €0.06
pipinoelbreve9: folds 
sambupkr: folds 
vinipats83: calls €0.05
nyko2a: raises €0.15 to €0.21
ecuinas: folds 
vinipats83: calls €0.15
*** FLOP *** [Th 5c Jd]
vinipats83: checks 
nyko2a: bets €0.19
vinipats83: calls €0.19
*** TURN *** [Th 5c Jd] [As]
vinipats83: checks 
nyko2a: bets €0.31
vinipats83: raises €1.66 to €1.97 and is all-in
nyko2a: folds 
Uncalled bet (€1.66) returned to vinipats83
vinipats83 collected €1.41 from pot
vinipats83: doesn't show hand 
*** SUMMARY ***
Total pot €1.48 | Rake €0.07 
Board [Th 5c Jd As]
Seat 1: sambupkr (button) folded before Flop (didn't bet)
Seat 2: vinipats83 (small blind) collected (€1.41)
Seat 3: nyko2a (big blind) folded on the Turn
Seat 4: wilbor123 folded before Flop (didn't bet)
Seat 5: ecuinas folded before Flop
Seat 6: pipinoelbreve9 folded before Flop (didn't bet)



PokerStars Zoom Hand #257563782275:  Hold'em No Limit (€0.01/€0.02) - 2025/08/31 23:27:58 CET [2025/08/31 17:27:58 ET]
Table 'Arneb' 6-max Seat #1 is the button
Seat 1: pipinoelbreve9 (€3.79 in chips) 
Seat 2: tijolon (€2.01 in chips) 
Seat 3: chelasd91 (€1.22 in chips) 
Seat 4: RCSA2 (€3.76 in chips) 
Seat 5: lopo1187 (€2.02 in chips) 
Seat 6: Grilo9 (€2.28 in chips) 
tijolon: posts small blind €0.01
chelasd91: posts big blind €0.02
*** HOLE CARDS ***
Dealt to pipinoelbreve9 [5d Ks]
RCSA2: folds 
lopo1187: folds 
Grilo9: folds 
pipinoelbreve9: raises €0.04 to €0.06
tijolon: folds 
chelasd91: calls €0.04
*** FLOP *** [Js 5c 2s]
chelasd91: checks 
pipinoelbreve9: bets €0.06
chelasd91: raises €0.06 to €0.12
pipinoelbreve9: calls €0.06
*** TURN *** [Js 5c 2s] [9d]
chelasd91: checks 
pipinoelbreve9: checks 
*** RIVER *** [Js 5c 2s 9d] [7h]
chelasd91: bets €0.42
pipinoelbreve9: folds 
Uncalled bet (€0.42) returned to chelasd91
chelasd91 collected €0.35 from pot
chelasd91: doesn't show hand 
*** SUMMARY ***
Total pot €0.37 | Rake €0.02 
Board [Js 5c 2s 9d 7h]
Seat 1: pipinoelbreve9 (button) folded on the River
Seat 2: tijolon (small blind) folded before Flop
Seat 3: chelasd91 (big blind) collected (€0.35)
Seat 4: RCSA2 folded before Flop (didn't bet)
Seat 5: lopo1187 folded before Flop (didn't bet)
Seat 6: Grilo9 folded before Flop (didn't bet)



PokerStars Zoom Hand #257563792556:  Hold'em No Limit (€0.01/€0.02) - 2025/08/31 23:28:34 CET [2025/08/31 17:28:34 ET]
Table 'Arneb' 6-max Seat #1 is the button
Seat 1: winie66 (€3.92 in chips) 
Seat 2: Strlen83 (€2.33 in chips) 
Seat 3: correcamiños (€3.94 in chips) 
Seat 4: pipinoelbreve9 (€3.61 in chips) 
Seat 5: lopo1187 (€2 in chips) 
Seat 6: XTNMLP (€1.67 in chips) 
Strlen83: posts small blind €0.01
correcamiños: posts big blind €0.02
*** HOLE CARDS ***
Dealt to pipinoelbreve9 [3h 8c]
pipinoelbreve9: folds 
lopo1187: folds 
XTNMLP: folds 
winie66: folds 
Strlen83: folds 
Uncalled bet (€0.01) returned to correcamiños
correcamiños collected €0.02 from pot
correcamiños: doesn't show hand 
*** SUMMARY ***
Total pot €0.02 | Rake €0 
Seat 1: winie66 (button) folded before Flop (didn't bet)
Seat 2: Strlen83 (small blind) folded before Flop
Seat 3: correcamiños (big blind) collected (€0.02)
Seat 4: pipinoelbreve9 folded before Flop (didn't bet)
Seat 5: lopo1187 folded before Flop (didn't bet)
Seat 6: XTNMLP folded before Flop (didn't bet)



PokerStars Zoom Hand #257563793616:  Hold'em No Limit (€0.01/€0.02) - 2025/08/31 23:28:37 CET [2025/08/31 17:28:37 ET]
Table 'Arneb' 6-max Seat #1 is the button
Seat 1: vinipats83 (€3.05 in chips) 
Seat 2: lopo1187 (€2.08 in chips) 
Seat 3: PkBcN15 (€2.02 in chips) 
Seat 4: trinityandme (€1.21 in chips) 
Seat 5: pipinoelbreve9 (€3.61 in chips) 
Seat 6: nyko2a (€2.46 in chips) 
lopo1187: posts small blind €0.01
PkBcN15: posts big blind €0.02
*** HOLE CARDS ***
Dealt to pipinoelbreve9 [Td 4s]
trinityandme: folds 
pipinoelbreve9: folds 
nyko2a: raises €0.04 to €0.06
vinipats83: folds 
lopo1187: folds 
PkBcN15: folds 
Uncalled bet (€0.04) returned to nyko2a
nyko2a collected €0.05 from pot
nyko2a: doesn't show hand 
*** SUMMARY ***
Total pot €0.05 | Rake €0 
Seat 1: vinipats83 (button) folded before Flop (didn't bet)
Seat 2: lopo1187 (small blind) folded before Flop
Seat 3: PkBcN15 (big blind) folded before Flop
Seat 4: trinityandme folded before Flop (didn't bet)
Seat 5: pipinoelbreve9 folded before Flop (didn't bet)
Seat 6: nyko2a collected (€0.05)



PokerStars Zoom Hand #257563794734:  Hold'em No Limit (€0.01/€0.02) - 2025/08/31 23:28:41 CET [2025/08/31 17:28:41 ET]
Table 'Arneb' 6-max Seat #1 is the button
Seat 1: ZoasHein (€5.85 in chips) 
Seat 2: ecuinas (€2.48 in chips) 
Seat 3: pipinoelbreve9 (€3.61 in chips) 
Seat 4: kurikutela53 (€0.62 in chips) 
Seat 5: tanoun1 (€5.89 in chips) 
Seat 6: Manuxanxe78 (€2.17 in chips) 
ecuinas: posts small blind €0.01
pipinoelbreve9: posts big blind €0.02
*** HOLE CARDS ***
Dealt to pipinoelbreve9 [Jc 9h]
kurikutela53: folds 
tanoun1: raises €0.03 to €0.05
Manuxanxe78: folds 
ZoasHein: calls €0.05
ecuinas: calls €0.04
pipinoelbreve9: calls €0.03
*** FLOP *** [3s Js Tc]
ecuinas: checks 
pipinoelbreve9: bets €0.12
tanoun1: calls €0.12
ZoasHein: folds 
ecuinas: calls €0.12
*** TURN *** [3s Js Tc] [2h]
ecuinas: checks 
pipinoelbreve9: checks 
tanoun1: bets €0.53
ecuinas: folds 
pipinoelbreve9: calls €0.53
*** RIVER *** [3s Js Tc 2h] [8c]
pipinoelbreve9: checks 
tanoun1: checks 
*** SHOW DOWN ***
pipinoelbreve9: shows [Jc 9h] (a pair of Jacks)
tanoun1: mucks hand 
pipinoelbreve9 collected €1.54 from pot
*** SUMMARY ***
Total pot €1.62 | Rake €0.08 
Board [3s Js Tc 2h 8c]
Seat 1: ZoasHein (button) folded on the Flop
Seat 2: ecuinas (small blind) folded on the Turn
Seat 3: pipinoelbreve9 (big blind) showed [Jc 9h] and won (€1.54) with a pair of Jacks
Seat 4: kurikutela53 folded before Flop (didn't bet)
Seat 5: tanoun1 mucked [Ks Ts]
Seat 6: Manuxanxe78 folded before Flop (didn't bet)



PokerStars Zoom Hand #257563819190:  Hold'em No Limit (€0.01/€0.02) - 2025/08/31 23:30:06 CET [2025/08/31 17:30:06 ET]
Table 'Arneb' 6-max Seat #1 is the button
Seat 1: correcamiños (€4.09 in chips) 
Seat 2: lilpapayaa (€0.71 in chips) 
Seat 3: MATADOR473 (€2.06 in chips) 
Seat 4: jvilela007 (€2.52 in chips) 
Seat 5: Grilo9 (€2 in chips) 
Seat 6: pipinoelbreve9 (€4.45 in chips) 
lilpapayaa: posts small blind €0.01
MATADOR473: posts big blind €0.02
*** HOLE CARDS ***
Dealt to pipinoelbreve9 [Ts 7d]
jvilela007: folds 
Grilo9: folds 
pipinoelbreve9: folds 
correcamiños: raises €0.04 to €0.06
lilpapayaa: folds 
MATADOR473: folds 
Uncalled bet (€0.04) returned to correcamiños
correcamiños collected €0.05 from pot
correcamiños: doesn't show hand 
*** SUMMARY ***
Total pot €0.05 | Rake €0 
Seat 1: correcamiños (button) collected (€0.05)
Seat 2: lilpapayaa (small blind) folded before Flop
Seat 3: MATADOR473 (big blind) folded before Flop
Seat 4: jvilela007 folded before Flop (didn't bet)
Seat 5: Grilo9 folded before Flop (didn't bet)
Seat 6: pipinoelbreve9 folded before Flop (didn't bet)



PokerStars Zoom Hand #257563820441:  Hold'em No Limit (€0.01/€0.02) - 2025/08/31 23:30:10 CET [2025/08/31 17:30:10 ET]
Table 'Arneb' 6-max Seat #1 is the button
Seat 1: trinityandme (€1.18 in chips) 
Seat 2: pipinoelbreve9 (€4.45 in chips) 
Seat 3: Manuxanxe78 (€2.13 in chips) 
Seat 4: LuisGR90 (€2 in chips) 
Seat 5: lopo1187 (€2.18 in chips) 
Seat 6: 28chan28 (€5.02 in chips) 
pipinoelbreve9: posts small blind €0.01
Manuxanxe78: posts big blind €0.02
*** HOLE CARDS ***
Dealt to pipinoelbreve9 [Tc Jc]
LuisGR90: raises €0.04 to €0.06
lopo1187: folds 
28chan28: folds 
trinityandme: folds 
pipinoelbreve9: calls €0.05
Manuxanxe78: folds 
*** FLOP *** [Ks 2c Qs]
pipinoelbreve9: checks 
LuisGR90: bets €0.04
pipinoelbreve9: calls €0.04
*** TURN *** [Ks 2c Qs] [Th]
pipinoelbreve9: checks 
LuisGR90: checks 
*** RIVER *** [Ks 2c Qs Th] [4h]
pipinoelbreve9: checks 
LuisGR90: bets €0.15
pipinoelbreve9: calls €0.15
*** SHOW DOWN ***
LuisGR90: shows [8h 9h] (high card King)
pipinoelbreve9: shows [Tc Jc] (a pair of Tens)
pipinoelbreve9 collected €0.49 from pot
*** SUMMARY ***
Total pot €0.52 | Rake €0.03 
Board [Ks 2c Qs Th 4h]
Seat 1: trinityandme (button) folded before Flop (didn't bet)
Seat 2: pipinoelbreve9 (small blind) showed [Tc Jc] and won (€0.49) with a pair of Tens
Seat 3: Manuxanxe78 (big blind) folded before Flop
Seat 4: LuisGR90 showed [8h 9h] and lost with high card King
Seat 5: lopo1187 folded before Flop (didn't bet)
Seat 6: 28chan28 folded before Flop (didn't bet)



PokerStars Zoom Hand #257563831965:  Hold'em No Limit (€0.01/€0.02) - 2025/08/31 23:30:50 CET [2025/08/31 17:30:50 ET]
Table 'Arneb' 6-max Seat #1 is the button
Seat 1: RCSA2 (€4.28 in chips) 
Seat 2: correcamiños (€2.98 in chips) 
Seat 3: Belezaso21 (€1 in chips) 
Seat 4: pipinoelbreve9 (€4.69 in chips) 
Seat 5: wilbor123 (€2.10 in chips) 
Seat 6: minisusy (€2.16 in chips) 
correcamiños: posts small blind €0.01
Belezaso21: posts big blind €0.02
*** HOLE CARDS ***
Dealt to pipinoelbreve9 [As Jh]
pipinoelbreve9: raises €0.04 to €0.06
wilbor123: folds 
minisusy: folds 
RCSA2: folds 
correcamiños: folds 
Belezaso21: calls €0.04
*** FLOP *** [Ac Ad Tc]
Belezaso21: checks 
pipinoelbreve9: bets €0.06
Belezaso21: calls €0.06
*** TURN *** [Ac Ad Tc] [Qh]
Belezaso21: bets €0.06
pipinoelbreve9: raises €0.18 to €0.24
Belezaso21: folds 
Uncalled bet (€0.18) returned to pipinoelbreve9
pipinoelbreve9 collected €0.35 from pot
pipinoelbreve9: doesn't show hand 
*** SUMMARY ***
Total pot €0.37 | Rake €0.02 
Board [Ac Ad Tc Qh]
Seat 1: RCSA2 (button) folded before Flop (didn't bet)
Seat 2: correcamiños (small blind) folded before Flop
Seat 3: Belezaso21 (big blind) folded on the Turn
Seat 4: pipinoelbreve9 collected (€0.35)
Seat 5: wilbor123 folded before Flop (didn't bet)
Seat 6: minisusy folded before Flop (didn't bet)



PokerStars Zoom Hand #257563847761:  Hold'em No Limit (€0.01/€0.02) - 2025/08/31 23:31:44 CET [2025/08/31 17:31:44 ET]
Table 'Arneb' 6-max Seat #1 is the button
Seat 1: adriaflores (€2.09 in chips) 
Seat 2: LuisGR90 (€2.17 in chips) 
Seat 3: lopo1187 (€2.10 in chips) 
Seat 4: pipinoelbreve9 (€4.86 in chips) 
Seat 5: RCSA2 (€3.26 in chips) 
Seat 6: minisusy (€2.16 in chips) 
LuisGR90: posts small blind €0.01
lopo1187: posts big blind €0.02
*** HOLE CARDS ***
Dealt to pipinoelbreve9 [7s Qc]
pipinoelbreve9: folds 
RCSA2: folds 
minisusy: folds 
adriaflores: raises €0.02 to €0.04
LuisGR90: folds 
lopo1187: folds 
Uncalled bet (€0.02) returned to adriaflores
adriaflores collected €0.05 from pot
adriaflores: doesn't show hand 
*** SUMMARY ***
Total pot €0.05 | Rake €0 
Seat 1: adriaflores (button) collected (€0.05)
Seat 2: LuisGR90 (small blind) folded before Flop
Seat 3: lopo1187 (big blind) folded before Flop
Seat 4: pipinoelbreve9 folded before Flop (didn't bet)
Seat 5: RCSA2 folded before Flop (didn't bet)
Seat 6: minisusy folded before Flop (didn't bet)



PokerStars Zoom Hand #257563851054:  Hold'em No Limit (€0.01/€0.02) - 2025/08/31 23:31:55 CET [2025/08/31 17:31:55 ET]
Table 'Arneb' 6-max Seat #1 is the button
Seat 1: pipinoelbreve9 (€4.86 in chips) 
Seat 2: Bhorch (€2.16 in chips) 
Seat 3: LuisGR90 (€2.16 in chips) 
Seat 4: Bestiote (€0.30 in chips) 
Seat 5: tanoun1 (€5.28 in chips) 
Seat 6: Grilo9 (€3.96 in chips) 
Bhorch: posts small blind €0.01
LuisGR90: posts big blind €0.02
*** HOLE CARDS ***
Dealt to pipinoelbreve9 [Ac Kc]
Bestiote: folds 
tanoun1: folds 
Grilo9: folds 
pipinoelbreve9: raises €0.04 to €0.06
Bhorch: calls €0.05
LuisGR90: folds 
*** FLOP *** [Kd Qd Jd]
Bhorch: bets €0.02
pipinoelbreve9: calls €0.02
*** TURN *** [Kd Qd Jd] [Qs]
Bhorch: checks 
pipinoelbreve9: checks 
*** RIVER *** [Kd Qd Jd Qs] [8h]
Bhorch: bets €0.17
pipinoelbreve9: calls €0.17
*** SHOW DOWN ***
Bhorch: shows [9d Td] (a straight flush, Nine to King)
pipinoelbreve9: mucks hand 
Bhorch collected €0.49 from pot
*** SUMMARY ***
Total pot €0.52 | Rake €0.03 
Board [Kd Qd Jd Qs 8h]
Seat 1: pipinoelbreve9 (button) mucked [Ac Kc]
Seat 2: Bhorch (small blind) showed [9d Td] and won (€0.49) with a straight flush, Nine to King
Seat 3: LuisGR90 (big blind) folded before Flop
Seat 4: Bestiote folded before Flop (didn't bet)
Seat 5: tanoun1 folded before Flop (didn't bet)
Seat 6: Grilo9 folded before Flop (didn't bet)



PokerStars Zoom Hand #257563862572:  Hold'em No Limit (€0.01/€0.02) - 2025/08/31 23:32:36 CET [2025/08/31 17:32:36 ET]
Table 'Arneb' 6-max Seat #1 is the button
Seat 1: Grilo9 (€3.44 in chips) 
Seat 2: pipinoelbreve9 (€4.61 in chips) 
Seat 3: nyko2a (€2.21 in chips) 
Seat 4: Phenon33 (€1.32 in chips) 
Seat 5: RCSA2 (€2.95 in chips) 
Seat 6: Manuxanxe78 (€2.05 in chips) 
pipinoelbreve9: posts small blind €0.01
nyko2a: posts big blind €0.02
*** HOLE CARDS ***
Dealt to pipinoelbreve9 [Ks Qc]
Phenon33: calls €0.02
RCSA2: folds 
Manuxanxe78: folds 
Grilo9: folds 
pipinoelbreve9: raises €0.04 to €0.06
nyko2a: folds 
Phenon33: calls €0.04
*** FLOP *** [2d 7h 6s]
pipinoelbreve9: checks 
Phenon33: checks 
*** TURN *** [2d 7h 6s] [2s]
pipinoelbreve9: checks 
Phenon33: bets €0.07
pipinoelbreve9: folds 
Uncalled bet (€0.07) returned to Phenon33
Phenon33 collected €0.13 from pot
Phenon33: doesn't show hand 
*** SUMMARY ***
Total pot €0.14 | Rake €0.01 
Board [2d 7h 6s 2s]
Seat 1: Grilo9 (button) folded before Flop (didn't bet)
Seat 2: pipinoelbreve9 (small blind) folded on the Turn
Seat 3: nyko2a (big blind) folded before Flop
Seat 4: Phenon33 collected (€0.13)
Seat 5: RCSA2 folded before Flop (didn't bet)
Seat 6: Manuxanxe78 folded before Flop (didn't bet)



PokerStars Zoom Hand #257563871195:  Hold'em No Limit (€0.01/€0.02) - 2025/08/31 23:33:06 CET [2025/08/31 17:33:06 ET]
Table 'Arneb' 6-max Seat #1 is the button
Seat 1: minisusy (€1.69 in chips) 
Seat 2: PavoN_PT (€1.94 in chips) 
Seat 3: pipinoelbreve9 (€4.55 in chips) 
Seat 4: dimag444 (€2 in chips) 
Seat 5: LuisGR90 (€2.66 in chips) 
Seat 6: RCSA2 (€3.28 in chips) 
PavoN_PT: posts small blind €0.01
pipinoelbreve9: posts big blind €0.02
*** HOLE CARDS ***
Dealt to pipinoelbreve9 [8s Th]
dimag444: raises €0.02 to €0.04
LuisGR90: folds 
RCSA2: folds 
minisusy: folds 
PavoN_PT: folds 
pipinoelbreve9: folds 
Uncalled bet (€0.02) returned to dimag444
dimag444 collected €0.05 from pot
dimag444: doesn't show hand 
*** SUMMARY ***
Total pot €0.05 | Rake €0 
Seat 1: minisusy (button) folded before Flop (didn't bet)
Seat 2: PavoN_PT (small blind) folded before Flop
Seat 3: pipinoelbreve9 (big blind) folded before Flop
Seat 4: dimag444 collected (€0.05)
Seat 5: LuisGR90 folded before Flop (didn't bet)
Seat 6: RCSA2 folded before Flop (didn't bet)



PokerStars Zoom Hand #257563874542:  Hold'em No Limit (€0.01/€0.02) - 2025/08/31 23:33:18 CET [2025/08/31 17:33:18 ET]
Table 'Arneb' 6-max Seat #1 is the button
Seat 1: tanoun1 (€7.76 in chips) 
Seat 2: Phenon33 (€1.37 in chips) 
Seat 3: lopo1187 (€2.03 in chips) 
Seat 4: LuisGR90 (€2.39 in chips) 
Seat 5: pipinoelbreve9 (€4.53 in chips) 
Seat 6: wilbor123 (€3.61 in chips) 
Phenon33: posts small blind €0.01
lopo1187: posts big blind €0.02
*** HOLE CARDS ***
Dealt to pipinoelbreve9 [5c 7h]
LuisGR90: folds 
pipinoelbreve9: folds 
wilbor123: folds 
tanoun1: folds 
Phenon33: calls €0.01
lopo1187: checks 
*** FLOP *** [8h 3s Qd]
Phenon33: bets €0.02
lopo1187: folds 
Uncalled bet (€0.02) returned to Phenon33
Phenon33 collected €0.04 from pot
Phenon33: doesn't show hand 
*** SUMMARY ***
Total pot €0.04 | Rake €0 
Board [8h 3s Qd]
Seat 1: tanoun1 (button) folded before Flop (didn't bet)
Seat 2: Phenon33 (small blind) collected (€0.04)
Seat 3: lopo1187 (big blind) folded on the Flop
Seat 4: LuisGR90 folded before Flop (didn't bet)
Seat 5: pipinoelbreve9 folded before Flop (didn't bet)
Seat 6: wilbor123 folded before Flop (didn't bet)



PokerStars Zoom Hand #257563875874:  Hold'em No Limit (€0.01/€0.02) - 2025/08/31 23:33:23 CET [2025/08/31 17:33:23 ET]
Table 'Arneb' 6-max Seat #1 is the button
Seat 1: Manuxanxe78 (€2 in chips) 
Seat 2: RCSA2 (€3.26 in chips) 
Seat 3: LuisGR90 (€2.39 in chips) 
Seat 4: pipinoelbreve9 (€4.53 in chips) 
Seat 5: NazaSilva (€0.89 in chips) 
Seat 6: charlie67100 (€3.25 in chips) 
RCSA2: posts small blind €0.01
LuisGR90: posts big blind €0.02
*** HOLE CARDS ***
Dealt to pipinoelbreve9 [Jh 4h]
pipinoelbreve9: folds 
NazaSilva: folds 
charlie67100: folds 
Manuxanxe78: folds 
RCSA2: raises €0.12 to €0.14
LuisGR90: folds 
Uncalled bet (€0.12) returned to RCSA2
RCSA2 collected €0.04 from pot
RCSA2: doesn't show hand 
*** SUMMARY ***
Total pot €0.04 | Rake €0 
Seat 1: Manuxanxe78 (button) folded before Flop (didn't bet)
Seat 2: RCSA2 (small blind) collected (€0.04)
Seat 3: LuisGR90 (big blind) folded before Flop
Seat 4: pipinoelbreve9 folded before Flop (didn't bet)
Seat 5: NazaSilva folded before Flop (didn't bet)
Seat 6: charlie67100 folded before Flop (didn't bet)



PokerStars Zoom Hand #257563877039:  Hold'em No Limit (€0.01/€0.02) - 2025/08/31 23:33:27 CET [2025/08/31 17:33:27 ET]
Table 'Arneb' 6-max Seat #1 is the button
Seat 1: LuisGR90 (€2.03 in chips) 
Seat 2: Manuxanxe78 (€2.03 in chips) 
Seat 3: italiano125 (€2.04 in chips) 
Seat 4: pipinoelbreve9 (€4.53 in chips) 
Seat 5: Bhorch (€2.80 in chips) 
Seat 6: minisusy (€1.70 in chips) 
Manuxanxe78: posts small blind €0.01
italiano125: posts big blind €0.02
*** HOLE CARDS ***
Dealt to pipinoelbreve9 [6d 9c]
pipinoelbreve9: folds 
Bhorch: calls €0.02
minisusy: folds 
LuisGR90: folds 
Manuxanxe78: folds 
italiano125: checks 
*** FLOP *** [9h Kh Ts]
italiano125: checks 
Bhorch: bets €0.02
italiano125: folds 
Uncalled bet (€0.02) returned to Bhorch
Bhorch collected €0.05 from pot
Bhorch: doesn't show hand 
*** SUMMARY ***
Total pot €0.05 | Rake €0 
Board [9h Kh Ts]
Seat 1: LuisGR90 (button) folded before Flop (didn't bet)
Seat 2: Manuxanxe78 (small blind) folded before Flop
Seat 3: italiano125 (big blind) folded on the Flop
Seat 4: pipinoelbreve9 folded before Flop (didn't bet)
Seat 5: Bhorch collected (€0.05)
Seat 6: minisusy folded before Flop (didn't bet)



PokerStars Zoom Hand #257563873329:  Hold'em No Limit (€0.01/€0.02) - 2025/08/31 23:33:14 CET [2025/08/31 17:33:14 ET]
Table 'Arneb' 6-max Seat #1 is the button
Seat 1: Jah2U (€0.56 in chips) 
Seat 2: lopo1187 (€2.04 in chips) 
Seat 3: chelasd91 (€1.43 in chips) 
Seat 4: tanoun1 (€7.76 in chips) 
Seat 5: Strlen83 (€2.07 in chips) 
Seat 6: pipinoelbreve9 (€4.53 in chips) 
lopo1187: posts small blind €0.01
chelasd91: posts big blind €0.02
*** HOLE CARDS ***
Dealt to pipinoelbreve9 [6c Th]
tanoun1: folds 
Strlen83: raises €0.04 to €0.06
pipinoelbreve9: folds 
Jah2U: calls €0.06
lopo1187: folds 
chelasd91: raises €0.19 to €0.25
Strlen83: calls €0.19
Jah2U: folds 
*** FLOP *** [4d Jd 5h]
chelasd91: bets €0.27
Strlen83: calls €0.27
*** TURN *** [4d Jd 5h] [9h]
chelasd91: bets €0.53
Strlen83: folds 
Uncalled bet (€0.53) returned to chelasd91
chelasd91 collected €1.05 from pot
chelasd91: doesn't show hand 
*** SUMMARY ***
Total pot €1.11 | Rake €0.06 
Board [4d Jd 5h 9h]
Seat 1: Jah2U (button) folded before Flop
Seat 2: lopo1187 (small blind) folded before Flop
Seat 3: chelasd91 (big blind) collected (€1.05)
Seat 4: tanoun1 folded before Flop (didn't bet)
Seat 5: Strlen83 folded on the Turn
Seat 6: pipinoelbreve9 folded before Flop (didn't bet)



PokerStars Zoom Hand #257563878174:  Hold'em No Limit (€0.01/€0.02) - 2025/08/31 23:33:31 CET [2025/08/31 17:33:31 ET]
Table 'Arneb' 6-max Seat #1 is the button
Seat 1: Davidsancheez16 (€0.98 in chips) 
Seat 2: NazaSilva (€0.89 in chips) 
Seat 3: pipinoelbreve9 (€4.53 in chips) 
Seat 4: LuisGR90 (€2.03 in chips) 
Seat 5: dimag444 (€3.99 in chips) 
Seat 6: Strlen83 (€2.45 in chips) 
NazaSilva: posts small blind €0.01
pipinoelbreve9: posts big blind €0.02
*** HOLE CARDS ***
Dealt to pipinoelbreve9 [7c 3d]
NazaSilva is disconnected 
LuisGR90: folds 
dimag444: folds 
Strlen83: folds 
Davidsancheez16: folds 
NazaSilva has timed out while disconnected
NazaSilva: folds 
Uncalled bet (€0.01) returned to pipinoelbreve9
pipinoelbreve9 collected €0.02 from pot
pipinoelbreve9: doesn't show hand 
*** SUMMARY ***
Total pot €0.02 | Rake €0 
Seat 1: Davidsancheez16 (button) folded before Flop (didn't bet)
Seat 2: NazaSilva (small blind) folded before Flop
Seat 3: pipinoelbreve9 (big blind) collected (€0.02)
Seat 4: LuisGR90 folded before Flop (didn't bet)
Seat 5: dimag444 folded before Flop (didn't bet)
Seat 6: Strlen83 folded before Flop (didn't bet)



PokerStars Zoom Hand #257563885275:  Hold'em No Limit (€0.01/€0.02) - 2025/08/31 23:33:55 CET [2025/08/31 17:33:55 ET]
Table 'Arneb' 6-max Seat #1 is the button
Seat 1: winie66 (€1.17 in chips) 
Seat 2: pipinoelbreve9 (€4.54 in chips) 
Seat 3: Grilo9 (€2.12 in chips) 
Seat 4: kurikutela53 (€0.77 in chips) 
Seat 5: RichyPozo (€2 in chips) 
Seat 6: RCSA2 (€2.98 in chips) 
pipinoelbreve9: posts small blind €0.01
Grilo9: posts big blind €0.02
*** HOLE CARDS ***
Dealt to pipinoelbreve9 [2h 8s]
kurikutela53: raises €0.02 to €0.04
RichyPozo: folds 
RCSA2: folds 
winie66: folds 
pipinoelbreve9: folds 
Grilo9: folds 
Uncalled bet (€0.02) returned to kurikutela53
kurikutela53 collected €0.05 from pot
kurikutela53: doesn't show hand 
*** SUMMARY ***
Total pot €0.05 | Rake €0 
Seat 1: winie66 (button) folded before Flop (didn't bet)
Seat 2: pipinoelbreve9 (small blind) folded before Flop
Seat 3: Grilo9 (big blind) folded before Flop
Seat 4: kurikutela53 collected (€0.05)
Seat 5: RichyPozo folded before Flop (didn't bet)
Seat 6: RCSA2 folded before Flop (didn't bet)



PokerStars Zoom Hand #257563886258:  Hold'em No Limit (€0.01/€0.02) - 2025/08/31 23:33:59 CET [2025/08/31 17:33:59 ET]
Table 'Arneb' 6-max Seat #1 is the button
Seat 1: pipinoelbreve9 (€4.53 in chips) 
Seat 2: raptureman1 (€2.24 in chips) 
Seat 3: Freddy-G74 (€2 in chips) 
Seat 4: sambupkr (€3.62 in chips) 
Seat 5: nyko2a (€3.30 in chips) 
Seat 6: Strlen83 (€2.45 in chips) 
raptureman1: posts small blind €0.01
Freddy-G74: posts big blind €0.02
*** HOLE CARDS ***
Dealt to pipinoelbreve9 [Qh 8s]
sambupkr: folds 
nyko2a: folds 
Strlen83: folds 
pipinoelbreve9: raises €0.04 to €0.06
raptureman1: folds 
Freddy-G74: folds 
Uncalled bet (€0.04) returned to pipinoelbreve9
pipinoelbreve9 collected €0.05 from pot
pipinoelbreve9: doesn't show hand 
*** SUMMARY ***
Total pot €0.05 | Rake €0 
Seat 1: pipinoelbreve9 (button) collected (€0.05)
Seat 2: raptureman1 (small blind) folded before Flop
Seat 3: Freddy-G74 (big blind) folded before Flop
Seat 4: sambupkr folded before Flop (didn't bet)
Seat 5: nyko2a folded before Flop (didn't bet)
Seat 6: Strlen83 folded before Flop (didn't bet)



PokerStars Zoom Hand #257563891197:  Hold'em No Limit (€0.01/€0.02) - 2025/08/31 23:34:16 CET [2025/08/31 17:34:16 ET]
Table 'Arneb' 6-max Seat #1 is the button
Seat 1: Grilo9 (€3.38 in chips) 
Seat 2: correcamiños (€2.82 in chips) 
Seat 3: lopo1187 (€2.08 in chips) 
Seat 4: Freddy-G74 (€1.98 in chips) 
Seat 5: Sportacus911 (€2.22 in chips) 
Seat 6: pipinoelbreve9 (€4.56 in chips) 
correcamiños: posts small blind €0.01
lopo1187: posts big blind €0.02
*** HOLE CARDS ***
Dealt to pipinoelbreve9 [Qd Th]
Freddy-G74: calls €0.02
Sportacus911: folds 
pipinoelbreve9: raises €0.04 to €0.06
Grilo9: folds 
correcamiños: folds 
lopo1187: folds 
Freddy-G74: folds 
Uncalled bet (€0.04) returned to pipinoelbreve9
pipinoelbreve9 collected €0.07 from pot
pipinoelbreve9: doesn't show hand 
*** SUMMARY ***
Total pot €0.07 | Rake €0 
Seat 1: Grilo9 (button) folded before Flop (didn't bet)
Seat 2: correcamiños (small blind) folded before Flop
Seat 3: lopo1187 (big blind) folded before Flop
Seat 4: Freddy-G74 folded before Flop
Seat 5: Sportacus911 folded before Flop (didn't bet)
Seat 6: pipinoelbreve9 collected (€0.07)



PokerStars Zoom Hand #257563896143:  Hold'em No Limit (€0.01/€0.02) - 2025/08/31 23:34:33 CET [2025/08/31 17:34:33 ET]
Table 'Arneb' 6-max Seat #1 is the button
Seat 1: Strlen83 (€2.42 in chips) 
Seat 2: Grilo9 (€2.44 in chips) 
Seat 3: pipinoelbreve9 (€4.61 in chips) 
Seat 4: nyko2a (€2.35 in chips) 
Seat 5: ColonyStr (€1.08 in chips) 
Seat 6: batista362 (€2.03 in chips) 
Grilo9: posts small blind €0.01
pipinoelbreve9: posts big blind €0.02
*** HOLE CARDS ***
Dealt to pipinoelbreve9 [9d Qs]
nyko2a: folds 
ColonyStr: folds 
batista362: folds 
Strlen83: folds 
Grilo9: folds 
Uncalled bet (€0.01) returned to pipinoelbreve9
pipinoelbreve9 collected €0.02 from pot
pipinoelbreve9: doesn't show hand 
*** SUMMARY ***
Total pot €0.02 | Rake €0 
Seat 1: Strlen83 (button) folded before Flop (didn't bet)
Seat 2: Grilo9 (small blind) folded before Flop
Seat 3: pipinoelbreve9 (big blind) collected (€0.02)
Seat 4: nyko2a folded before Flop (didn't bet)
Seat 5: ColonyStr folded before Flop (didn't bet)
Seat 6: batista362 folded before Flop (didn't bet)



PokerStars Zoom Hand #257563901737:  Hold'em No Limit (€0.01/€0.02) - 2025/08/31 23:34:53 CET [2025/08/31 17:34:53 ET]
Table 'Arneb' 6-max Seat #1 is the button
Seat 1: Grilo9 (€2.07 in chips) 
Seat 2: pipinoelbreve9 (€4.62 in chips) 
Seat 3: RCSA2 (€3.24 in chips) 
Seat 4: sambupkr (€2.24 in chips) 
Seat 5: Mai SA135 (€2.51 in chips) 
Seat 6: GleQbenny (€3.03 in chips) 
pipinoelbreve9: posts small blind €0.01
RCSA2: posts big blind €0.02
*** HOLE CARDS ***
Dealt to pipinoelbreve9 [4d 9s]
sambupkr: folds 
Mai SA135: folds 
GleQbenny: raises €0.02 to €0.04
Grilo9: folds 
pipinoelbreve9: folds 
RCSA2: folds 
Uncalled bet (€0.02) returned to GleQbenny
GleQbenny collected €0.05 from pot
GleQbenny: doesn't show hand 
*** SUMMARY ***
Total pot €0.05 | Rake €0 
Seat 1: Grilo9 (button) folded before Flop (didn't bet)
Seat 2: pipinoelbreve9 (small blind) folded before Flop
Seat 3: RCSA2 (big blind) folded before Flop
Seat 4: sambupkr folded before Flop (didn't bet)
Seat 5: Mai SA135 folded before Flop (didn't bet)
Seat 6: GleQbenny collected (€0.05)



PokerStars Zoom Hand #257563902904:  Hold'em No Limit (€0.01/€0.02) - 2025/08/31 23:34:57 CET [2025/08/31 17:34:57 ET]
Table 'Arneb' 6-max Seat #1 is the button
Seat 1: sambupkr (€3.68 in chips) 
Seat 2: Grilo9 (€2.07 in chips) 
Seat 3: trinityandme (€1.03 in chips) 
Seat 4: dimag444 (€2.03 in chips) 
Seat 5: pipinoelbreve9 (€4.61 in chips) 
Seat 6: tanoun1 (€3.56 in chips) 
Grilo9: posts small blind €0.01
trinityandme: posts big blind €0.02
*** HOLE CARDS ***
Dealt to pipinoelbreve9 [5c 4d]
dimag444: folds 
pipinoelbreve9: folds 
tanoun1: folds 
sambupkr: folds 
Grilo9: folds 
Uncalled bet (€0.01) returned to trinityandme
trinityandme collected €0.02 from pot
trinityandme: doesn't show hand 
*** SUMMARY ***
Total pot €0.02 | Rake €0 
Seat 1: sambupkr (button) folded before Flop (didn't bet)
Seat 2: Grilo9 (small blind) folded before Flop
Seat 3: trinityandme (big blind) collected (€0.02)
Seat 4: dimag444 folded before Flop (didn't bet)
Seat 5: pipinoelbreve9 folded before Flop (didn't bet)
Seat 6: tanoun1 folded before Flop (didn't bet)



PokerStars Zoom Hand #257563904943:  Hold'em No Limit (€0.01/€0.02) - 2025/08/31 23:35:04 CET [2025/08/31 17:35:04 ET]
Table 'Arneb' 6-max Seat #1 is the button
Seat 1: PavoN_PT (€2.56 in chips) 
Seat 2: migulanyez (€1.39 in chips) 
Seat 3: 28chan28 (€4.38 in chips) 
Seat 4: correcamiños (€3.73 in chips) 
Seat 5: pipinoelbreve9 (€4.61 in chips) 
Seat 6: Grilo9 (€2.06 in chips) 
migulanyez: posts small blind €0.01
28chan28: posts big blind €0.02
*** HOLE CARDS ***
Dealt to pipinoelbreve9 [Kd 4h]
correcamiños: raises €0.04 to €0.06
pipinoelbreve9: folds 
Grilo9: folds 
PavoN_PT: folds 
migulanyez: folds 
28chan28: folds 
Uncalled bet (€0.04) returned to correcamiños
correcamiños collected €0.05 from pot
correcamiños: doesn't show hand 
*** SUMMARY ***
Total pot €0.05 | Rake €0 
Seat 1: PavoN_PT (button) folded before Flop (didn't bet)
Seat 2: migulanyez (small blind) folded before Flop
Seat 3: 28chan28 (big blind) folded before Flop
Seat 4: correcamiños collected (€0.05)
Seat 5: pipinoelbreve9 folded before Flop (didn't bet)
Seat 6: Grilo9 folded before Flop (didn't bet)



PokerStars Zoom Hand #257563899036:  Hold'em No Limit (€0.01/€0.02) - 2025/08/31 23:34:43 CET [2025/08/31 17:34:43 ET]
Table 'Arneb' 6-max Seat #1 is the button
Seat 1: pipinoelbreve9 (€4.62 in chips) 
Seat 2: felgas1968 (€6.80 in chips) 
Seat 3: dimag444 (€2.05 in chips) 
Seat 4: italiano125 (€2 in chips) 
Seat 5: tijolon (€2.55 in chips) 
Seat 6: wilbor123 (€3.12 in chips) 
felgas1968: posts small blind €0.01
dimag444: posts big blind €0.02
*** HOLE CARDS ***
Dealt to pipinoelbreve9 [4h Td]
italiano125: calls €0.02
tijolon: raises €0.07 to €0.09
wilbor123: folds 
pipinoelbreve9: folds 
felgas1968: calls €0.08
dimag444: folds 
italiano125: calls €0.07
*** FLOP *** [8s 6c Kc]
felgas1968: checks 
italiano125: checks 
tijolon: bets €0.20
felgas1968: folds 
italiano125: calls €0.20
*** TURN *** [8s 6c Kc] [7c]
italiano125: checks 
tijolon: checks 
*** RIVER *** [8s 6c Kc 7c] [6s]
italiano125: checks 
tijolon: checks 
*** SHOW DOWN ***
italiano125: shows [Ks Ts] (two pair, Kings and Sixes)
tijolon: mucks hand 
italiano125 collected €0.66 from pot
*** SUMMARY ***
Total pot €0.69 | Rake €0.03 
Board [8s 6c Kc 7c 6s]
Seat 1: pipinoelbreve9 (button) folded before Flop (didn't bet)
Seat 2: felgas1968 (small blind) folded on the Flop
Seat 3: dimag444 (big blind) folded before Flop
Seat 4: italiano125 showed [Ks Ts] and won (€0.66) with two pair, Kings and Sixes
Seat 5: tijolon mucked [3c 3h]
Seat 6: wilbor123 folded before Flop (didn't bet)



PokerStars Zoom Hand #257563911594:  Hold'em No Limit (€0.01/€0.02) - 2025/08/31 23:35:27 CET [2025/08/31 17:35:27 ET]
Table 'Arneb' 6-max Seat #1 is the button
Seat 1: pipinoelbreve9 (€4.61 in chips) 
Seat 2: pucelazo (€3.14 in chips) 
Seat 3: tanoun1 (€2.24 in chips) 
Seat 4: Manuxanxe78 (€2.05 in chips) 
Seat 5: Sportacus911 (€2.24 in chips) 
Seat 6: correcamiños (€2.51 in chips) 
pucelazo: posts small blind €0.01
tanoun1: posts big blind €0.02
*** HOLE CARDS ***
Dealt to pipinoelbreve9 [Ad 3h]
Manuxanxe78: folds 
Sportacus911: folds 
correcamiños: folds 
pipinoelbreve9: raises €0.04 to €0.06
pucelazo: folds 
tanoun1: folds 
Uncalled bet (€0.04) returned to pipinoelbreve9
pipinoelbreve9 collected €0.05 from pot
pipinoelbreve9: doesn't show hand 
*** SUMMARY ***
Total pot €0.05 | Rake €0 
Seat 1: pipinoelbreve9 (button) collected (€0.05)
Seat 2: pucelazo (small blind) folded before Flop
Seat 3: tanoun1 (big blind) folded before Flop
Seat 4: Manuxanxe78 folded before Flop (didn't bet)
Seat 5: Sportacus911 folded before Flop (didn't bet)
Seat 6: correcamiños folded before Flop (didn't bet)



PokerStars Zoom Hand #257563916677:  Hold'em No Limit (€0.01/€0.02) - 2025/08/31 23:35:45 CET [2025/08/31 17:35:45 ET]
Table 'Arneb' 6-max Seat #1 is the button
Seat 1: BancaRota33 (€2.45 in chips) 
Seat 2: LuisGR90 (€2.10 in chips) 
Seat 3: AceGurb (€2 in chips) 
Seat 4: Romeo22901 (€1.64 in chips) 
Seat 5: vinipats83 (€1.52 in chips) 
Seat 6: pipinoelbreve9 (€4.64 in chips) 
LuisGR90: posts small blind €0.01
AceGurb: posts big blind €0.02
*** HOLE CARDS ***
Dealt to pipinoelbreve9 [8h 8c]
Romeo22901: folds 
vinipats83: folds 
pipinoelbreve9: raises €0.04 to €0.06
BancaRota33: folds 
LuisGR90: raises €0.16 to €0.22
AceGurb: folds 
pipinoelbreve9: calls €0.16
*** FLOP *** [2d As 2h]
LuisGR90: bets €0.14
pipinoelbreve9: folds 
Uncalled bet (€0.14) returned to LuisGR90
LuisGR90 collected €0.44 from pot
LuisGR90: doesn't show hand 
*** SUMMARY ***
Total pot €0.46 | Rake €0.02 
Board [2d As 2h]
Seat 1: BancaRota33 (button) folded before Flop (didn't bet)
Seat 2: LuisGR90 (small blind) collected (€0.44)
Seat 3: AceGurb (big blind) folded before Flop
Seat 4: Romeo22901 folded before Flop (didn't bet)
Seat 5: vinipats83 folded before Flop (didn't bet)
Seat 6: pipinoelbreve9 folded on the Flop



PokerStars Zoom Hand #257563900010:  Hold'em No Limit (€0.01/€0.02) - 2025/08/31 23:34:47 CET [2025/08/31 17:34:47 ET]
Table 'Arneb' 6-max Seat #1 is the button
Seat 1: Belezaso21 (€0.78 in chips) 
Seat 2: pucelazo (€2.06 in chips) 
Seat 3: XTNMLP (€2.59 in chips) 
Seat 4: LuisGR90 (€2 in chips) 
Seat 5: Grilo9 (€3.41 in chips) 
Seat 6: pipinoelbreve9 (€4.62 in chips) 
pucelazo: posts small blind €0.01
XTNMLP: posts big blind €0.02
*** HOLE CARDS ***
Dealt to pipinoelbreve9 [9h Qd]
LuisGR90: folds 
Grilo9: raises €0.04 to €0.06
pipinoelbreve9: folds 
Belezaso21: calls €0.06
pucelazo: folds 
XTNMLP: calls €0.04
*** FLOP *** [Th Qh 7s]
XTNMLP: checks 
Grilo9: checks 
Belezaso21: bets €0.06
XTNMLP: calls €0.06
Grilo9: folds 
*** TURN *** [Th Qh 7s] [3d]
XTNMLP: bets €0.11
Belezaso21: calls €0.11
*** RIVER *** [Th Qh 7s 3d] [8s]
XTNMLP: checks 
Belezaso21: checks 
*** SHOW DOWN ***
XTNMLP: shows [Js Qs] (a pair of Queens)
Belezaso21: mucks hand 
XTNMLP collected €0.50 from pot
*** SUMMARY ***
Total pot €0.53 | Rake €0.03 
Board [Th Qh 7s 3d 8s]
Seat 1: Belezaso21 (button) mucked [Jc As]
Seat 2: pucelazo (small blind) folded before Flop
Seat 3: XTNMLP (big blind) showed [Js Qs] and won (€0.50) with a pair of Queens
Seat 4: LuisGR90 folded before Flop (didn't bet)
Seat 5: Grilo9 folded on the Flop
Seat 6: pipinoelbreve9 folded before Flop (didn't bet)



PokerStars Zoom Hand #257563928173:  Hold'em No Limit (€0.01/€0.02) - 2025/08/31 23:36:25 CET [2025/08/31 17:36:25 ET]
Table 'Arneb' 6-max Seat #1 is the button
Seat 1: MENDACANELO (€1.95 in chips) 
Seat 2: Manuxanxe78 (€2 in chips) 
Seat 3: pipinoelbreve9 (€4.42 in chips) 
Seat 4: winie66 (€1.16 in chips) 
Seat 5: pucelazo (€2.08 in chips) 
Seat 6: Grilo9 (€2.40 in chips) 
Manuxanxe78: posts small blind €0.01
pipinoelbreve9: posts big blind €0.02
*** HOLE CARDS ***
Dealt to pipinoelbreve9 [7h Kd]
winie66: folds 
pucelazo: folds 
Grilo9: folds 
MENDACANELO: folds 
Manuxanxe78: folds 
Uncalled bet (€0.01) returned to pipinoelbreve9
pipinoelbreve9 collected €0.02 from pot
pipinoelbreve9: doesn't show hand 
*** SUMMARY ***
Total pot €0.02 | Rake €0 
Seat 1: MENDACANELO (button) folded before Flop (didn't bet)
Seat 2: Manuxanxe78 (small blind) folded before Flop
Seat 3: pipinoelbreve9 (big blind) collected (€0.02)
Seat 4: winie66 folded before Flop (didn't bet)
Seat 5: pucelazo folded before Flop (didn't bet)
Seat 6: Grilo9 folded before Flop (didn't bet)



PokerStars Zoom Hand #257563932793:  Hold'em No Limit (€0.01/€0.02) - 2025/08/31 23:36:41 CET [2025/08/31 17:36:41 ET]
Table 'Arneb' 6-max Seat #1 is the button
Seat 1: ecuinas (€1.37 in chips) 
Seat 2: marcosbalsaa (€1.94 in chips) 
Seat 3: tijolon (€2.44 in chips) 
Seat 4: pipinoelbreve9 (€4.42 in chips) 
Seat 5: MENDACANELO (€1.94 in chips) 
Seat 6: Sportacus911 (€2.04 in chips) 
marcosbalsaa: posts small blind €0.01
tijolon: posts big blind €0.02
*** HOLE CARDS ***
Dealt to pipinoelbreve9 [2d 4d]
pipinoelbreve9: folds 
MENDACANELO: folds 
Sportacus911: folds 
ecuinas: raises €0.04 to €0.06
marcosbalsaa: folds 
tijolon: folds 
Uncalled bet (€0.04) returned to ecuinas
ecuinas collected €0.05 from pot
ecuinas: doesn't show hand 
*** SUMMARY ***
Total pot €0.05 | Rake €0 
Seat 1: ecuinas (button) collected (€0.05)
Seat 2: marcosbalsaa (small blind) folded before Flop
Seat 3: tijolon (big blind) folded before Flop
Seat 4: pipinoelbreve9 folded before Flop (didn't bet)
Seat 5: MENDACANELO folded before Flop (didn't bet)
Seat 6: Sportacus911 folded before Flop (didn't bet)



PokerStars Zoom Hand #257563931599:  Hold'em No Limit (€0.01/€0.02) - 2025/08/31 23:36:37 CET [2025/08/31 17:36:37 ET]
Table 'Arneb' 6-max Seat #1 is the button
Seat 1: felgas1968 (€6.76 in chips) 
Seat 2: BancaRota33 (€2.51 in chips) 
Seat 3: Manuxanxe78 (€2 in chips) 
Seat 4: pipinoelbreve9 (€4.42 in chips) 
Seat 5: Belezaso21 (€0.55 in chips) 
Seat 6: LuisGR90 (€2.04 in chips) 
BancaRota33: posts small blind €0.01
Manuxanxe78: posts big blind €0.02
*** HOLE CARDS ***
Dealt to pipinoelbreve9 [Jh 7c]
pipinoelbreve9: folds 
Belezaso21: folds 
LuisGR90: raises €0.04 to €0.06
felgas1968: folds 
BancaRota33: folds 
Manuxanxe78: folds 
Uncalled bet (€0.04) returned to LuisGR90
LuisGR90 collected €0.05 from pot
LuisGR90: doesn't show hand 
*** SUMMARY ***
Total pot €0.05 | Rake €0 
Seat 1: felgas1968 (button) folded before Flop (didn't bet)
Seat 2: BancaRota33 (small blind) folded before Flop
Seat 3: Manuxanxe78 (big blind) folded before Flop
Seat 4: pipinoelbreve9 folded before Flop (didn't bet)
Seat 5: Belezaso21 folded before Flop (didn't bet)
Seat 6: LuisGR90 collected (€0.05)



PokerStars Zoom Hand #257563933836:  Hold'em No Limit (€0.01/€0.02) - 2025/08/31 23:36:45 CET [2025/08/31 17:36:45 ET]
Table 'Arneb' 6-max Seat #1 is the button
Seat 1: lopo1187 (€2.10 in chips) 
Seat 2: minisusy (€1.53 in chips) 
Seat 3: XXXJAVIXXX14 (€1.93 in chips) 
Seat 4: RCSA2 (€3.02 in chips) 
Seat 5: pipinoelbreve9 (€4.42 in chips) 
Seat 6: Diamondsdogs (€2.50 in chips) 
minisusy: posts small blind €0.01
XXXJAVIXXX14: posts big blind €0.02
*** HOLE CARDS ***
Dealt to pipinoelbreve9 [Js 3h]
RCSA2: folds 
pipinoelbreve9: folds 
Diamondsdogs: raises €0.04 to €0.06
lopo1187: folds 
minisusy: folds 
XXXJAVIXXX14: folds 
Uncalled bet (€0.04) returned to Diamondsdogs
Diamondsdogs collected €0.05 from pot
Diamondsdogs: doesn't show hand 
*** SUMMARY ***
Total pot €0.05 | Rake €0 
Seat 1: lopo1187 (button) folded before Flop (didn't bet)
Seat 2: minisusy (small blind) folded before Flop
Seat 3: XXXJAVIXXX14 (big blind) folded before Flop
Seat 4: RCSA2 folded before Flop (didn't bet)
Seat 5: pipinoelbreve9 folded before Flop (didn't bet)
Seat 6: Diamondsdogs collected (€0.05)



PokerStars Zoom Hand #257563935573:  Hold'em No Limit (€0.01/€0.02) - 2025/08/31 23:36:51 CET [2025/08/31 17:36:51 ET]
Table 'Arneb' 6-max Seat #1 is the button
Seat 1: pipinoelbreve9 (€4.42 in chips) 
Seat 2: Sportacus911 (€2.04 in chips) 
Seat 3: Xoco Cusco (€4.03 in chips) 
Seat 4: tijolon (€2.42 in chips) 
Seat 5: Grilo9 (€3.34 in chips) 
Seat 6: charlie67100 (€2.96 in chips) 
Sportacus911: posts small blind €0.01
Xoco Cusco: posts big blind €0.02
*** HOLE CARDS ***
Dealt to pipinoelbreve9 [4h Ad]
tijolon: folds 
Grilo9: folds 
charlie67100: folds 
pipinoelbreve9: raises €0.04 to €0.06
Sportacus911: folds 
Xoco Cusco: folds 
Uncalled bet (€0.04) returned to pipinoelbreve9
pipinoelbreve9 collected €0.05 from pot
pipinoelbreve9: doesn't show hand 
*** SUMMARY ***
Total pot €0.05 | Rake €0 
Seat 1: pipinoelbreve9 (button) collected (€0.05)
Seat 2: Sportacus911 (small blind) folded before Flop
Seat 3: Xoco Cusco (big blind) folded before Flop
Seat 4: tijolon folded before Flop (didn't bet)
Seat 5: Grilo9 folded before Flop (didn't bet)
Seat 6: charlie67100 folded before Flop (didn't bet)



PokerStars Zoom Hand #257563939564:  Hold'em No Limit (€0.01/€0.02) - 2025/08/31 23:37:05 CET [2025/08/31 17:37:05 ET]
Table 'Arneb' 6-max Seat #1 is the button
Seat 1: tijolon (€3.15 in chips) 
Seat 2: batista362 (€2.12 in chips) 
Seat 3: RichyPozo (€2.31 in chips) 
Seat 4: Grilo9 (€2.24 in chips) 
Seat 5: RCSA2 (€3.31 in chips) 
Seat 6: pipinoelbreve9 (€4.45 in chips) 
batista362: posts small blind €0.01
RichyPozo: posts big blind €0.02
*** HOLE CARDS ***
Dealt to pipinoelbreve9 [Qc 9s]
Grilo9: folds 
RCSA2: folds 
pipinoelbreve9: raises €0.04 to €0.06
tijolon: folds 
batista362: folds 
RichyPozo: folds 
Uncalled bet (€0.04) returned to pipinoelbreve9
pipinoelbreve9 collected €0.05 from pot
pipinoelbreve9: doesn't show hand 
*** SUMMARY ***
Total pot €0.05 | Rake €0 
Seat 1: tijolon (button) folded before Flop (didn't bet)
Seat 2: batista362 (small blind) folded before Flop
Seat 3: RichyPozo (big blind) folded before Flop
Seat 4: Grilo9 folded before Flop (didn't bet)
Seat 5: RCSA2 folded before Flop (didn't bet)
Seat 6: pipinoelbreve9 collected (€0.05)



PokerStars Zoom Hand #257563930660:  Hold'em No Limit (€0.01/€0.02) - 2025/08/31 23:36:34 CET [2025/08/31 17:36:34 ET]
Table 'Arneb' 6-max Seat #1 is the button
Seat 1: LuisGR90 (€2.04 in chips) 
Seat 2: pipinoelbreve9 (€4.43 in chips) 
Seat 3: dimag444 (€2 in chips) 
Seat 4: Sportacus911 (€2.04 in chips) 
Seat 5: sambupkr (€3.27 in chips) 
Seat 6: MENDACANELO (€1.94 in chips) 
pipinoelbreve9: posts small blind €0.01
dimag444: posts big blind €0.02
*** HOLE CARDS ***
Dealt to pipinoelbreve9 [Ts 8h]
Sportacus911: folds 
sambupkr: raises €0.03 to €0.05
MENDACANELO: folds 
LuisGR90: folds 
pipinoelbreve9: folds 
dimag444: calls €0.03
*** FLOP *** [4c 6c Jd]
dimag444: checks 
sambupkr: bets €0.03
dimag444: calls €0.03
*** TURN *** [4c 6c Jd] [7h]
dimag444: checks 
sambupkr: checks 
*** RIVER *** [4c 6c Jd 7h] [9c]
dimag444: bets €0.04
sambupkr: raises €3.15 to €3.19 and is all-in
dimag444: folds 
Uncalled bet (€3.15) returned to sambupkr
sambupkr collected €0.24 from pot
sambupkr: doesn't show hand 
*** SUMMARY ***
Total pot €0.25 | Rake €0.01 
Board [4c 6c Jd 7h 9c]
Seat 1: LuisGR90 (button) folded before Flop (didn't bet)
Seat 2: pipinoelbreve9 (small blind) folded before Flop
Seat 3: dimag444 (big blind) folded on the River
Seat 4: Sportacus911 folded before Flop (didn't bet)
Seat 5: sambupkr collected (€0.24)
Seat 6: MENDACANELO folded before Flop (didn't bet)



PokerStars Zoom Hand #257563943753:  Hold'em No Limit (€0.01/€0.02) - 2025/08/31 23:37:20 CET [2025/08/31 17:37:20 ET]
Table 'Arneb' 6-max Seat #1 is the button
Seat 1: Manuxanxe78 (€2 in chips) 
Seat 2: Grilo9 (€2.16 in chips) 
Seat 3: lopo1187 (€2.09 in chips) 
Seat 4: pipinoelbreve9 (€4.48 in chips) 
Seat 5: tijolon (€2.42 in chips) 
Seat 6: RichyPozo (€2.29 in chips) 
Grilo9: posts small blind €0.01
lopo1187: posts big blind €0.02
*** HOLE CARDS ***
Dealt to pipinoelbreve9 [5h As]
pipinoelbreve9: folds 
tijolon: folds 
RichyPozo: folds 
Manuxanxe78: folds 
Grilo9: raises €0.04 to €0.06
lopo1187: folds 
Uncalled bet (€0.04) returned to Grilo9
Grilo9 collected €0.04 from pot
Grilo9: doesn't show hand 
*** SUMMARY ***
Total pot €0.04 | Rake €0 
Seat 1: Manuxanxe78 (button) folded before Flop (didn't bet)
Seat 2: Grilo9 (small blind) collected (€0.04)
Seat 3: lopo1187 (big blind) folded before Flop
Seat 4: pipinoelbreve9 folded before Flop (didn't bet)
Seat 5: tijolon folded before Flop (didn't bet)
Seat 6: RichyPozo folded before Flop (didn't bet)



