PokerStars Zoom Hand #257660811747:  Hold'em No Limit (€0.01/€0.02) - 2025/09/08 14:37:07 CET [2025/09/08 8:37:07 ET]
Table 'Arneb' 6-max Seat #1 is the button
Seat 1: Dimusa22 (€1.59 in chips) 
Seat 2: Phamtom123 (€0.92 in chips) 
Seat 3: pipinoelbreve9 (€2 in chips) 
Seat 4: SMN242 (€2 in chips) 
Seat 5: playismael1992 (€2.51 in chips) 
Seat 6: KillVerlaine (€4.56 in chips) 
Phamtom123: posts small blind €0.01
pipinoelbreve9: posts big blind €0.02
*** HOLE CARDS ***
Dealt to pipinoelbreve9 [Ah As]
SMN242: folds 
playismael1992: folds 
KillVerlaine: folds 
Dimusa22: folds 
Phamtom123: calls €0.01
pipinoelbreve9: raises €0.08 to €0.10
Phamtom123: folds 
Uncalled bet (€0.08) returned to pipinoelbreve9
pipinoelbreve9 collected €0.04 from pot
pipinoelbreve9: doesn't show hand 
*** SUMMARY ***
Total pot €0.04 | Rake €0 
Seat 1: Dimusa22 (button) folded before Flop (didn't bet)
Seat 2: Phamtom123 (small blind) folded before Flop
Seat 3: pipinoelbreve9 (big blind) collected (€0.04)
Seat 4: SMN242 folded before Flop (didn't bet)
Seat 5: playismael1992 folded before Flop (didn't bet)
Seat 6: KillVerlaine folded before Flop (didn't bet)



PokerStars Zoom Hand #257660813777:  Hold'em No Limit (€0.01/€0.02) - 2025/09/08 14:37:22 CET [2025/09/08 8:37:22 ET]
Table 'Arneb' 6-max Seat #1 is the button
Seat 1: bdcscstars (€1.35 in chips) 
Seat 2: pipinoelbreve9 (€2.02 in chips) 
Seat 3: GamerVidal (€2 in chips) 
Seat 4: fullben2211 (€1.30 in chips) 
Seat 5: sektor_mdk (€1.85 in chips) 
Seat 6: RMOT100A (€1.78 in chips) 
pipinoelbreve9: posts small blind €0.01
GamerVidal: posts big blind €0.02
*** HOLE CARDS ***
Dealt to pipinoelbreve9 [Td Qc]
fullben2211: folds 
sektor_mdk: raises €0.04 to €0.06
RMOT100A: folds 
bdcscstars: folds 
pipinoelbreve9: calls €0.05
GamerVidal: folds 
*** FLOP *** [Qh Jd 4h]
pipinoelbreve9: checks 
sektor_mdk: bets €0.04
pipinoelbreve9: calls €0.04
*** TURN *** [Qh Jd 4h] [4c]
pipinoelbreve9: checks 
sektor_mdk: bets €0.06
pipinoelbreve9: calls €0.06
*** RIVER *** [Qh Jd 4h 4c] [Ks]
pipinoelbreve9: bets €0.18
sektor_mdk: calls €0.18
*** SHOW DOWN ***
pipinoelbreve9: shows [Td Qc] (two pair, Queens and Fours)
sektor_mdk: shows [Js Kd] (two pair, Kings and Jacks)
sektor_mdk collected €0.66 from pot
*** SUMMARY ***
Total pot €0.70 | Rake €0.04 
Board [Qh Jd 4h 4c Ks]
Seat 1: bdcscstars (button) folded before Flop (didn't bet)
Seat 2: pipinoelbreve9 (small blind) showed [Td Qc] and lost with two pair, Queens and Fours
Seat 3: GamerVidal (big blind) folded before Flop
Seat 4: fullben2211 folded before Flop (didn't bet)
Seat 5: sektor_mdk showed [Js Kd] and won (€0.66) with two pair, Kings and Jacks
Seat 6: RMOT100A folded before Flop (didn't bet)



PokerStars Zoom Hand #257660819295:  Hold'em No Limit (€0.01/€0.02) - 2025/09/08 14:38:05 CET [2025/09/08 8:38:05 ET]
Table 'Arneb' 6-max Seat #1 is the button
Seat 1: pipinoelbreve9 (€2 in chips) 
Seat 2: V1e4ra (€2.61 in chips) 
Seat 3: kombei63 (€2.66 in chips) 
Seat 4: simplicio82 (€1.03 in chips) 
Seat 5: SMN242 (€2 in chips) 
Seat 6: 34pluto (€1 in chips) 
V1e4ra: posts small blind €0.01
kombei63: posts big blind €0.02
*** HOLE CARDS ***
Dealt to pipinoelbreve9 [Td Ah]
simplicio82: calls €0.02
SMN242: folds 
34pluto: calls €0.02
pipinoelbreve9: raises €0.08 to €0.10
V1e4ra: folds 
kombei63: folds 
simplicio82: calls €0.08
34pluto: calls €0.08
*** FLOP *** [7s Qh 4s]
simplicio82: checks 
34pluto: checks 
pipinoelbreve9: checks 
*** TURN *** [7s Qh 4s] [Jd]
simplicio82: bets €0.04
34pluto: raises €0.04 to €0.08
pipinoelbreve9: calls €0.08
simplicio82: folds 
*** RIVER *** [7s Qh 4s Jd] [5c]
34pluto: checks 
pipinoelbreve9: checks 
*** SHOW DOWN ***
34pluto: shows [Js Ad] (a pair of Jacks)
pipinoelbreve9: mucks hand 
34pluto collected €0.50 from pot
*** SUMMARY ***
Total pot €0.53 | Rake €0.03 
Board [7s Qh 4s Jd 5c]
Seat 1: pipinoelbreve9 (button) mucked [Td Ah]
Seat 2: V1e4ra (small blind) folded before Flop
Seat 3: kombei63 (big blind) folded before Flop
Seat 4: simplicio82 folded on the Turn
Seat 5: SMN242 folded before Flop (didn't bet)
Seat 6: 34pluto showed [Js Ad] and won (€0.50) with a pair of Jacks



PokerStars Zoom Hand #257660825937:  Hold'em No Limit (€0.01/€0.02) - 2025/09/08 14:38:56 CET [2025/09/08 8:38:56 ET]
Table 'Arneb' 6-max Seat #1 is the button
Seat 1: sektor_mdk (€2.34 in chips) 
Seat 2: SMN242 (€2 in chips) 
Seat 3: EiramSenpai (€1.20 in chips) 
Seat 4: bdcscstars (€1.50 in chips) 
Seat 5: clavells (€2.08 in chips) 
Seat 6: pipinoelbreve9 (€2 in chips) 
SMN242: posts small blind €0.01
EiramSenpai: posts big blind €0.02
*** HOLE CARDS ***
Dealt to pipinoelbreve9 [7d 3h]
bdcscstars: raises €0.02 to €0.04
clavells: calls €0.04
pipinoelbreve9: folds 
sektor_mdk: folds 
SMN242: folds 
EiramSenpai: calls €0.02
*** FLOP *** [8s Qd 3d]
EiramSenpai: checks 
bdcscstars: bets €0.08
clavells: folds 
EiramSenpai: folds 
Uncalled bet (€0.08) returned to bdcscstars
bdcscstars collected €0.12 from pot
bdcscstars: doesn't show hand 
*** SUMMARY ***
Total pot €0.13 | Rake €0.01 
Board [8s Qd 3d]
Seat 1: sektor_mdk (button) folded before Flop (didn't bet)
Seat 2: SMN242 (small blind) folded before Flop
Seat 3: EiramSenpai (big blind) folded on the Flop
Seat 4: bdcscstars collected (€0.12)
Seat 5: clavells folded on the Flop
Seat 6: pipinoelbreve9 folded before Flop (didn't bet)



PokerStars Zoom Hand #257660826402:  Hold'em No Limit (€0.01/€0.02) - 2025/09/08 14:38:59 CET [2025/09/08 8:38:59 ET]
Table 'Arneb' 6-max Seat #1 is the button
Seat 1: Popins0011 (€2.17 in chips) 
Seat 2: fullben2211 (€1.22 in chips) 
Seat 3: Pokermon6664 (€0.62 in chips) 
Seat 4: Ctr Alt Surp (€2.04 in chips) 
Seat 5: pipinoelbreve9 (€2 in chips) 
Seat 6: ranchim (€2.24 in chips) 
fullben2211: posts small blind €0.01
Pokermon6664: posts big blind €0.02
*** HOLE CARDS ***
Dealt to pipinoelbreve9 [4c 6s]
Ctr Alt Surp: folds 
pipinoelbreve9: folds 
ranchim: folds 
Popins0011: folds 
fullben2211: calls €0.01
Pokermon6664: checks 
*** FLOP *** [2h 2s Ks]
fullben2211: checks 
Pokermon6664: checks 
*** TURN *** [2h 2s Ks] [8s]
fullben2211: checks 
Pokermon6664: checks 
*** RIVER *** [2h 2s Ks 8s] [Th]
fullben2211: checks 
Pokermon6664: bets €0.02
fullben2211: folds 
Uncalled bet (€0.02) returned to Pokermon6664
Pokermon6664 collected €0.04 from pot
Pokermon6664: doesn't show hand 
*** SUMMARY ***
Total pot €0.04 | Rake €0 
Board [2h 2s Ks 8s Th]
Seat 1: Popins0011 (button) folded before Flop (didn't bet)
Seat 2: fullben2211 (small blind) folded on the River
Seat 3: Pokermon6664 (big blind) collected (€0.04)
Seat 4: Ctr Alt Surp folded before Flop (didn't bet)
Seat 5: pipinoelbreve9 folded before Flop (didn't bet)
Seat 6: ranchim folded before Flop (didn't bet)



PokerStars Zoom Hand #257660825340:  Hold'em No Limit (€0.01/€0.02) - 2025/09/08 14:38:51 CET [2025/09/08 8:38:51 ET]
Table 'Arneb' 6-max Seat #1 is the button
Seat 1: snowstorm-C9 (€1.96 in chips) 
Seat 2: damianmg10 (€2.47 in chips) 
Seat 3: fullben2211 (€1.24 in chips) 
Seat 4: playismael1992 (€2.39 in chips) 
Seat 5: pipinoelbreve9 (€2 in chips) 
Seat 6: Chrispin94 (€2.19 in chips) 
damianmg10: posts small blind €0.01
fullben2211: posts big blind €0.02
*** HOLE CARDS ***
Dealt to pipinoelbreve9 [2h 4d]
playismael1992: raises €0.05 to €0.07
pipinoelbreve9: folds 
Chrispin94: calls €0.07
snowstorm-C9: folds 
damianmg10: folds 
fullben2211: folds 
*** FLOP *** [Kh 6h 9c]
playismael1992: bets €0.16
Chrispin94: folds 
Uncalled bet (€0.16) returned to playismael1992
playismael1992 collected €0.16 from pot
playismael1992: doesn't show hand 
*** SUMMARY ***
Total pot €0.17 | Rake €0.01 
Board [Kh 6h 9c]
Seat 1: snowstorm-C9 (button) folded before Flop (didn't bet)
Seat 2: damianmg10 (small blind) folded before Flop
Seat 3: fullben2211 (big blind) folded before Flop
Seat 4: playismael1992 collected (€0.16)
Seat 5: pipinoelbreve9 folded before Flop (didn't bet)
Seat 6: Chrispin94 folded on the Flop



PokerStars Zoom Hand #257660827058:  Hold'em No Limit (€0.01/€0.02) - 2025/09/08 14:39:04 CET [2025/09/08 8:39:04 ET]
Table 'Arneb' 6-max Seat #1 is the button
Seat 1: ranchim (€2.24 in chips) 
Seat 2: Rodrigo00141 (€1.80 in chips) 
Seat 3: pipinoelbreve9 (€2 in chips) 
Seat 4: GamerVidal (€1.91 in chips) 
Seat 5: SMN242 (€2 in chips) 
Seat 6: damianmg10 (€2.17 in chips) 
Rodrigo00141: posts small blind €0.01
pipinoelbreve9: posts big blind €0.02
*** HOLE CARDS ***
Dealt to pipinoelbreve9 [3c Js]
GamerVidal: folds 
SMN242: folds 
damianmg10: folds 
ranchim: folds 
Rodrigo00141: calls €0.01
pipinoelbreve9: checks 
*** FLOP *** [Ac Qh Td]
Rodrigo00141: checks 
pipinoelbreve9: checks 
*** TURN *** [Ac Qh Td] [8d]
Rodrigo00141: checks 
pipinoelbreve9: checks 
*** RIVER *** [Ac Qh Td 8d] [4s]
Rodrigo00141: checks 
pipinoelbreve9: checks 
*** SHOW DOWN ***
Rodrigo00141: shows [Qc 7h] (a pair of Queens)
pipinoelbreve9: mucks hand 
Rodrigo00141 collected €0.04 from pot
*** SUMMARY ***
Total pot €0.04 | Rake €0 
Board [Ac Qh Td 8d 4s]
Seat 1: ranchim (button) folded before Flop (didn't bet)
Seat 2: Rodrigo00141 (small blind) showed [Qc 7h] and won (€0.04) with a pair of Queens
Seat 3: pipinoelbreve9 (big blind) mucked [3c Js]
Seat 4: GamerVidal folded before Flop (didn't bet)
Seat 5: SMN242 folded before Flop (didn't bet)
Seat 6: damianmg10 folded before Flop (didn't bet)



PokerStars Zoom Hand #257660833667:  Hold'em No Limit (€0.01/€0.02) - 2025/09/08 14:39:55 CET [2025/09/08 8:39:55 ET]
Table 'Arneb' 6-max Seat #1 is the button
Seat 1: pipinoelbreve9 (€2 in chips) 
Seat 2: GamerVidal (€1.97 in chips) 
Seat 3: Rodrigo00141 (€1.82 in chips) 
Seat 4: MDKristian (€2.14 in chips) 
Seat 5: linoviseu25 (€0.95 in chips) 
Seat 6: RMOT100A (€1.83 in chips) 
GamerVidal: posts small blind €0.01
Rodrigo00141: posts big blind €0.02
*** HOLE CARDS ***
Dealt to pipinoelbreve9 [6s 4h]
MDKristian: folds 
linoviseu25: folds 
RMOT100A: folds 
pipinoelbreve9: folds 
GamerVidal: folds 
Uncalled bet (€0.01) returned to Rodrigo00141
Rodrigo00141 collected €0.02 from pot
Rodrigo00141: doesn't show hand 
*** SUMMARY ***
Total pot €0.02 | Rake €0 
Seat 1: pipinoelbreve9 (button) folded before Flop (didn't bet)
Seat 2: GamerVidal (small blind) folded before Flop
Seat 3: Rodrigo00141 (big blind) collected (€0.02)
Seat 4: MDKristian folded before Flop (didn't bet)
Seat 5: linoviseu25 folded before Flop (didn't bet)
Seat 6: RMOT100A folded before Flop (didn't bet)



PokerStars Zoom Hand #257660834265:  Hold'em No Limit (€0.01/€0.02) - 2025/09/08 14:39:59 CET [2025/09/08 8:39:59 ET]
Table 'Arneb' 6-max Seat #1 is the button
Seat 1: MDKristian (€2.14 in chips) 
Seat 2: pipinoelbreve9 (€2 in chips) 
Seat 3: RMOT100A (€1.83 in chips) 
Seat 4: linoviseu25 (€0.95 in chips) 
Seat 5: swiitx (€2.77 in chips) 
Seat 6: 34pluto (€1.51 in chips) 
pipinoelbreve9: posts small blind €0.01
RMOT100A: posts big blind €0.02
*** HOLE CARDS ***
Dealt to pipinoelbreve9 [3s Ad]
linoviseu25: folds 
swiitx: raises €0.04 to €0.06
34pluto: raises €0.15 to €0.21
MDKristian: folds 
pipinoelbreve9: folds 
RMOT100A: folds 
swiitx: folds 
Uncalled bet (€0.15) returned to 34pluto
34pluto collected €0.15 from pot
34pluto: doesn't show hand 
*** SUMMARY ***
Total pot €0.15 | Rake €0 
Seat 1: MDKristian (button) folded before Flop (didn't bet)
Seat 2: pipinoelbreve9 (small blind) folded before Flop
Seat 3: RMOT100A (big blind) folded before Flop
Seat 4: linoviseu25 folded before Flop (didn't bet)
Seat 5: swiitx folded before Flop
Seat 6: 34pluto collected (€0.15)



PokerStars Zoom Hand #257660835425:  Hold'em No Limit (€0.01/€0.02) - 2025/09/08 14:40:08 CET [2025/09/08 8:40:08 ET]
Table 'Arneb' 6-max Seat #1 is the button
Seat 1: cagou006 (€3.31 in chips) 
Seat 2: Ivanovich960 (€5.58 in chips) 
Seat 3: crissstal (€1.43 in chips) 
Seat 4: GamerVidal (€2.13 in chips) 
Seat 5: MDKristian (€2.14 in chips) 
Seat 6: pipinoelbreve9 (€2 in chips) 
Ivanovich960: posts small blind €0.01
crissstal: posts big blind €0.02
*** HOLE CARDS ***
Dealt to pipinoelbreve9 [6h Kh]
GamerVidal: folds 
MDKristian: folds 
pipinoelbreve9: raises €0.04 to €0.06
cagou006: calls €0.06
Ivanovich960: calls €0.05
crissstal: calls €0.04
*** FLOP *** [2d 7h 5h]
Ivanovich960: checks 
crissstal: checks 
pipinoelbreve9: bets €0.14
cagou006: folds 
Ivanovich960: calls €0.14
crissstal: folds 
*** TURN *** [2d 7h 5h] [Kc]
Ivanovich960: bets €0.18
pipinoelbreve9: calls €0.18
*** RIVER *** [2d 7h 5h Kc] [Ac]
Ivanovich960: checks 
pipinoelbreve9: checks 
*** SHOW DOWN ***
Ivanovich960: shows [Ts Td] (a pair of Tens)
pipinoelbreve9: shows [6h Kh] (a pair of Kings)
pipinoelbreve9 collected €0.84 from pot
*** SUMMARY ***
Total pot €0.88 | Rake €0.04 
Board [2d 7h 5h Kc Ac]
Seat 1: cagou006 (button) folded on the Flop
Seat 2: Ivanovich960 (small blind) showed [Ts Td] and lost with a pair of Tens
Seat 3: crissstal (big blind) folded on the Flop
Seat 4: GamerVidal folded before Flop (didn't bet)
Seat 5: MDKristian folded before Flop (didn't bet)
Seat 6: pipinoelbreve9 showed [6h Kh] and won (€0.84) with a pair of Kings



PokerStars Zoom Hand #257660841529:  Hold'em No Limit (€0.01/€0.02) - 2025/09/08 14:40:54 CET [2025/09/08 8:40:54 ET]
Table 'Arneb' 6-max Seat #1 is the button
Seat 1: fullben2211 (€1.15 in chips) 
Seat 2: MDKristian (€2.08 in chips) 
Seat 3: SolverSoul (€1.27 in chips) 
Seat 4: Chrisbug33 (€1.57 in chips) 
Seat 5: pipinoelbreve9 (€2.46 in chips) 
Seat 6: V1e4ra (€3.15 in chips) 
MDKristian: posts small blind €0.01
SolverSoul: posts big blind €0.02
*** HOLE CARDS ***
Dealt to pipinoelbreve9 [Ac 2d]
Chrisbug33: folds 
pipinoelbreve9: folds 
V1e4ra: folds 
fullben2211: folds 
MDKristian: folds 
Uncalled bet (€0.01) returned to SolverSoul
SolverSoul collected €0.02 from pot
SolverSoul: doesn't show hand 
*** SUMMARY ***
Total pot €0.02 | Rake €0 
Seat 1: fullben2211 (button) folded before Flop (didn't bet)
Seat 2: MDKristian (small blind) folded before Flop
Seat 3: SolverSoul (big blind) collected (€0.02)
Seat 4: Chrisbug33 folded before Flop (didn't bet)
Seat 5: pipinoelbreve9 folded before Flop (didn't bet)
Seat 6: V1e4ra folded before Flop (didn't bet)



PokerStars Zoom Hand #257660842325:  Hold'em No Limit (€0.01/€0.02) - 2025/09/08 14:41:00 CET [2025/09/08 8:41:00 ET]
Table 'Arneb' 6-max Seat #1 is the button
Seat 1: pipinoelbreve9 (€2.46 in chips) 
Seat 2: SHoKeRoNe (€2.06 in chips) 
Seat 3: Popins0011 (€0.08 in chips) 
Seat 4: V1e4ra (€1.90 in chips) 
Seat 5: maitreyoda59 (€0.42 in chips) 
Seat 6: WHY?NOW IS (€2.16 in chips) 
SHoKeRoNe: posts small blind €0.01
Popins0011: posts big blind €0.02
*** HOLE CARDS ***
Dealt to pipinoelbreve9 [9s Ad]
V1e4ra: folds 
maitreyoda59: folds 
WHY?NOW IS: folds 
pipinoelbreve9: raises €0.04 to €0.06
SHoKeRoNe: folds 
Popins0011: raises €0.02 to €0.08 and is all-in
pipinoelbreve9: calls €0.02
*** FLOP *** [8d 7s 4d]
*** TURN *** [8d 7s 4d] [Kh]
*** RIVER *** [8d 7s 4d Kh] [8c]
*** SHOW DOWN ***
Popins0011: shows [Jh Jc] (two pair, Jacks and Eights)
pipinoelbreve9: shows [9s Ad] (a pair of Eights)
Popins0011 collected €0.16 from pot
*** SUMMARY ***
Total pot €0.17 | Rake €0.01 
Board [8d 7s 4d Kh 8c]
Seat 1: pipinoelbreve9 (button) showed [9s Ad] and lost with a pair of Eights
Seat 2: SHoKeRoNe (small blind) folded before Flop
Seat 3: Popins0011 (big blind) showed [Jh Jc] and won (€0.16) with two pair, Jacks and Eights
Seat 4: V1e4ra folded before Flop (didn't bet)
Seat 5: maitreyoda59 folded before Flop (didn't bet)
Seat 6: WHY?NOW IS folded before Flop (didn't bet)



PokerStars Zoom Hand #257660846409:  Hold'em No Limit (€0.01/€0.02) - 2025/09/08 14:41:31 CET [2025/09/08 8:41:31 ET]
Table 'Arneb' 6-max Seat #1 is the button
Seat 1: crissstal (€1.46 in chips) 
Seat 2: pipinoelbreve9 (€2.38 in chips) 
Seat 3: KillVerlaine (€4.73 in chips) 
Seat 4: MDKristian (€2.11 in chips) 
Seat 5: fullben2211 (€1.13 in chips) 
Seat 6: cagou006 (€3.25 in chips) 
pipinoelbreve9: posts small blind €0.01
KillVerlaine: posts big blind €0.02
*** HOLE CARDS ***
Dealt to pipinoelbreve9 [7h Th]
MDKristian: folds 
fullben2211: folds 
cagou006: folds 
crissstal: folds 
pipinoelbreve9: folds 
Uncalled bet (€0.01) returned to KillVerlaine
KillVerlaine collected €0.02 from pot
KillVerlaine: doesn't show hand 
*** SUMMARY ***
Total pot €0.02 | Rake €0 
Seat 1: crissstal (button) folded before Flop (didn't bet)
Seat 2: pipinoelbreve9 (small blind) folded before Flop
Seat 3: KillVerlaine (big blind) collected (€0.02)
Seat 4: MDKristian folded before Flop (didn't bet)
Seat 5: fullben2211 folded before Flop (didn't bet)
Seat 6: cagou006 folded before Flop (didn't bet)



PokerStars Zoom Hand #257660849346:  Hold'em No Limit (€0.01/€0.02) - 2025/09/08 14:41:53 CET [2025/09/08 8:41:53 ET]
Table 'Arneb' 6-max Seat #1 is the button
Seat 1: fullben2211 (€1.13 in chips) 
Seat 2: yunowme (€2.10 in chips) 
Seat 3: V1e4ra (€1.87 in chips) 
Seat 4: pipinoelbreve9 (€2.35 in chips) 
Seat 5: SolverSoul (€1.33 in chips) 
Seat 6: GamerVidal (€4.01 in chips) 
yunowme: posts small blind €0.01
V1e4ra: posts big blind €0.02
*** HOLE CARDS ***
Dealt to pipinoelbreve9 [8s Jc]
pipinoelbreve9: folds 
SolverSoul: folds 
GamerVidal: folds 
fullben2211: folds 
yunowme: folds 
Uncalled bet (€0.01) returned to V1e4ra
V1e4ra collected €0.02 from pot
V1e4ra: doesn't show hand 
*** SUMMARY ***
Total pot €0.02 | Rake €0 
Seat 1: fullben2211 (button) folded before Flop (didn't bet)
Seat 2: yunowme (small blind) folded before Flop
Seat 3: V1e4ra (big blind) collected (€0.02)
Seat 4: pipinoelbreve9 folded before Flop (didn't bet)
Seat 5: SolverSoul folded before Flop (didn't bet)
Seat 6: GamerVidal folded before Flop (didn't bet)



PokerStars Zoom Hand #257660847641:  Hold'em No Limit (€0.01/€0.02) - 2025/09/08 14:41:40 CET [2025/09/08 8:41:40 ET]
Table 'Arneb' 6-max Seat #1 is the button
Seat 1: ranchim (€2.21 in chips) 
Seat 2: MDKristian (€2.12 in chips) 
Seat 3: pipinoelbreve9 (€2.37 in chips) 
Seat 4: Percu32 (€3.28 in chips) 
Seat 5: cagou006 (€3.25 in chips) 
Seat 6: Ruca2010600 (€2.35 in chips) 
MDKristian: posts small blind €0.01
pipinoelbreve9: posts big blind €0.02
*** HOLE CARDS ***
Dealt to pipinoelbreve9 [7c 5h]
Percu32: folds 
cagou006: folds 
Ruca2010600: folds 
ranchim: raises €0.03 to €0.05
MDKristian: calls €0.04
pipinoelbreve9: folds 
*** FLOP *** [Jc 7s Ad]
MDKristian: bets €0.11
ranchim: calls €0.11
*** TURN *** [Jc 7s Ad] [6d]
MDKristian: bets €0.24
ranchim: folds 
Uncalled bet (€0.24) returned to MDKristian
MDKristian collected €0.32 from pot
MDKristian: doesn't show hand 
*** SUMMARY ***
Total pot €0.34 | Rake €0.02 
Board [Jc 7s Ad 6d]
Seat 1: ranchim (button) folded on the Turn
Seat 2: MDKristian (small blind) collected (€0.32)
Seat 3: pipinoelbreve9 (big blind) folded before Flop
Seat 4: Percu32 folded before Flop (didn't bet)
Seat 5: cagou006 folded before Flop (didn't bet)
Seat 6: Ruca2010600 folded before Flop (didn't bet)



PokerStars Zoom Hand #257660850067:  Hold'em No Limit (€0.01/€0.02) - 2025/09/08 14:41:59 CET [2025/09/08 8:41:59 ET]
Table 'Arneb' 6-max Seat #1 is the button
Seat 1: yunowme (€3.18 in chips) 
Seat 2: V1e4ra (€4.49 in chips) 
Seat 3: Ruca2010600 (€2.35 in chips) 
Seat 4: pipinoelbreve9 (€2.35 in chips) 
Seat 5: 34pluto (€1.31 in chips) 
Seat 6: SolverSoul (€1.33 in chips) 
V1e4ra: posts small blind €0.01
Ruca2010600: posts big blind €0.02
*** HOLE CARDS ***
Dealt to pipinoelbreve9 [9c Jd]
pipinoelbreve9: folds 
34pluto: folds 
SolverSoul: folds 
yunowme: raises €0.03 to €0.05
V1e4ra: folds 
Ruca2010600: folds 
Uncalled bet (€0.03) returned to yunowme
yunowme collected €0.05 from pot
yunowme: doesn't show hand 
*** SUMMARY ***
Total pot €0.05 | Rake €0 
Seat 1: yunowme (button) collected (€0.05)
Seat 2: V1e4ra (small blind) folded before Flop
Seat 3: Ruca2010600 (big blind) folded before Flop
Seat 4: pipinoelbreve9 folded before Flop (didn't bet)
Seat 5: 34pluto folded before Flop (didn't bet)
Seat 6: SolverSoul folded before Flop (didn't bet)



PokerStars Zoom Hand #257660851359:  Hold'em No Limit (€0.01/€0.02) - 2025/09/08 14:42:08 CET [2025/09/08 8:42:08 ET]
Table 'Arneb' 6-max Seat #1 is the button
Seat 1: V1e4ra (€4.48 in chips) 
Seat 2: Ctr Alt Surp (€2.79 in chips) 
Seat 3: maitreyoda59 (€0.32 in chips) 
Seat 4: pipinoelbreve9 (€2.35 in chips) 
Seat 5: RMOT100A (€1.80 in chips) 
Seat 6: Chrisbug33 (€1.47 in chips) 
Ctr Alt Surp: posts small blind €0.01
maitreyoda59: posts big blind €0.02
*** HOLE CARDS ***
Dealt to pipinoelbreve9 [Tc 5s]
pipinoelbreve9: folds 
RMOT100A: folds 
Chrisbug33: folds 
V1e4ra: raises €0.05 to €0.07
Ctr Alt Surp: folds 
maitreyoda59: folds 
Uncalled bet (€0.05) returned to V1e4ra
V1e4ra collected €0.05 from pot
V1e4ra: doesn't show hand 
*** SUMMARY ***
Total pot €0.05 | Rake €0 
Seat 1: V1e4ra (button) collected (€0.05)
Seat 2: Ctr Alt Surp (small blind) folded before Flop
Seat 3: maitreyoda59 (big blind) folded before Flop
Seat 4: pipinoelbreve9 folded before Flop (didn't bet)
Seat 5: RMOT100A folded before Flop (didn't bet)
Seat 6: Chrisbug33 folded before Flop (didn't bet)



PokerStars Zoom Hand #257660850617:  Hold'em No Limit (€0.01/€0.02) - 2025/09/08 14:42:03 CET [2025/09/08 8:42:03 ET]
Table 'Arneb' 6-max Seat #1 is the button
Seat 1: V1e4ra (€3.10 in chips) 
Seat 2: fullben2211 (€1.13 in chips) 
Seat 3: 34pluto (€1.50 in chips) 
Seat 4: Phamtom123 (€0.77 in chips) 
Seat 5: sektor_mdk (€2.31 in chips) 
Seat 6: pipinoelbreve9 (€2.35 in chips) 
fullben2211: posts small blind €0.01
34pluto: posts big blind €0.02
*** HOLE CARDS ***
Dealt to pipinoelbreve9 [9d 6h]
Phamtom123: calls €0.02
sektor_mdk: raises €0.02 to €0.04
pipinoelbreve9: folds 
V1e4ra: folds 
fullben2211: raises €0.08 to €0.12
34pluto: folds 
Phamtom123: calls €0.10
sektor_mdk: folds 
*** FLOP *** [5d 4s 5s]
fullben2211: bets €0.14
Phamtom123: folds 
Uncalled bet (€0.14) returned to fullben2211
fullben2211 collected €0.28 from pot
fullben2211: doesn't show hand 
*** SUMMARY ***
Total pot €0.30 | Rake €0.02 
Board [5d 4s 5s]
Seat 1: V1e4ra (button) folded before Flop (didn't bet)
Seat 2: fullben2211 (small blind) collected (€0.28)
Seat 3: 34pluto (big blind) folded before Flop
Seat 4: Phamtom123 folded on the Flop
Seat 5: sektor_mdk folded before Flop
Seat 6: pipinoelbreve9 folded before Flop (didn't bet)



PokerStars Zoom Hand #257660851767:  Hold'em No Limit (€0.01/€0.02) - 2025/09/08 14:42:12 CET [2025/09/08 8:42:12 ET]
Table 'Arneb' 6-max Seat #1 is the button
Seat 1: 34pluto (€1.31 in chips) 
Seat 2: EiramSenpai (€1.34 in chips) 
Seat 3: kombei63 (€2.93 in chips) 
Seat 4: V1e4ra (€1.88 in chips) 
Seat 5: pipinoelbreve9 (€2.35 in chips) 
Seat 6: yunowme (€3.21 in chips) 
EiramSenpai: posts small blind €0.01
kombei63: posts big blind €0.02
*** HOLE CARDS ***
Dealt to pipinoelbreve9 [Qh Jh]
V1e4ra: raises €0.05 to €0.07
pipinoelbreve9: calls €0.07
yunowme: folds 
34pluto: folds 
EiramSenpai: calls €0.06
kombei63: folds 
*** FLOP *** [2h Jc 4s]
EiramSenpai: checks 
V1e4ra: checks 
pipinoelbreve9: bets €0.11
EiramSenpai: calls €0.11
V1e4ra: folds 
*** TURN *** [2h Jc 4s] [2d]
EiramSenpai: checks 
pipinoelbreve9: bets €0.30
EiramSenpai: folds 
Uncalled bet (€0.30) returned to pipinoelbreve9
pipinoelbreve9 collected €0.43 from pot
pipinoelbreve9: doesn't show hand 
*** SUMMARY ***
Total pot €0.45 | Rake €0.02 
Board [2h Jc 4s 2d]
Seat 1: 34pluto (button) folded before Flop (didn't bet)
Seat 2: EiramSenpai (small blind) folded on the Turn
Seat 3: kombei63 (big blind) folded before Flop
Seat 4: V1e4ra folded on the Flop
Seat 5: pipinoelbreve9 collected (€0.43)
Seat 6: yunowme folded before Flop (didn't bet)



PokerStars Zoom Hand #257660859441:  Hold'em No Limit (€0.01/€0.02) - 2025/09/08 14:43:10 CET [2025/09/08 8:43:10 ET]
Table 'Arneb' 6-max Seat #1 is the button
Seat 1: EiramSenpai (€1.16 in chips) 
Seat 2: kombei63 (€2.88 in chips) 
Seat 3: pipinoelbreve9 (€2.60 in chips) 
Seat 4: simplicio82 (€1.47 in chips) 
Seat 5: rascavieja (€1.07 in chips) 
Seat 6: linoviseu25 (€1.07 in chips) 
kombei63: posts small blind €0.01
pipinoelbreve9: posts big blind €0.02
*** HOLE CARDS ***
Dealt to pipinoelbreve9 [Jc Tc]
simplicio82: folds 
rascavieja: folds 
linoviseu25: folds 
EiramSenpai: folds 
kombei63: folds 
Uncalled bet (€0.01) returned to pipinoelbreve9
pipinoelbreve9 collected €0.02 from pot
pipinoelbreve9: doesn't show hand 
*** SUMMARY ***
Total pot €0.02 | Rake €0 
Seat 1: EiramSenpai (button) folded before Flop (didn't bet)
Seat 2: kombei63 (small blind) folded before Flop
Seat 3: pipinoelbreve9 (big blind) collected (€0.02)
Seat 4: simplicio82 folded before Flop (didn't bet)
Seat 5: rascavieja folded before Flop (didn't bet)
Seat 6: linoviseu25 folded before Flop (didn't bet)



PokerStars Zoom Hand #257660862535:  Hold'em No Limit (€0.01/€0.02) - 2025/09/08 14:43:35 CET [2025/09/08 8:43:35 ET]
Table 'Arneb' 6-max Seat #1 is the button
Seat 1: pipinoelbreve9 (€2.60 in chips) 
Seat 2: rccmonteiro27 (€2.79 in chips) 
Seat 3: Ivanovich960 (€5.35 in chips) 
Seat 4: ecuinas (€2.32 in chips) 
Seat 5: SMN242 (€2.32 in chips) 
Seat 6: cagou006 (€3.73 in chips) 
rccmonteiro27: posts small blind €0.01
Ivanovich960: posts big blind €0.02
*** HOLE CARDS ***
Dealt to pipinoelbreve9 [3s 8c]
ecuinas: folds 
SMN242: folds 
cagou006: folds 
pipinoelbreve9: folds 
rccmonteiro27: folds 
Uncalled bet (€0.01) returned to Ivanovich960
Ivanovich960 collected €0.02 from pot
Ivanovich960: doesn't show hand 
*** SUMMARY ***
Total pot €0.02 | Rake €0 
Seat 1: pipinoelbreve9 (button) folded before Flop (didn't bet)
Seat 2: rccmonteiro27 (small blind) folded before Flop
Seat 3: Ivanovich960 (big blind) collected (€0.02)
Seat 4: ecuinas folded before Flop (didn't bet)
Seat 5: SMN242 folded before Flop (didn't bet)
Seat 6: cagou006 folded before Flop (didn't bet)



PokerStars Zoom Hand #257660860887:  Hold'em No Limit (€0.01/€0.02) - 2025/09/08 14:43:22 CET [2025/09/08 8:43:22 ET]
Table 'Arneb' 6-max Seat #1 is the button
Seat 1: ABotillo12 (€2.47 in chips) 
Seat 2: pipinoelbreve9 (€2.61 in chips) 
Seat 3: EiramSenpai (€1.16 in chips) 
Seat 4: rascavieja (€1.07 in chips) 
Seat 5: MDKristian (€2 in chips) 
Seat 6: V1e4ra (€1.80 in chips) 
pipinoelbreve9: posts small blind €0.01
EiramSenpai: posts big blind €0.02
*** HOLE CARDS ***
Dealt to pipinoelbreve9 [9h 4d]
rascavieja: folds 
MDKristian: raises €0.04 to €0.06
V1e4ra: folds 
ABotillo12: raises €0.12 to €0.18
pipinoelbreve9: folds 
EiramSenpai: folds 
MDKristian: folds 
Uncalled bet (€0.12) returned to ABotillo12
ABotillo12 collected €0.15 from pot
ABotillo12: doesn't show hand 
*** SUMMARY ***
Total pot €0.15 | Rake €0 
Seat 1: ABotillo12 (button) collected (€0.15)
Seat 2: pipinoelbreve9 (small blind) folded before Flop
Seat 3: EiramSenpai (big blind) folded before Flop
Seat 4: rascavieja folded before Flop (didn't bet)
Seat 5: MDKristian folded before Flop
Seat 6: V1e4ra folded before Flop (didn't bet)



PokerStars Zoom Hand #257660864676:  Hold'em No Limit (€0.01/€0.02) - 2025/09/08 14:43:51 CET [2025/09/08 8:43:51 ET]
Table 'Arneb' 6-max Seat #1 is the button
Seat 1: kombei63 (€1.84 in chips) 
Seat 2: fullben2211 (€1.27 in chips) 
Seat 3: MDKristian (€2.17 in chips) 
Seat 4: pipinoelbreve9 (€2.60 in chips) 
Seat 5: V1e4ra (€1.80 in chips) 
Seat 6: ABotillo12 (€2.56 in chips) 
fullben2211: posts small blind €0.01
MDKristian: posts big blind €0.02
*** HOLE CARDS ***
Dealt to pipinoelbreve9 [Jc 2h]
pipinoelbreve9: folds 
V1e4ra: folds 
ABotillo12: raises €0.03 to €0.05
kombei63: folds 
fullben2211: folds 
MDKristian: folds 
Uncalled bet (€0.03) returned to ABotillo12
ABotillo12 collected €0.05 from pot
ABotillo12: doesn't show hand 
*** SUMMARY ***
Total pot €0.05 | Rake €0 
Seat 1: kombei63 (button) folded before Flop (didn't bet)
Seat 2: fullben2211 (small blind) folded before Flop
Seat 3: MDKristian (big blind) folded before Flop
Seat 4: pipinoelbreve9 folded before Flop (didn't bet)
Seat 5: V1e4ra folded before Flop (didn't bet)
Seat 6: ABotillo12 collected (€0.05)



PokerStars Zoom Hand #257660865113:  Hold'em No Limit (€0.01/€0.02) - 2025/09/08 14:43:54 CET [2025/09/08 8:43:54 ET]
Table 'Arneb' 6-max Seat #1 is the button
Seat 1: pipinoelbreve9 (€2.60 in chips) 
Seat 2: EiramSenpai (€1.14 in chips) 
Seat 3: Bestiote (€0.44 in chips) 
Seat 4: Ivanovich960 (€5.36 in chips) 
Seat 5: V1e4ra (€2.29 in chips) 
Seat 6: MDKristian (€4.05 in chips) 
EiramSenpai: posts small blind €0.01
Bestiote: posts big blind €0.02
*** HOLE CARDS ***
Dealt to pipinoelbreve9 [Th Ac]
Ivanovich960: folds 
V1e4ra: folds 
MDKristian: raises €0.04 to €0.06
pipinoelbreve9: raises €0.12 to €0.18
EiramSenpai: folds 
Bestiote: folds 
MDKristian: raises €0.24 to €0.42
pipinoelbreve9: folds 
Uncalled bet (€0.24) returned to MDKristian
MDKristian collected €0.39 from pot
MDKristian: doesn't show hand 
*** SUMMARY ***
Total pot €0.39 | Rake €0 
Seat 1: pipinoelbreve9 (button) folded before Flop
Seat 2: EiramSenpai (small blind) folded before Flop
Seat 3: Bestiote (big blind) folded before Flop
Seat 4: Ivanovich960 folded before Flop (didn't bet)
Seat 5: V1e4ra folded before Flop (didn't bet)
Seat 6: MDKristian collected (€0.39)



PokerStars Zoom Hand #257660863753:  Hold'em No Limit (€0.01/€0.02) - 2025/09/08 14:43:44 CET [2025/09/08 8:43:44 ET]
Table 'Arneb' 6-max Seat #1 is the button
Seat 1: V1e4ra (€1.80 in chips) 
Seat 2: MV.killplayer (€1.94 in chips) 
Seat 3: Percu32 (€3.25 in chips) 
Seat 4: MDKristian (€4.05 in chips) 
Seat 5: osking118 (€3.32 in chips) 
Seat 6: pipinoelbreve9 (€2.60 in chips) 
MV.killplayer: posts small blind €0.01
Percu32: posts big blind €0.02
*** HOLE CARDS ***
Dealt to pipinoelbreve9 [6h 7d]
MDKristian: folds 
osking118: raises €0.02 to €0.04
pipinoelbreve9: folds 
V1e4ra: folds 
MV.killplayer: calls €0.03
Percu32: calls €0.02
*** FLOP *** [8c 3s Th]
MV.killplayer: checks 
Percu32: checks 
osking118: checks 
*** TURN *** [8c 3s Th] [9s]
MV.killplayer: checks 
Percu32: checks 
osking118: bets €0.11
MV.killplayer: folds 
Percu32: folds 
Uncalled bet (€0.11) returned to osking118
osking118 collected €0.11 from pot
osking118: doesn't show hand 
*** SUMMARY ***
Total pot €0.12 | Rake €0.01 
Board [8c 3s Th 9s]
Seat 1: V1e4ra (button) folded before Flop (didn't bet)
Seat 2: MV.killplayer (small blind) folded on the Turn
Seat 3: Percu32 (big blind) folded on the Turn
Seat 4: MDKristian folded before Flop (didn't bet)
Seat 5: osking118 collected (€0.11)
Seat 6: pipinoelbreve9 folded before Flop (didn't bet)



PokerStars Zoom Hand #257660869633:  Hold'em No Limit (€0.01/€0.02) - 2025/09/08 14:44:28 CET [2025/09/08 8:44:28 ET]
Table 'Arneb' 6-max Seat #1 is the button
Seat 1: Gortrak (€2.11 in chips) 
Seat 2: pipinoelbreve9 (€2.40 in chips) 
Seat 3: GamerVidal (€4.19 in chips) 
Seat 4: fafamax666 (€1.71 in chips) 
Seat 5: fullben2211 (€1.24 in chips) 
Seat 6: playismael1992 (€2.17 in chips) 
pipinoelbreve9: posts small blind €0.01
GamerVidal: posts big blind €0.02
*** HOLE CARDS ***
Dealt to pipinoelbreve9 [4h Js]
playismael1992 is disconnected 
fafamax666: folds 
fullben2211: folds 
playismael1992 has timed out while disconnected
playismael1992: folds 
Gortrak: folds 
pipinoelbreve9: folds 
Uncalled bet (€0.01) returned to GamerVidal
GamerVidal collected €0.02 from pot
GamerVidal: doesn't show hand 
*** SUMMARY ***
Total pot €0.02 | Rake €0 
Seat 1: Gortrak (button) folded before Flop (didn't bet)
Seat 2: pipinoelbreve9 (small blind) folded before Flop
Seat 3: GamerVidal (big blind) collected (€0.02)
Seat 4: fafamax666 folded before Flop (didn't bet)
Seat 5: fullben2211 folded before Flop (didn't bet)
Seat 6: playismael1992 folded before Flop (didn't bet)



PokerStars Zoom Hand #257660872622:  Hold'em No Limit (€0.01/€0.02) - 2025/09/08 14:44:51 CET [2025/09/08 8:44:51 ET]
Table 'Arneb' 6-max Seat #1 is the button
Seat 1: pipinoelbreve9 (€2.39 in chips) 
Seat 2: clavells (€1.32 in chips) 
Seat 3: damianmg10 (€2.05 in chips) 
Seat 4: Bestiote (€0.41 in chips) 
Seat 5: Ctr Alt Surp (€2.61 in chips) 
Seat 6: V1e4ra (€2 in chips) 
clavells: posts small blind €0.01
damianmg10: posts big blind €0.02
*** HOLE CARDS ***
Dealt to pipinoelbreve9 [3s 5h]
Bestiote: folds 
Ctr Alt Surp: folds 
V1e4ra: folds 
pipinoelbreve9: folds 
clavells: folds 
Uncalled bet (€0.01) returned to damianmg10
damianmg10 collected €0.02 from pot
damianmg10: doesn't show hand 
*** SUMMARY ***
Total pot €0.02 | Rake €0 
Seat 1: pipinoelbreve9 (button) folded before Flop (didn't bet)
Seat 2: clavells (small blind) folded before Flop
Seat 3: damianmg10 (big blind) collected (€0.02)
Seat 4: Bestiote folded before Flop (didn't bet)
Seat 5: Ctr Alt Surp folded before Flop (didn't bet)
Seat 6: V1e4ra folded before Flop (didn't bet)



PokerStars Zoom Hand #257660870468:  Hold'em No Limit (€0.01/€0.02) - 2025/09/08 14:44:34 CET [2025/09/08 8:44:34 ET]
Table 'Arneb' 6-max Seat #1 is the button
Seat 1: fafamax666 (€1.71 in chips) 
Seat 2: V1e4ra (€2.27 in chips) 
Seat 3: fullben2211 (€1.24 in chips) 
Seat 4: Gortrak (€2.11 in chips) 
Seat 5: damianmg10 (€2.05 in chips) 
Seat 6: pipinoelbreve9 (€2.39 in chips) 
V1e4ra: posts small blind €0.01
fullben2211: posts big blind €0.02
*** HOLE CARDS ***
Dealt to pipinoelbreve9 [3h 6d]
Gortrak: folds 
damianmg10: folds 
pipinoelbreve9: folds 
fafamax666: folds 
V1e4ra: raises €0.05 to €0.07
fullben2211: folds 
Uncalled bet (€0.05) returned to V1e4ra
V1e4ra collected €0.04 from pot
V1e4ra: doesn't show hand 
*** SUMMARY ***
Total pot €0.04 | Rake €0 
Seat 1: fafamax666 (button) folded before Flop (didn't bet)
Seat 2: V1e4ra (small blind) collected (€0.04)
Seat 3: fullben2211 (big blind) folded before Flop
Seat 4: Gortrak folded before Flop (didn't bet)
Seat 5: damianmg10 folded before Flop (didn't bet)
Seat 6: pipinoelbreve9 folded before Flop (didn't bet)



PokerStars Zoom Hand #257660867844:  Hold'em No Limit (€0.01/€0.02) - 2025/09/08 14:44:15 CET [2025/09/08 8:44:15 ET]
Table 'Arneb' 6-max Seat #1 is the button
Seat 1: SHoKeRoNe (€1.99 in chips) 
Seat 2: EiramSenpai (€2.52 in chips) 
Seat 3: pipinoelbreve9 (€2.42 in chips) 
Seat 4: yunowme (€5.13 in chips) 
Seat 5: MDKristian (€2.14 in chips) 
Seat 6: KillVerlaine (€5.15 in chips) 
EiramSenpai: posts small blind €0.01
pipinoelbreve9: posts big blind €0.02
*** HOLE CARDS ***
Dealt to pipinoelbreve9 [4h Jd]
yunowme: folds 
MDKristian: folds 
KillVerlaine: raises €0.03 to €0.05
SHoKeRoNe: folds 
EiramSenpai: calls €0.04
pipinoelbreve9: folds 
*** FLOP *** [Ts 9h 9d]
EiramSenpai: checks 
KillVerlaine: bets €0.08
EiramSenpai: calls €0.08
*** TURN *** [Ts 9h 9d] [Ac]
EiramSenpai: checks 
KillVerlaine: checks 
*** RIVER *** [Ts 9h 9d Ac] [Kh]
EiramSenpai: checks 
KillVerlaine: bets €0.16
EiramSenpai: folds 
Uncalled bet (€0.16) returned to KillVerlaine
KillVerlaine collected €0.27 from pot
KillVerlaine: doesn't show hand 
*** SUMMARY ***
Total pot €0.28 | Rake €0.01 
Board [Ts 9h 9d Ac Kh]
Seat 1: SHoKeRoNe (button) folded before Flop (didn't bet)
Seat 2: EiramSenpai (small blind) folded on the River
Seat 3: pipinoelbreve9 (big blind) folded before Flop
Seat 4: yunowme folded before Flop (didn't bet)
Seat 5: MDKristian folded before Flop (didn't bet)
Seat 6: KillVerlaine collected (€0.27)



PokerStars Zoom Hand #257660874722:  Hold'em No Limit (€0.01/€0.02) - 2025/09/08 14:45:06 CET [2025/09/08 8:45:06 ET]
Table 'Arneb' 6-max Seat #1 is the button
Seat 1: MDKristian (€2.15 in chips) 
Seat 2: Ruca2010600 (€2.26 in chips) 
Seat 3: V1e4ra (€2 in chips) 
Seat 4: cagou006 (€3.73 in chips) 
Seat 5: pipinoelbreve9 (€2.39 in chips) 
Seat 6: Chrisbug33 (€1.75 in chips) 
Ruca2010600: posts small blind €0.01
V1e4ra: posts big blind €0.02
*** HOLE CARDS ***
Dealt to pipinoelbreve9 [Ts 4d]
cagou006: folds 
pipinoelbreve9: folds 
Chrisbug33: folds 
MDKristian: folds 
Ruca2010600: folds 
Uncalled bet (€0.01) returned to V1e4ra
V1e4ra collected €0.02 from pot
V1e4ra: doesn't show hand 
*** SUMMARY ***
Total pot €0.02 | Rake €0 
Seat 1: MDKristian (button) folded before Flop (didn't bet)
Seat 2: Ruca2010600 (small blind) folded before Flop
Seat 3: V1e4ra (big blind) collected (€0.02)
Seat 4: cagou006 folded before Flop (didn't bet)
Seat 5: pipinoelbreve9 folded before Flop (didn't bet)
Seat 6: Chrisbug33 folded before Flop (didn't bet)



PokerStars Zoom Hand #257660871644:  Hold'em No Limit (€0.01/€0.02) - 2025/09/08 14:44:43 CET [2025/09/08 8:44:43 ET]
Table 'Arneb' 6-max Seat #1 is the button
Seat 1: MDKristian (€2.04 in chips) 
Seat 2: swiitx (€2.41 in chips) 
Seat 3: Popins0011 (€2 in chips) 
Seat 4: pipinoelbreve9 (€2.39 in chips) 
Seat 5: Gortrak (€2.11 in chips) 
Seat 6: Pachysander (€2.74 in chips) 
swiitx: posts small blind €0.01
Popins0011: posts big blind €0.02
*** HOLE CARDS ***
Dealt to pipinoelbreve9 [Ks Tc]
pipinoelbreve9: folds 
Gortrak: folds 
Pachysander: raises €0.02 to €0.04
MDKristian: folds 
swiitx: folds 
Popins0011: calls €0.02
*** FLOP *** [Td 3c Jd]
Popins0011: checks 
Pachysander: checks 
*** TURN *** [Td 3c Jd] [7s]
Popins0011: checks 
Pachysander: bets €0.09
Popins0011: calls €0.09
*** RIVER *** [Td 3c Jd 7s] [3s]
Popins0011: checks 
Pachysander: checks 
*** SHOW DOWN ***
Popins0011: shows [7h 6c] (two pair, Sevens and Threes)
Pachysander: mucks hand 
Popins0011 collected €0.26 from pot
*** SUMMARY ***
Total pot €0.27 | Rake €0.01 
Board [Td 3c Jd 7s 3s]
Seat 1: MDKristian (button) folded before Flop (didn't bet)
Seat 2: swiitx (small blind) folded before Flop
Seat 3: Popins0011 (big blind) showed [7h 6c] and won (€0.26) with two pair, Sevens and Threes
Seat 4: pipinoelbreve9 folded before Flop (didn't bet)
Seat 5: Gortrak folded before Flop (didn't bet)
Seat 6: Pachysander mucked [Ad 6d]



PokerStars Zoom Hand #257660873659:  Hold'em No Limit (€0.01/€0.02) - 2025/09/08 14:44:58 CET [2025/09/08 8:44:58 ET]
Table 'Arneb' 6-max Seat #1 is the button
Seat 1: kombei63 (€2.78 in chips) 
Seat 2: snowstorm-C9 (€2.05 in chips) 
Seat 3: Ruca2010600 (€2.28 in chips) 
Seat 4: MDKristian (€2 in chips) 
Seat 5: pipinoelbreve9 (€2.39 in chips) 
Seat 6: WHY?NOW IS (€2.13 in chips) 
snowstorm-C9: posts small blind €0.01
Ruca2010600: posts big blind €0.02
*** HOLE CARDS ***
Dealt to pipinoelbreve9 [8h 3c]
MDKristian: folds 
pipinoelbreve9: folds 
WHY?NOW IS: calls €0.02
kombei63: raises €0.07 to €0.09
snowstorm-C9: folds 
Ruca2010600: folds 
WHY?NOW IS: calls €0.07
*** FLOP *** [3h Ac 6h]
WHY?NOW IS: checks 
kombei63: bets €0.12
WHY?NOW IS: folds 
Uncalled bet (€0.12) returned to kombei63
kombei63 collected €0.20 from pot
kombei63: doesn't show hand 
*** SUMMARY ***
Total pot €0.21 | Rake €0.01 
Board [3h Ac 6h]
Seat 1: kombei63 (button) collected (€0.20)
Seat 2: snowstorm-C9 (small blind) folded before Flop
Seat 3: Ruca2010600 (big blind) folded before Flop
Seat 4: MDKristian folded before Flop (didn't bet)
Seat 5: pipinoelbreve9 folded before Flop (didn't bet)
Seat 6: WHY?NOW IS folded on the Flop



PokerStars Zoom Hand #257660875464:  Hold'em No Limit (€0.01/€0.02) - 2025/09/08 14:45:12 CET [2025/09/08 8:45:12 ET]
Table 'Arneb' 6-max Seat #1 is the button
Seat 1: 34pluto (€1.52 in chips) 
Seat 2: SolverSoul (€1.43 in chips) 
Seat 3: pipinoelbreve9 (€2.39 in chips) 
Seat 4: crissstal (€1.40 in chips) 
Seat 5: snowstorm-C9 (€2.04 in chips) 
Seat 6: V1e4ra (€2.29 in chips) 
SolverSoul: posts small blind €0.01
pipinoelbreve9: posts big blind €0.02
*** HOLE CARDS ***
Dealt to pipinoelbreve9 [4d 5s]
crissstal: folds 
snowstorm-C9: folds 
V1e4ra: folds 
34pluto: folds 
SolverSoul: calls €0.01
pipinoelbreve9: checks 
*** FLOP *** [As 8c 2d]
SolverSoul: checks 
pipinoelbreve9: checks 
*** TURN *** [As 8c 2d] [5h]
SolverSoul: checks 
pipinoelbreve9: checks 
*** RIVER *** [As 8c 2d 5h] [Ac]
SolverSoul: checks 
pipinoelbreve9: bets €0.02
SolverSoul: folds 
Uncalled bet (€0.02) returned to pipinoelbreve9
pipinoelbreve9 collected €0.04 from pot
pipinoelbreve9: doesn't show hand 
*** SUMMARY ***
Total pot €0.04 | Rake €0 
Board [As 8c 2d 5h Ac]
Seat 1: 34pluto (button) folded before Flop (didn't bet)
Seat 2: SolverSoul (small blind) folded on the River
Seat 3: pipinoelbreve9 (big blind) collected (€0.04)
Seat 4: crissstal folded before Flop (didn't bet)
Seat 5: snowstorm-C9 folded before Flop (didn't bet)
Seat 6: V1e4ra folded before Flop (didn't bet)



PokerStars Zoom Hand #257660879921:  Hold'em No Limit (€0.01/€0.02) - 2025/09/08 14:45:45 CET [2025/09/08 8:45:45 ET]
Table 'Arneb' 6-max Seat #1 is the button
Seat 1: MDKristian (€2 in chips) 
Seat 2: kombei63 (€1.81 in chips) 
Seat 3: soyeterno (€2 in chips) 
Seat 4: swiitx (€2.32 in chips) 
Seat 5: pipinoelbreve9 (€2.40 in chips) 
Seat 6: GamerVidal (€4.22 in chips) 
kombei63: posts small blind €0.01
soyeterno: posts big blind €0.02
*** HOLE CARDS ***
Dealt to pipinoelbreve9 [Qc 2s]
swiitx: folds 
pipinoelbreve9: folds 
GamerVidal: folds 
MDKristian: folds 
kombei63: folds 
Uncalled bet (€0.01) returned to soyeterno
soyeterno collected €0.02 from pot
soyeterno: doesn't show hand 
*** SUMMARY ***
Total pot €0.02 | Rake €0 
Seat 1: MDKristian (button) folded before Flop (didn't bet)
Seat 2: kombei63 (small blind) folded before Flop
Seat 3: soyeterno (big blind) collected (€0.02)
Seat 4: swiitx folded before Flop (didn't bet)
Seat 5: pipinoelbreve9 folded before Flop (didn't bet)
Seat 6: GamerVidal folded before Flop (didn't bet)



PokerStars Zoom Hand #257660879213:  Hold'em No Limit (€0.01/€0.02) - 2025/09/08 14:45:40 CET [2025/09/08 8:45:40 ET]
Table 'Arneb' 6-max Seat #1 is the button
Seat 1: kombei63 (€1.81 in chips) 
Seat 2: pipinoelbreve9 (€2.41 in chips) 
Seat 3: Percu32 (€3.27 in chips) 
Seat 4: EiramSenpai (€1.01 in chips) 
Seat 5: Phamtom123 (€0.84 in chips) 
Seat 6: yunowme (€5.11 in chips) 
pipinoelbreve9: posts small blind €0.01
Percu32: posts big blind €0.02
*** HOLE CARDS ***
Dealt to pipinoelbreve9 [8d 2s]
EiramSenpai: folds 
Phamtom123: folds 
yunowme: raises €0.03 to €0.05
kombei63: folds 
pipinoelbreve9: folds 
Percu32: calls €0.03
*** FLOP *** [8s Qc 3s]
Percu32: checks 
yunowme: checks 
*** TURN *** [8s Qc 3s] [6s]
Percu32: checks 
yunowme: checks 
*** RIVER *** [8s Qc 3s 6s] [Th]
Percu32: bets €0.10
yunowme: folds 
Uncalled bet (€0.10) returned to Percu32
Percu32 collected €0.10 from pot
Percu32: doesn't show hand 
*** SUMMARY ***
Total pot €0.11 | Rake €0.01 
Board [8s Qc 3s 6s Th]
Seat 1: kombei63 (button) folded before Flop (didn't bet)
Seat 2: pipinoelbreve9 (small blind) folded before Flop
Seat 3: Percu32 (big blind) collected (€0.10)
Seat 4: EiramSenpai folded before Flop (didn't bet)
Seat 5: Phamtom123 folded before Flop (didn't bet)
Seat 6: yunowme folded on the River



PokerStars Zoom Hand #257660880911:  Hold'em No Limit (€0.01/€0.02) - 2025/09/08 14:45:53 CET [2025/09/08 8:45:53 ET]
Table 'Arneb' 6-max Seat #1 is the button
Seat 1: snowstorm-C9 (€2.02 in chips) 
Seat 2: WHY?NOW IS (€2.02 in chips) 
Seat 3: Pachysander (€2.66 in chips) 
Seat 4: GamerVidal (€2.08 in chips) 
Seat 5: osking118 (€3.37 in chips) 
Seat 6: pipinoelbreve9 (€2.40 in chips) 
WHY?NOW IS: posts small blind €0.01
Pachysander: posts big blind €0.02
*** HOLE CARDS ***
Dealt to pipinoelbreve9 [4c 3c]
GamerVidal: folds 
osking118: folds 
pipinoelbreve9: folds 
snowstorm-C9: folds 
WHY?NOW IS: calls €0.01
Pachysander: checks 
*** FLOP *** [5h Qh 8s]
WHY?NOW IS: checks 
Pachysander: bets €0.04
WHY?NOW IS: calls €0.04
*** TURN *** [5h Qh 8s] [7d]
WHY?NOW IS: checks 
Pachysander: checks 
*** RIVER *** [5h Qh 8s 7d] [3d]
WHY?NOW IS: bets €0.08
Pachysander: folds 
Uncalled bet (€0.08) returned to WHY?NOW IS
WHY?NOW IS collected €0.11 from pot
WHY?NOW IS: doesn't show hand 
*** SUMMARY ***
Total pot €0.12 | Rake €0.01 
Board [5h Qh 8s 7d 3d]
Seat 1: snowstorm-C9 (button) folded before Flop (didn't bet)
Seat 2: WHY?NOW IS (small blind) collected (€0.11)
Seat 3: Pachysander (big blind) folded on the River
Seat 4: GamerVidal folded before Flop (didn't bet)
Seat 5: osking118 folded before Flop (didn't bet)
Seat 6: pipinoelbreve9 folded before Flop (didn't bet)



PokerStars Zoom Hand #257660883666:  Hold'em No Limit (€0.01/€0.02) - 2025/09/08 14:46:13 CET [2025/09/08 8:46:13 ET]
Table 'Arneb' 6-max Seat #1 is the button
Seat 1: pipinoelbreve9 (€2.40 in chips) 
Seat 2: SMN242 (€2.35 in chips) 
Seat 3: GamerVidal (€2.08 in chips) 
Seat 4: SolverSoul (€1.40 in chips) 
Seat 5: V1e4ra (€2.43 in chips) 
Seat 6: Chrisbug33 (€1.81 in chips) 
SMN242: posts small blind €0.01
GamerVidal: posts big blind €0.02
*** HOLE CARDS ***
Dealt to pipinoelbreve9 [Ac Js]
SolverSoul: folds 
V1e4ra: folds 
Chrisbug33: folds 
pipinoelbreve9: raises €0.04 to €0.06
SMN242: folds 
GamerVidal: calls €0.04
*** FLOP *** [6d 3d Ad]
GamerVidal: checks 
pipinoelbreve9: checks 
*** TURN *** [6d 3d Ad] [Jh]
GamerVidal: checks 
pipinoelbreve9: bets €0.06
GamerVidal: calls €0.06
*** RIVER *** [6d 3d Ad Jh] [Qc]
GamerVidal: checks 
pipinoelbreve9: bets €0.12
GamerVidal: folds 
Uncalled bet (€0.12) returned to pipinoelbreve9
pipinoelbreve9 collected €0.24 from pot
pipinoelbreve9: doesn't show hand 
*** SUMMARY ***
Total pot €0.25 | Rake €0.01 
Board [6d 3d Ad Jh Qc]
Seat 1: pipinoelbreve9 (button) collected (€0.24)
Seat 2: SMN242 (small blind) folded before Flop
Seat 3: GamerVidal (big blind) folded on the River
Seat 4: SolverSoul folded before Flop (didn't bet)
Seat 5: V1e4ra folded before Flop (didn't bet)
Seat 6: Chrisbug33 folded before Flop (didn't bet)



PokerStars Zoom Hand #257660896332:  Hold'em No Limit (€0.01/€0.02) - 2025/09/08 14:47:50 CET [2025/09/08 8:47:50 ET]
Table 'Arneb' 6-max Seat #1 is the button
Seat 1: PerParFr (€2 in chips) 
Seat 2: GamerVidal (€4.64 in chips) 
Seat 3: V1e4ra (€3.03 in chips) 
Seat 4: pipinoelbreve9 (€2.52 in chips) 
Seat 5: MDKristian (€2.05 in chips) 
Seat 6: 34pluto (€1.50 in chips) 
GamerVidal: posts small blind €0.01
V1e4ra: posts big blind €0.02
*** HOLE CARDS ***
Dealt to pipinoelbreve9 [Kc 8c]
pipinoelbreve9: raises €0.04 to €0.06
MDKristian: folds 
34pluto: folds 
PerParFr: folds 
GamerVidal: folds 
V1e4ra: calls €0.04
*** FLOP *** [5s Ts Qd]
V1e4ra: checks 
pipinoelbreve9: checks 
*** TURN *** [5s Ts Qd] [4c]
V1e4ra: bets €0.07
pipinoelbreve9: folds 
Uncalled bet (€0.07) returned to V1e4ra
V1e4ra collected €0.12 from pot
V1e4ra: doesn't show hand 
*** SUMMARY ***
Total pot €0.13 | Rake €0.01 
Board [5s Ts Qd 4c]
Seat 1: PerParFr (button) folded before Flop (didn't bet)
Seat 2: GamerVidal (small blind) folded before Flop
Seat 3: V1e4ra (big blind) collected (€0.12)
Seat 4: pipinoelbreve9 folded on the Turn
Seat 5: MDKristian folded before Flop (didn't bet)
Seat 6: 34pluto folded before Flop (didn't bet)



PokerStars Zoom Hand #257660900543:  Hold'em No Limit (€0.01/€0.02) - 2025/09/08 14:48:22 CET [2025/09/08 8:48:22 ET]
Table 'Arneb' 6-max Seat #1 is the button
Seat 1: cagou006 (€3.33 in chips) 
Seat 2: Percu32 (€3.54 in chips) 
Seat 3: pipinoelbreve9 (€2.46 in chips) 
Seat 4: V1e4ra (€2.33 in chips) 
Seat 5: Ivanovich960 (€4.84 in chips) 
Seat 6: clavells (€0.26 in chips) 
Percu32: posts small blind €0.01
pipinoelbreve9: posts big blind €0.02
*** HOLE CARDS ***
Dealt to pipinoelbreve9 [Ad 2c]
V1e4ra: raises €0.05 to €0.07
Ivanovich960: folds 
clavells: folds 
cagou006: folds 
Percu32: folds 
pipinoelbreve9: folds 
Uncalled bet (€0.05) returned to V1e4ra
V1e4ra collected €0.05 from pot
V1e4ra: doesn't show hand 
*** SUMMARY ***
Total pot €0.05 | Rake €0 
Seat 1: cagou006 (button) folded before Flop (didn't bet)
Seat 2: Percu32 (small blind) folded before Flop
Seat 3: pipinoelbreve9 (big blind) folded before Flop
Seat 4: V1e4ra collected (€0.05)
Seat 5: Ivanovich960 folded before Flop (didn't bet)
Seat 6: clavells folded before Flop (didn't bet)



PokerStars Zoom Hand #257660901324:  Hold'em No Limit (€0.01/€0.02) - 2025/09/08 14:48:28 CET [2025/09/08 8:48:28 ET]
Table 'Arneb' 6-max Seat #1 is the button
Seat 1: Ctr Alt Surp (€1.98 in chips) 
Seat 2: pipinoelbreve9 (€2.44 in chips) 
Seat 3: Tyrandes4pattes (€2.82 in chips) 
Seat 4: bdcscstars (€1.87 in chips) 
Seat 5: maitreyoda59 (€2.19 in chips) 
Seat 6: SMN242 (€3.06 in chips) 
pipinoelbreve9: posts small blind €0.01
Tyrandes4pattes: posts big blind €0.02
*** HOLE CARDS ***
Dealt to pipinoelbreve9 [Qs 4d]
bdcscstars: folds 
maitreyoda59: folds 
SMN242: raises €0.03 to €0.05
Ctr Alt Surp: folds 
pipinoelbreve9: folds 
Tyrandes4pattes: calls €0.03
*** FLOP *** [Ad 9d 2d]
Tyrandes4pattes: checks 
SMN242: bets €0.05
Tyrandes4pattes: folds 
Uncalled bet (€0.05) returned to SMN242
SMN242 collected €0.10 from pot
SMN242: doesn't show hand 
*** SUMMARY ***
Total pot €0.11 | Rake €0.01 
Board [Ad 9d 2d]
Seat 1: Ctr Alt Surp (button) folded before Flop (didn't bet)
Seat 2: pipinoelbreve9 (small blind) folded before Flop
Seat 3: Tyrandes4pattes (big blind) folded on the Flop
Seat 4: bdcscstars folded before Flop (didn't bet)
Seat 5: maitreyoda59 folded before Flop (didn't bet)
Seat 6: SMN242 collected (€0.10)



PokerStars Zoom Hand #257660902914:  Hold'em No Limit (€0.01/€0.02) - 2025/09/08 14:48:40 CET [2025/09/08 8:48:40 ET]
Table 'Arneb' 6-max Seat #1 is the button
Seat 1: swiitx (€1.95 in chips) 
Seat 2: soyeterno (€2 in chips) 
Seat 3: madbikeman (€1.43 in chips) 
Seat 4: clavells (€0.26 in chips) 
Seat 5: MDKristian (€2.02 in chips) 
Seat 6: pipinoelbreve9 (€2.43 in chips) 
soyeterno: posts small blind €0.01
madbikeman: posts big blind €0.02
*** HOLE CARDS ***
Dealt to pipinoelbreve9 [Ac Tc]
clavells: raises €0.02 to €0.04
MDKristian: folds 
pipinoelbreve9: calls €0.04
swiitx: folds 
soyeterno: folds 
madbikeman: folds 
*** FLOP *** [4c Td 6c]
clavells: checks 
pipinoelbreve9: bets €0.05
clavells: raises €0.17 to €0.22 and is all-in
pipinoelbreve9: calls €0.17
*** TURN *** [4c Td 6c] [9h]
*** RIVER *** [4c Td 6c 9h] [Ah]
*** SHOW DOWN ***
clavells: shows [7d 7h] (a pair of Sevens)
pipinoelbreve9: shows [Ac Tc] (two pair, Aces and Tens)
pipinoelbreve9 collected €0.52 from pot
*** SUMMARY ***
Total pot €0.55 | Rake €0.03 
Board [4c Td 6c 9h Ah]
Seat 1: swiitx (button) folded before Flop (didn't bet)
Seat 2: soyeterno (small blind) folded before Flop
Seat 3: madbikeman (big blind) folded before Flop
Seat 4: clavells showed [7d 7h] and lost with a pair of Sevens
Seat 5: MDKristian folded before Flop (didn't bet)
Seat 6: pipinoelbreve9 showed [Ac Tc] and won (€0.52) with two pair, Aces and Tens



PokerStars Zoom Hand #257660902152:  Hold'em No Limit (€0.01/€0.02) - 2025/09/08 14:48:34 CET [2025/09/08 8:48:34 ET]
Table 'Arneb' 6-max Seat #1 is the button
Seat 1: pipinoelbreve9 (€2.43 in chips) 
Seat 2: Tyrandes4pattes (€2 in chips) 
Seat 3: yunowme (€5.13 in chips) 
Seat 4: crissstal (€1.54 in chips) 
Seat 5: MDKristian (€2.02 in chips) 
Seat 6: 34pluto (€1.41 in chips) 
Tyrandes4pattes: posts small blind €0.01
yunowme: posts big blind €0.02
*** HOLE CARDS ***
Dealt to pipinoelbreve9 [5c 9d]
crissstal: folds 
MDKristian: folds 
34pluto: raises €0.02 to €0.04
pipinoelbreve9: folds 
Tyrandes4pattes: folds 
yunowme: calls €0.02
*** FLOP *** [Jd Qh Td]
yunowme: checks 
34pluto: checks 
*** TURN *** [Jd Qh Td] [Jh]
yunowme: bets €0.06
34pluto: calls €0.06
*** RIVER *** [Jd Qh Td Jh] [9s]
yunowme: checks 
34pluto: checks 
*** SHOW DOWN ***
yunowme: shows [3h Ad] (a pair of Jacks)
34pluto: shows [Ah 8h] (a straight, Eight to Queen)
34pluto collected €0.20 from pot
*** SUMMARY ***
Total pot €0.21 | Rake €0.01 
Board [Jd Qh Td Jh 9s]
Seat 1: pipinoelbreve9 (button) folded before Flop (didn't bet)
Seat 2: Tyrandes4pattes (small blind) folded before Flop
Seat 3: yunowme (big blind) showed [3h Ad] and lost with a pair of Jacks
Seat 4: crissstal folded before Flop (didn't bet)
Seat 5: MDKristian folded before Flop (didn't bet)
Seat 6: 34pluto showed [Ah 8h] and won (€0.20) with a straight, Eight to Queen



PokerStars Zoom Hand #257660906805:  Hold'em No Limit (€0.01/€0.02) - 2025/09/08 14:49:09 CET [2025/09/08 8:49:09 ET]
Table 'Arneb' 6-max Seat #1 is the button
Seat 1: ranchim (€1.97 in chips) 
Seat 2: soyeterno (€2.57 in chips) 
Seat 3: pipinoelbreve9 (€2.68 in chips) 
Seat 4: PerParFr (€2.27 in chips) 
Seat 5: MDKristian (€2 in chips) 
Seat 6: bdcscstars (€1.42 in chips) 
soyeterno: posts small blind €0.01
pipinoelbreve9: posts big blind €0.02
*** HOLE CARDS ***
Dealt to pipinoelbreve9 [Td Ad]
PerParFr: folds 
MDKristian: folds 
bdcscstars: folds 
ranchim: folds 
soyeterno: folds 
Uncalled bet (€0.01) returned to pipinoelbreve9
pipinoelbreve9 collected €0.02 from pot
pipinoelbreve9: doesn't show hand 
*** SUMMARY ***
Total pot €0.02 | Rake €0 
Seat 1: ranchim (button) folded before Flop (didn't bet)
Seat 2: soyeterno (small blind) folded before Flop
Seat 3: pipinoelbreve9 (big blind) collected (€0.02)
Seat 4: PerParFr folded before Flop (didn't bet)
Seat 5: MDKristian folded before Flop (didn't bet)
Seat 6: bdcscstars folded before Flop (didn't bet)



PokerStars Zoom Hand #257660906155:  Hold'em No Limit (€0.01/€0.02) - 2025/09/08 14:49:04 CET [2025/09/08 8:49:04 ET]
Table 'Arneb' 6-max Seat #1 is the button
Seat 1: SHoKeRoNe (€2.45 in chips) 
Seat 2: pipinoelbreve9 (€2.69 in chips) 
Seat 3: Gortrak (€2.39 in chips) 
Seat 4: EiramSenpai (€2.30 in chips) 
Seat 5: Ivanovich960 (€4.78 in chips) 
Seat 6: MDKristian (€2 in chips) 
pipinoelbreve9: posts small blind €0.01
Gortrak: posts big blind €0.02
*** HOLE CARDS ***
Dealt to pipinoelbreve9 [Ts 2s]
EiramSenpai: folds 
Ivanovich960: calls €0.02
MDKristian: folds 
SHoKeRoNe: folds 
pipinoelbreve9: folds 
Gortrak: checks 
*** FLOP *** [Ks 6c Kd]
Gortrak: checks 
Ivanovich960: checks 
*** TURN *** [Ks 6c Kd] [Js]
Gortrak: bets €0.04
Ivanovich960: calls €0.04
*** RIVER *** [Ks 6c Kd Js] [9s]
Gortrak: checks 
Ivanovich960: bets €0.24
Gortrak: calls €0.24
*** SHOW DOWN ***
Ivanovich960: shows [Td Qs] (a straight, Nine to King)
Gortrak: mucks hand 
Ivanovich960 collected €0.58 from pot
*** SUMMARY ***
Total pot €0.61 | Rake €0.03 
Board [Ks 6c Kd Js 9s]
Seat 1: SHoKeRoNe (button) folded before Flop (didn't bet)
Seat 2: pipinoelbreve9 (small blind) folded before Flop
Seat 3: Gortrak (big blind) mucked [Jd 7c]
Seat 4: EiramSenpai folded before Flop (didn't bet)
Seat 5: Ivanovich960 showed [Td Qs] and won (€0.58) with a straight, Nine to King
Seat 6: MDKristian folded before Flop (didn't bet)



PokerStars Zoom Hand #257660908694:  Hold'em No Limit (€0.01/€0.02) - 2025/09/08 14:49:23 CET [2025/09/08 8:49:23 ET]
Table 'Arneb' 6-max Seat #1 is the button
Seat 1: pipinoelbreve9 (€2.69 in chips) 
Seat 2: rccmonteiro27 (€3.15 in chips) 
Seat 3: bdcscstars (€1.41 in chips) 
Seat 4: yunowme (€5.03 in chips) 
Seat 5: davidelgnomo747 (€2.39 in chips) 
Seat 6: SolverSoul (€1.10 in chips) 
rccmonteiro27: posts small blind €0.01
bdcscstars: posts big blind €0.02
*** HOLE CARDS ***
Dealt to pipinoelbreve9 [5h 3c]
yunowme: folds 
davidelgnomo747: folds 
SolverSoul: folds 
pipinoelbreve9: folds 
rccmonteiro27 is disconnected 
rccmonteiro27 has timed out while disconnected
rccmonteiro27: folds 
Uncalled bet (€0.01) returned to bdcscstars
bdcscstars collected €0.02 from pot
bdcscstars: doesn't show hand 
*** SUMMARY ***
Total pot €0.02 | Rake €0 
Seat 1: pipinoelbreve9 (button) folded before Flop (didn't bet)
Seat 2: rccmonteiro27 (small blind) folded before Flop
Seat 3: bdcscstars (big blind) collected (€0.02)
Seat 4: yunowme folded before Flop (didn't bet)
Seat 5: davidelgnomo747 folded before Flop (didn't bet)
Seat 6: SolverSoul folded before Flop (didn't bet)



PokerStars Zoom Hand #257660909465:  Hold'em No Limit (€0.01/€0.02) - 2025/09/08 14:49:29 CET [2025/09/08 8:49:29 ET]
Table 'Arneb' 6-max Seat #1 is the button
Seat 1: osking118 (€3.04 in chips) 
Seat 2: fullben2211 (€1.38 in chips) 
Seat 3: pipinoelbreve9 (€2.69 in chips) 
Seat 4: KillVerlaine (€5.16 in chips) 
Seat 5: pokermobydik (€1.80 in chips) 
Seat 6: SHoKeRoNe (€2.45 in chips) 
fullben2211: posts small blind €0.01
pipinoelbreve9: posts big blind €0.02
*** HOLE CARDS ***
Dealt to pipinoelbreve9 [3h Th]
KillVerlaine: folds 
pokermobydik: raises €0.03 to €0.05
SHoKeRoNe: folds 
osking118: folds 
fullben2211: folds 
pipinoelbreve9: folds 
Uncalled bet (€0.03) returned to pokermobydik
pokermobydik collected €0.05 from pot
pokermobydik: doesn't show hand 
*** SUMMARY ***
Total pot €0.05 | Rake €0 
Seat 1: osking118 (button) folded before Flop (didn't bet)
Seat 2: fullben2211 (small blind) folded before Flop
Seat 3: pipinoelbreve9 (big blind) folded before Flop
Seat 4: KillVerlaine folded before Flop (didn't bet)
Seat 5: pokermobydik collected (€0.05)
Seat 6: SHoKeRoNe folded before Flop (didn't bet)



PokerStars Zoom Hand #257660901795:  Hold'em No Limit (€0.01/€0.02) - 2025/09/08 14:48:31 CET [2025/09/08 8:48:31 ET]
Table 'Arneb' 6-max Seat #1 is the button
Seat 1: RMOT100A (€2.03 in chips) 
Seat 2: madbikeman (€1.44 in chips) 
Seat 3: KillVerlaine (€5.17 in chips) 
Seat 4: pipinoelbreve9 (€2.43 in chips) 
Seat 5: davidelgnomo747 (€1.19 in chips) 
Seat 6: Chrispin94 (€2.02 in chips) 
madbikeman: posts small blind €0.01
KillVerlaine: posts big blind €0.02
*** HOLE CARDS ***
Dealt to pipinoelbreve9 [9d 6s]
pipinoelbreve9: folds 
davidelgnomo747: raises €0.02 to €0.04
Chrispin94: calls €0.04
RMOT100A: calls €0.04
madbikeman: folds 
KillVerlaine: calls €0.02
*** FLOP *** [Th 5d 3h]
KillVerlaine: checks 
davidelgnomo747: checks 
Chrispin94: bets €0.10
RMOT100A: folds 
KillVerlaine: folds 
davidelgnomo747: calls €0.10
*** TURN *** [Th 5d 3h] [7d]
davidelgnomo747: checks 
Chrispin94: checks 
*** RIVER *** [Th 5d 3h 7d] [3c]
davidelgnomo747: checks 
Chrispin94: checks 
*** SHOW DOWN ***
davidelgnomo747: shows [Td 9c] (two pair, Tens and Threes)
Chrispin94: mucks hand 
davidelgnomo747 collected €0.35 from pot
*** SUMMARY ***
Total pot €0.37 | Rake €0.02 
Board [Th 5d 3h 7d 3c]
Seat 1: RMOT100A (button) folded on the Flop
Seat 2: madbikeman (small blind) folded before Flop
Seat 3: KillVerlaine (big blind) folded on the Flop
Seat 4: pipinoelbreve9 folded before Flop (didn't bet)
Seat 5: davidelgnomo747 showed [Td 9c] and won (€0.35) with two pair, Tens and Threes
Seat 6: Chrispin94 mucked [Kh 5h]



PokerStars Zoom Hand #257660909039:  Hold'em No Limit (€0.01/€0.02) - 2025/09/08 14:49:26 CET [2025/09/08 8:49:26 ET]
Table 'Arneb' 6-max Seat #1 is the button
Seat 1: cagou006 (€3.25 in chips) 
Seat 2: RMOT100A (€1.89 in chips) 
Seat 3: kombei63 (€2.64 in chips) 
Seat 4: SolverSoul (€1.10 in chips) 
Seat 5: pipinoelbreve9 (€2.69 in chips) 
Seat 6: ranchim (€1.97 in chips) 
RMOT100A: posts small blind €0.01
kombei63: posts big blind €0.02
*** HOLE CARDS ***
Dealt to pipinoelbreve9 [6h 2h]
SolverSoul: folds 
pipinoelbreve9: folds 
ranchim: raises €0.03 to €0.05
cagou006: folds 
RMOT100A: calls €0.04
kombei63: folds 
*** FLOP *** [Ks 8h Qs]
RMOT100A: checks 
ranchim: checks 
*** TURN *** [Ks 8h Qs] [6s]
RMOT100A: bets €0.02
ranchim: folds 
Uncalled bet (€0.02) returned to RMOT100A
RMOT100A collected €0.11 from pot
RMOT100A: doesn't show hand 
*** SUMMARY ***
Total pot €0.12 | Rake €0.01 
Board [Ks 8h Qs 6s]
Seat 1: cagou006 (button) folded before Flop (didn't bet)
Seat 2: RMOT100A (small blind) collected (€0.11)
Seat 3: kombei63 (big blind) folded before Flop
Seat 4: SolverSoul folded before Flop (didn't bet)
Seat 5: pipinoelbreve9 folded before Flop (didn't bet)
Seat 6: ranchim folded on the Turn



PokerStars Zoom Hand #257660908257:  Hold'em No Limit (€0.01/€0.02) - 2025/09/08 14:49:20 CET [2025/09/08 8:49:20 ET]
Table 'Arneb' 6-max Seat #1 is the button
Seat 1: Tyrandes4pattes (€2.86 in chips) 
Seat 2: Kasiborn (€2.67 in chips) 
Seat 3: WHY?NOW IS (€1.42 in chips) 
Seat 4: damianmg10 (€1.99 in chips) 
Seat 5: swiitx (€1.89 in chips) 
Seat 6: pipinoelbreve9 (€2.69 in chips) 
Kasiborn: posts small blind €0.01
WHY?NOW IS: posts big blind €0.02
*** HOLE CARDS ***
Dealt to pipinoelbreve9 [Ah 3s]
damianmg10: raises €0.02 to €0.04
swiitx: folds 
pipinoelbreve9: folds 
Tyrandes4pattes: folds 
Kasiborn: calls €0.03
WHY?NOW IS: calls €0.02
*** FLOP *** [Tc Qs Th]
Kasiborn: checks 
WHY?NOW IS: bets €0.02
damianmg10: calls €0.02
Kasiborn: calls €0.02
*** TURN *** [Tc Qs Th] [Jd]
Kasiborn: bets €2.61 and is all-in
WHY?NOW IS: folds 
damianmg10: folds 
Uncalled bet (€2.61) returned to Kasiborn
Kasiborn collected €0.17 from pot
Kasiborn: doesn't show hand 
*** SUMMARY ***
Total pot €0.18 | Rake €0.01 
Board [Tc Qs Th Jd]
Seat 1: Tyrandes4pattes (button) folded before Flop (didn't bet)
Seat 2: Kasiborn (small blind) collected (€0.17)
Seat 3: WHY?NOW IS (big blind) folded on the Turn
Seat 4: damianmg10 folded on the Turn
Seat 5: swiitx folded before Flop (didn't bet)
Seat 6: pipinoelbreve9 folded before Flop (didn't bet)



PokerStars Zoom Hand #257660911464:  Hold'em No Limit (€0.01/€0.02) - 2025/09/08 14:49:44 CET [2025/09/08 8:49:44 ET]
Table 'Arneb' 6-max Seat #1 is the button
Seat 1: pokermobydik (€1.83 in chips) 
Seat 2: PerParFr (€2.47 in chips) 
Seat 3: fafamax666 (€1.78 in chips) 
Seat 4: V1e4ra (€2.50 in chips) 
Seat 5: pipinoelbreve9 (€2.67 in chips) 
Seat 6: Gortrak (€2.08 in chips) 
PerParFr: posts small blind €0.01
fafamax666: posts big blind €0.02
*** HOLE CARDS ***
Dealt to pipinoelbreve9 [Ac 4h]
V1e4ra: folds 
pipinoelbreve9: folds 
Gortrak: folds 
pokermobydik: raises €0.03 to €0.05
PerParFr: folds 
fafamax666: calls €0.03
*** FLOP *** [6c Qs 5s]
fafamax666: checks 
pokermobydik: checks 
*** TURN *** [6c Qs 5s] [Kd]
fafamax666: checks 
pokermobydik: bets €0.05
fafamax666: calls €0.05
*** RIVER *** [6c Qs 5s Kd] [2h]
fafamax666: checks 
pokermobydik: checks 
*** SHOW DOWN ***
fafamax666: shows [Jd Jh] (a pair of Jacks)
pokermobydik: shows [Qc Th] (a pair of Queens)
pokermobydik collected €0.20 from pot
*** SUMMARY ***
Total pot €0.21 | Rake €0.01 
Board [6c Qs 5s Kd 2h]
Seat 1: pokermobydik (button) showed [Qc Th] and won (€0.20) with a pair of Queens
Seat 2: PerParFr (small blind) folded before Flop
Seat 3: fafamax666 (big blind) showed [Jd Jh] and lost with a pair of Jacks
Seat 4: V1e4ra folded before Flop (didn't bet)
Seat 5: pipinoelbreve9 folded before Flop (didn't bet)
Seat 6: Gortrak folded before Flop (didn't bet)



PokerStars Zoom Hand #257660912120:  Hold'em No Limit (€0.01/€0.02) - 2025/09/08 14:49:48 CET [2025/09/08 8:49:48 ET]
Table 'Arneb' 6-max Seat #1 is the button
Seat 1: Ivanovich960 (€5.06 in chips) 
Seat 2: V1e4ra (€3.62 in chips) 
Seat 3: SolverSoul (€1.09 in chips) 
Seat 4: pipinoelbreve9 (€2.67 in chips) 
Seat 5: PerParFr (€2.27 in chips) 
Seat 6: snowstorm-C9 (€1.75 in chips) 
V1e4ra: posts small blind €0.01
SolverSoul: posts big blind €0.02
*** HOLE CARDS ***
Dealt to pipinoelbreve9 [Qc Ad]
pipinoelbreve9: raises €0.04 to €0.06
PerParFr: folds 
snowstorm-C9: calls €0.06
Ivanovich960: folds 
V1e4ra: folds 
SolverSoul: folds 
*** FLOP *** [As Ah 7h]
pipinoelbreve9: checks 
snowstorm-C9: checks 
*** TURN *** [As Ah 7h] [6h]
pipinoelbreve9: bets €0.07
snowstorm-C9: folds 
Uncalled bet (€0.07) returned to pipinoelbreve9
pipinoelbreve9 collected €0.14 from pot
pipinoelbreve9: doesn't show hand 
*** SUMMARY ***
Total pot €0.15 | Rake €0.01 
Board [As Ah 7h 6h]
Seat 1: Ivanovich960 (button) folded before Flop (didn't bet)
Seat 2: V1e4ra (small blind) folded before Flop
Seat 3: SolverSoul (big blind) folded before Flop
Seat 4: pipinoelbreve9 collected (€0.14)
Seat 5: PerParFr folded before Flop (didn't bet)
Seat 6: snowstorm-C9 folded on the Turn



PokerStars Zoom Hand #257660916711:  Hold'em No Limit (€0.01/€0.02) - 2025/09/08 14:50:22 CET [2025/09/08 8:50:22 ET]
Table 'Arneb' 6-max Seat #1 is the button
Seat 1: Ruca2010600 (€1.71 in chips) 
Seat 2: fafamax666 (€1.68 in chips) 
Seat 3: Tyrandes4pattes (€2.22 in chips) 
Seat 4: V1e4ra (€2.33 in chips) 
Seat 5: bdcscstars (€1.38 in chips) 
Seat 6: pipinoelbreve9 (€2.75 in chips) 
fafamax666: posts small blind €0.01
Tyrandes4pattes: posts big blind €0.02
*** HOLE CARDS ***
Dealt to pipinoelbreve9 [5h 5c]
V1e4ra: folds 
bdcscstars: folds 
pipinoelbreve9: raises €0.04 to €0.06
Ruca2010600: folds 
fafamax666: folds 
Tyrandes4pattes: folds 
Uncalled bet (€0.04) returned to pipinoelbreve9
pipinoelbreve9 collected €0.05 from pot
pipinoelbreve9: doesn't show hand 
*** SUMMARY ***
Total pot €0.05 | Rake €0 
Seat 1: Ruca2010600 (button) folded before Flop (didn't bet)
Seat 2: fafamax666 (small blind) folded before Flop
Seat 3: Tyrandes4pattes (big blind) folded before Flop
Seat 4: V1e4ra folded before Flop (didn't bet)
Seat 5: bdcscstars folded before Flop (didn't bet)
Seat 6: pipinoelbreve9 collected (€0.05)



PokerStars Zoom Hand #257660920169:  Hold'em No Limit (€0.01/€0.02) - 2025/09/08 14:50:48 CET [2025/09/08 8:50:48 ET]
Table 'Arneb' 6-max Seat #1 is the button
Seat 1: V1e4ra (€2.19 in chips) 
Seat 2: pipinoelbreve9 (€2.78 in chips) 
Seat 3: Ivanovich960 (€5.02 in chips) 
Seat 4: Tyrandes4pattes (€2.88 in chips) 
Seat 5: madbikeman (€1.48 in chips) 
Seat 6: Chrisbug33 (€1.87 in chips) 
pipinoelbreve9: posts small blind €0.01
Ivanovich960: posts big blind €0.02
*** HOLE CARDS ***
Dealt to pipinoelbreve9 [Td 4c]
Tyrandes4pattes: folds 
madbikeman: folds 
Chrisbug33: folds 
V1e4ra: folds 
pipinoelbreve9: folds 
Uncalled bet (€0.01) returned to Ivanovich960
Ivanovich960 collected €0.02 from pot
Ivanovich960: doesn't show hand 
*** SUMMARY ***
Total pot €0.02 | Rake €0 
Seat 1: V1e4ra (button) folded before Flop (didn't bet)
Seat 2: pipinoelbreve9 (small blind) folded before Flop
Seat 3: Ivanovich960 (big blind) collected (€0.02)
Seat 4: Tyrandes4pattes folded before Flop (didn't bet)
Seat 5: madbikeman folded before Flop (didn't bet)
Seat 6: Chrisbug33 folded before Flop (didn't bet)



PokerStars Zoom Hand #257660921211:  Hold'em No Limit (€0.01/€0.02) - 2025/09/08 14:50:56 CET [2025/09/08 8:50:56 ET]
Table 'Arneb' 6-max Seat #1 is the button
Seat 1: ocsur (€1.65 in chips) 
Seat 2: Chrisbug33 (€1.85 in chips) 
Seat 3: PerParFr (€2.24 in chips) 
Seat 4: pipinoelbreve9 (€2.77 in chips) 
Seat 5: Tyrandes4pattes (€2.38 in chips) 
Seat 6: SHoKeRoNe (€2.40 in chips) 
Chrisbug33: posts small blind €0.01
PerParFr: posts big blind €0.02
*** HOLE CARDS ***
Dealt to pipinoelbreve9 [Qd 6h]
pipinoelbreve9: folds 
Tyrandes4pattes: raises €0.04 to €0.06
SHoKeRoNe: folds 
ocsur: folds 
Chrisbug33: folds 
PerParFr: folds 
Uncalled bet (€0.04) returned to Tyrandes4pattes
Tyrandes4pattes collected €0.05 from pot
Tyrandes4pattes: doesn't show hand 
*** SUMMARY ***
Total pot €0.05 | Rake €0 
Seat 1: ocsur (button) folded before Flop (didn't bet)
Seat 2: Chrisbug33 (small blind) folded before Flop
Seat 3: PerParFr (big blind) folded before Flop
Seat 4: pipinoelbreve9 folded before Flop (didn't bet)
Seat 5: Tyrandes4pattes collected (€0.05)
Seat 6: SHoKeRoNe folded before Flop (didn't bet)



PokerStars Zoom Hand #257660921840:  Hold'em No Limit (€0.01/€0.02) - 2025/09/08 14:51:01 CET [2025/09/08 8:51:01 ET]
Table 'Arneb' 6-max Seat #1 is the button
Seat 1: swiitx (€1.69 in chips) 
Seat 2: ocsur (€1.65 in chips) 
Seat 3: MDKristian (€2 in chips) 
Seat 4: Chrisbug33 (€1.84 in chips) 
Seat 5: pipinoelbreve9 (€2.77 in chips) 
Seat 6: yunowme (€5.04 in chips) 
ocsur: posts small blind €0.01
MDKristian: posts big blind €0.02
*** HOLE CARDS ***
Dealt to pipinoelbreve9 [Jd 2c]
Chrisbug33: folds 
pipinoelbreve9: folds 
yunowme: raises €0.03 to €0.05
swiitx: folds 
ocsur: folds 
MDKristian: folds 
Uncalled bet (€0.03) returned to yunowme
yunowme collected €0.05 from pot
yunowme: doesn't show hand 
*** SUMMARY ***
Total pot €0.05 | Rake €0 
Seat 1: swiitx (button) folded before Flop (didn't bet)
Seat 2: ocsur (small blind) folded before Flop
Seat 3: MDKristian (big blind) folded before Flop
Seat 4: Chrisbug33 folded before Flop (didn't bet)
Seat 5: pipinoelbreve9 folded before Flop (didn't bet)
Seat 6: yunowme collected (€0.05)



PokerStars Zoom Hand #257660924126:  Hold'em No Limit (€0.01/€0.02) - 2025/09/08 14:51:18 CET [2025/09/08 8:51:18 ET]
Table 'Arneb' 6-max Seat #1 is the button
Seat 1: pipinoelbreve9 (€2.75 in chips) 
Seat 2: simplicio82 (€0.79 in chips) 
Seat 3: manolo1953 (€1.30 in chips) 
Seat 4: MDKristian (€2 in chips) 
Seat 5: EiramSenpai (€2.30 in chips) 
Seat 6: Tyrandes4pattes (€2.40 in chips) 
simplicio82: posts small blind €0.01
manolo1953: posts big blind €0.02
*** HOLE CARDS ***
Dealt to pipinoelbreve9 [4h 9s]
MDKristian: folds 
EiramSenpai: folds 
Tyrandes4pattes: raises €0.04 to €0.06
pipinoelbreve9: folds 
simplicio82: folds 
manolo1953: folds 
Uncalled bet (€0.04) returned to Tyrandes4pattes
Tyrandes4pattes collected €0.05 from pot
Tyrandes4pattes: doesn't show hand 
*** SUMMARY ***
Total pot €0.05 | Rake €0 
Seat 1: pipinoelbreve9 (button) folded before Flop (didn't bet)
Seat 2: simplicio82 (small blind) folded before Flop
Seat 3: manolo1953 (big blind) folded before Flop
Seat 4: MDKristian folded before Flop (didn't bet)
Seat 5: EiramSenpai folded before Flop (didn't bet)
Seat 6: Tyrandes4pattes collected (€0.05)



PokerStars Zoom Hand #257660922479:  Hold'em No Limit (€0.01/€0.02) - 2025/09/08 14:51:06 CET [2025/09/08 8:51:06 ET]
Table 'Arneb' 6-max Seat #1 is the button
Seat 1: sektor_mdk (€2.13 in chips) 
Seat 2: snowstorm-C9 (€1.70 in chips) 
Seat 3: pipinoelbreve9 (€2.77 in chips) 
Seat 4: Popins0011 (€3.75 in chips) 
Seat 5: simplicio82 (€0.85 in chips) 
Seat 6: swiitx (€1.69 in chips) 
snowstorm-C9: posts small blind €0.01
pipinoelbreve9: posts big blind €0.02
*** HOLE CARDS ***
Dealt to pipinoelbreve9 [5c 4c]
Popins0011: raises €0.04 to €0.06
simplicio82: calls €0.06
swiitx: folds 
sektor_mdk: raises €0.08 to €0.14
snowstorm-C9: folds 
pipinoelbreve9: folds 
Popins0011: calls €0.08
simplicio82: folds 
*** FLOP *** [4s 3s 8s]
Popins0011: checks 
sektor_mdk: bets €0.18
Popins0011: calls €0.18
*** TURN *** [4s 3s 8s] [6d]
Popins0011: bets €0.31
sektor_mdk: calls €0.31
*** RIVER *** [4s 3s 8s 6d] [5s]
Popins0011: checks 
sektor_mdk: checks 
*** SHOW DOWN ***
Popins0011: shows [Ts Td] (a flush, Ten high)
sektor_mdk: mucks hand 
Popins0011 collected €1.28 from pot
*** SUMMARY ***
Total pot €1.35 | Rake €0.07 
Board [4s 3s 8s 6d 5s]
Seat 1: sektor_mdk (button) mucked [Ad Ac]
Seat 2: snowstorm-C9 (small blind) folded before Flop
Seat 3: pipinoelbreve9 (big blind) folded before Flop
Seat 4: Popins0011 showed [Ts Td] and won (€1.28) with a flush, Ten high
Seat 5: simplicio82 folded before Flop
Seat 6: swiitx folded before Flop (didn't bet)



PokerStars Zoom Hand #257660924640:  Hold'em No Limit (€0.01/€0.02) - 2025/09/08 14:51:22 CET [2025/09/08 8:51:22 ET]
Table 'Arneb' 6-max Seat #1 is the button
Seat 1: rccmonteiro27 (€1.94 in chips) 
Seat 2: pipinoelbreve9 (€2.75 in chips) 
Seat 3: simplicio82 (€0.78 in chips) 
Seat 4: Gortrak (€2.09 in chips) 
Seat 5: V1e4ra (€2.39 in chips) 
Seat 6: MDKristian (€2 in chips) 
pipinoelbreve9: posts small blind €0.01
simplicio82: posts big blind €0.02
*** HOLE CARDS ***
Dealt to pipinoelbreve9 [Qh 9s]
Gortrak: raises €0.03 to €0.05
V1e4ra: folds 
MDKristian: folds 
rccmonteiro27: raises €0.11 to €0.16
pipinoelbreve9: folds 
simplicio82: calls €0.14
Gortrak: raises €0.49 to €0.65
rccmonteiro27: calls €0.49
simplicio82: folds 
*** FLOP *** [9c 5d Jd]
Gortrak: bets €1.44 and is all-in
rccmonteiro27: folds 
Uncalled bet (€1.44) returned to Gortrak
Gortrak collected €1.40 from pot
Gortrak: doesn't show hand 
*** SUMMARY ***
Total pot €1.47 | Rake €0.07 
Board [9c 5d Jd]
Seat 1: rccmonteiro27 (button) folded on the Flop
Seat 2: pipinoelbreve9 (small blind) folded before Flop
Seat 3: simplicio82 (big blind) folded before Flop
Seat 4: Gortrak collected (€1.40)
Seat 5: V1e4ra folded before Flop (didn't bet)
Seat 6: MDKristian folded before Flop (didn't bet)



PokerStars Zoom Hand #257660926346:  Hold'em No Limit (€0.01/€0.02) - 2025/09/08 14:51:35 CET [2025/09/08 8:51:35 ET]
Table 'Arneb' 6-max Seat #1 is the button
Seat 1: pipinoelbreve9 (€2.74 in chips) 
Seat 2: Prim24 (€2.23 in chips) 
Seat 3: Percu32 (€3.66 in chips) 
Seat 4: Tyrandes4pattes (€2.19 in chips) 
Seat 5: snowstorm-C9 (€1.69 in chips) 
Seat 6: V1e4ra (€2.13 in chips) 
Prim24: posts small blind €0.01
Percu32: posts big blind €0.02
*** HOLE CARDS ***
Dealt to pipinoelbreve9 [Kd Ac]
Tyrandes4pattes: raises €0.02 to €0.04
snowstorm-C9: calls €0.04
V1e4ra: calls €0.04
pipinoelbreve9: raises €0.20 to €0.24
Prim24: folds 
Percu32: folds 
Tyrandes4pattes: folds 
snowstorm-C9: folds 
V1e4ra: calls €0.20
*** FLOP *** [Kh Qh Kc]
V1e4ra: checks 
pipinoelbreve9: bets €0.16
V1e4ra: folds 
Uncalled bet (€0.16) returned to pipinoelbreve9
pipinoelbreve9 collected €0.56 from pot
pipinoelbreve9: doesn't show hand 
*** SUMMARY ***
Total pot €0.59 | Rake €0.03 
Board [Kh Qh Kc]
Seat 1: pipinoelbreve9 (button) collected (€0.56)
Seat 2: Prim24 (small blind) folded before Flop
Seat 3: Percu32 (big blind) folded before Flop
Seat 4: Tyrandes4pattes folded before Flop
Seat 5: snowstorm-C9 folded before Flop
Seat 6: V1e4ra folded on the Flop



PokerStars Zoom Hand #257660935198:  Hold'em No Limit (€0.01/€0.02) - 2025/09/08 14:52:42 CET [2025/09/08 8:52:42 ET]
Table 'Arneb' 6-max Seat #1 is the button
Seat 1: kombei63 (€2.46 in chips) 
Seat 2: D Tasmania (€1.63 in chips) 
Seat 3: pipinoelbreve9 (€3.06 in chips) 
Seat 4: Tyrandes4pattes (€2.63 in chips) 
Seat 5: MDKristian (€2.18 in chips) 
Seat 6: V1e4ra (€1.88 in chips) 
D Tasmania: posts small blind €0.01
pipinoelbreve9: posts big blind €0.02
*** HOLE CARDS ***
Dealt to pipinoelbreve9 [5s 9c]
Tyrandes4pattes: folds 
MDKristian: folds 
V1e4ra: folds 
kombei63: raises €0.04 to €0.06
D Tasmania: folds 
pipinoelbreve9: folds 
Uncalled bet (€0.04) returned to kombei63
kombei63 collected €0.05 from pot
kombei63: doesn't show hand 
*** SUMMARY ***
Total pot €0.05 | Rake €0 
Seat 1: kombei63 (button) collected (€0.05)
Seat 2: D Tasmania (small blind) folded before Flop
Seat 3: pipinoelbreve9 (big blind) folded before Flop
Seat 4: Tyrandes4pattes folded before Flop (didn't bet)
Seat 5: MDKristian folded before Flop (didn't bet)
Seat 6: V1e4ra folded before Flop (didn't bet)



PokerStars Zoom Hand #257660936432:  Hold'em No Limit (€0.01/€0.02) - 2025/09/08 14:52:51 CET [2025/09/08 8:52:51 ET]
Table 'Arneb' 6-max Seat #1 is the button
Seat 1: Gortrak (€2.72 in chips) 
Seat 2: combinius1 (€2 in chips) 
Seat 3: Bestiote (€0.89 in chips) 
Seat 4: damianmg10 (€2.55 in chips) 
Seat 5: MDKristian (€2.10 in chips) 
Seat 6: pipinoelbreve9 (€3.04 in chips) 
combinius1: posts small blind €0.01
Bestiote: posts big blind €0.02
*** HOLE CARDS ***
Dealt to pipinoelbreve9 [6s Qc]
damianmg10: folds 
MDKristian: folds 
pipinoelbreve9: folds 
Gortrak: folds 
combinius1: folds 
Uncalled bet (€0.01) returned to Bestiote
Bestiote collected €0.02 from pot
Bestiote: doesn't show hand 
*** SUMMARY ***
Total pot €0.02 | Rake €0 
Seat 1: Gortrak (button) folded before Flop (didn't bet)
Seat 2: combinius1 (small blind) folded before Flop
Seat 3: Bestiote (big blind) collected (€0.02)
Seat 4: damianmg10 folded before Flop (didn't bet)
Seat 5: MDKristian folded before Flop (didn't bet)
Seat 6: pipinoelbreve9 folded before Flop (didn't bet)



PokerStars Zoom Hand #257660937064:  Hold'em No Limit (€0.01/€0.02) - 2025/09/08 14:52:56 CET [2025/09/08 8:52:56 ET]
Table 'Arneb' 6-max Seat #1 is the button
Seat 1: V1e4ra (€2.48 in chips) 
Seat 2: pipinoelbreve9 (€3.04 in chips) 
Seat 3: kombei63 (€2.49 in chips) 
Seat 4: WHY?NOW IS (€1.71 in chips) 
Seat 5: fafamax666 (€1.53 in chips) 
Seat 6: Gortrak (€2.72 in chips) 
pipinoelbreve9: posts small blind €0.01
kombei63: posts big blind €0.02
*** HOLE CARDS ***
Dealt to pipinoelbreve9 [8d 9c]
WHY?NOW IS: raises €0.05 to €0.07
fafamax666: folds 
Gortrak: folds 
V1e4ra: folds 
pipinoelbreve9: folds 
kombei63: folds 
Uncalled bet (€0.05) returned to WHY?NOW IS
WHY?NOW IS collected €0.05 from pot
WHY?NOW IS: doesn't show hand 
*** SUMMARY ***
Total pot €0.05 | Rake €0 
Seat 1: V1e4ra (button) folded before Flop (didn't bet)
Seat 2: pipinoelbreve9 (small blind) folded before Flop
Seat 3: kombei63 (big blind) folded before Flop
Seat 4: WHY?NOW IS collected (€0.05)
Seat 5: fafamax666 folded before Flop (didn't bet)
Seat 6: Gortrak folded before Flop (didn't bet)



PokerStars Zoom Hand #257660934273:  Hold'em No Limit (€0.01/€0.02) - 2025/09/08 14:52:35 CET [2025/09/08 8:52:35 ET]
Table 'Arneb' 6-max Seat #1 is the button
Seat 1: punisher1106 (€1.76 in chips) 
Seat 2: Tyrandes4pattes (€2.64 in chips) 
Seat 3: davidelgnomo747 (€2.41 in chips) 
Seat 4: osking118 (€2 in chips) 
Seat 5: 34pluto (€1.59 in chips) 
Seat 6: pipinoelbreve9 (€3.06 in chips) 
Tyrandes4pattes: posts small blind €0.01
davidelgnomo747: posts big blind €0.02
*** HOLE CARDS ***
Dealt to pipinoelbreve9 [3h Qd]
osking118: folds 
34pluto: calls €0.02
pipinoelbreve9: folds 
punisher1106: folds 
Tyrandes4pattes: folds 
davidelgnomo747: checks 
*** FLOP *** [2c 9c 3s]
davidelgnomo747: checks 
34pluto: checks 
*** TURN *** [2c 9c 3s] [Ad]
davidelgnomo747: bets €0.05
34pluto: calls €0.05
*** RIVER *** [2c 9c 3s Ad] [6c]
davidelgnomo747: checks 
34pluto: bets €0.18
davidelgnomo747: folds 
Uncalled bet (€0.18) returned to 34pluto
34pluto collected €0.14 from pot
34pluto: doesn't show hand 
*** SUMMARY ***
Total pot €0.15 | Rake €0.01 
Board [2c 9c 3s Ad 6c]
Seat 1: punisher1106 (button) folded before Flop (didn't bet)
Seat 2: Tyrandes4pattes (small blind) folded before Flop
Seat 3: davidelgnomo747 (big blind) folded on the River
Seat 4: osking118 folded before Flop (didn't bet)
Seat 5: 34pluto collected (€0.14)
Seat 6: pipinoelbreve9 folded before Flop (didn't bet)



PokerStars Zoom Hand #257660939189:  Hold'em No Limit (€0.01/€0.02) - 2025/09/08 14:53:12 CET [2025/09/08 8:53:12 ET]
Table 'Arneb' 6-max Seat #1 is the button
Seat 1: pipinoelbreve9 (€3.03 in chips) 
Seat 2: MDKristian (€2.08 in chips) 
Seat 3: V1e4ra (€3.48 in chips) 
Seat 4: Percu32 (€3.62 in chips) 
Seat 5: SMN242 (€3.04 in chips) 
Seat 6: sektor_mdk (€1.45 in chips) 
MDKristian: posts small blind €0.01
V1e4ra: posts big blind €0.02
*** HOLE CARDS ***
Dealt to pipinoelbreve9 [7h 5d]
Percu32: folds 
SMN242: folds 
sektor_mdk: folds 
pipinoelbreve9: folds 
MDKristian: folds 
Uncalled bet (€0.01) returned to V1e4ra
V1e4ra collected €0.02 from pot
V1e4ra: doesn't show hand 
*** SUMMARY ***
Total pot €0.02 | Rake €0 
Seat 1: pipinoelbreve9 (button) folded before Flop (didn't bet)
Seat 2: MDKristian (small blind) folded before Flop
Seat 3: V1e4ra (big blind) collected (€0.02)
Seat 4: Percu32 folded before Flop (didn't bet)
Seat 5: SMN242 folded before Flop (didn't bet)
Seat 6: sektor_mdk folded before Flop (didn't bet)



PokerStars Zoom Hand #257660934727:  Hold'em No Limit (€0.01/€0.02) - 2025/09/08 14:52:38 CET [2025/09/08 8:52:38 ET]
Table 'Arneb' 6-max Seat #1 is the button
Seat 1: Pachysander (€1.85 in chips) 
Seat 2: ranchim (€1.91 in chips) 
Seat 3: Popins0011 (€4.45 in chips) 
Seat 4: pipinoelbreve9 (€3.06 in chips) 
Seat 5: kombei63 (€2.46 in chips) 
Seat 6: osking118 (€2 in chips) 
ranchim: posts small blind €0.01
Popins0011: posts big blind €0.02
*** HOLE CARDS ***
Dealt to pipinoelbreve9 [7c 9h]
pipinoelbreve9: folds 
kombei63: folds 
osking118: folds 
Pachysander: raises €0.04 to €0.06
ranchim: folds 
Popins0011: calls €0.04
*** FLOP *** [Js 4d Kh]
Popins0011: checks 
Pachysander: checks 
*** TURN *** [Js 4d Kh] [Ad]
Popins0011: checks 
Pachysander: bets €0.12
Popins0011: calls €0.12
*** RIVER *** [Js 4d Kh Ad] [6h]
Popins0011: checks 
Pachysander: bets €0.18
Popins0011: raises €0.38 to €0.56
Pachysander: calls €0.38
*** SHOW DOWN ***
Popins0011: shows [Kd Jh] (two pair, Kings and Jacks)
Pachysander: mucks hand 
Popins0011 collected €1.42 from pot
*** SUMMARY ***
Total pot €1.49 | Rake €0.07 
Board [Js 4d Kh Ad 6h]
Seat 1: Pachysander (button) mucked [Ac Qh]
Seat 2: ranchim (small blind) folded before Flop
Seat 3: Popins0011 (big blind) showed [Kd Jh] and won (€1.42) with two pair, Kings and Jacks
Seat 4: pipinoelbreve9 folded before Flop (didn't bet)
Seat 5: kombei63 folded before Flop (didn't bet)
Seat 6: osking118 folded before Flop (didn't bet)



PokerStars Zoom Hand #257661026575:  Hold'em No Limit (€0.01/€0.02) - 2025/09/08 15:05:16 CET [2025/09/08 9:05:16 ET]
Table 'Arneb' 6-max Seat #1 is the button
Seat 1: crissstal (€1.41 in chips) 
Seat 2: V1e4ra (€2.76 in chips) 
Seat 3: pipinoelbreve9 (€2 in chips) 
Seat 4: MDKristian (€2.13 in chips) 
Seat 5: Percu32 (€2.92 in chips) 
Seat 6: ABotillo12 (€2 in chips) 
V1e4ra: posts small blind €0.01
pipinoelbreve9: posts big blind €0.02
*** HOLE CARDS ***
Dealt to pipinoelbreve9 [Ts 4s]
MDKristian: raises €0.02 to €0.04
Percu32: calls €0.04
ABotillo12: raises €0.12 to €0.16
crissstal: folds 
V1e4ra: folds 
pipinoelbreve9: folds 
MDKristian: folds 
Percu32: calls €0.12
*** FLOP *** [6s Ks 4d]
Percu32: checks 
ABotillo12: bets €0.12
Percu32: folds 
Uncalled bet (€0.12) returned to ABotillo12
ABotillo12 collected €0.37 from pot
ABotillo12: doesn't show hand 
*** SUMMARY ***
Total pot €0.39 | Rake €0.02 
Board [6s Ks 4d]
Seat 1: crissstal (button) folded before Flop (didn't bet)
Seat 2: V1e4ra (small blind) folded before Flop
Seat 3: pipinoelbreve9 (big blind) folded before Flop
Seat 4: MDKristian folded before Flop
Seat 5: Percu32 folded on the Flop
Seat 6: ABotillo12 collected (€0.37)



PokerStars Zoom Hand #257661027900:  Hold'em No Limit (€0.01/€0.02) - 2025/09/08 15:05:26 CET [2025/09/08 9:05:26 ET]
Table 'Arneb' 6-max Seat #1 is the button
Seat 1: pipinoelbreve9 (€2 in chips) 
Seat 2: V1e4ra (€1.36 in chips) 
Seat 3: leobcn9 (€2 in chips) 
Seat 4: 34pluto (€1.53 in chips) 
Seat 5: maitreyoda59 (€3.55 in chips) 
Seat 6: Tyrandes4pattes (€2.56 in chips) 
V1e4ra: posts small blind €0.01
leobcn9: posts big blind €0.02
*** HOLE CARDS ***
Dealt to pipinoelbreve9 [5s Kd]
34pluto: folds 
maitreyoda59: raises €0.02 to €0.04
Tyrandes4pattes: folds 
pipinoelbreve9: folds 
V1e4ra: calls €0.03
leobcn9: folds 
*** FLOP *** [3h 7c Ah]
V1e4ra: checks 
maitreyoda59: bets €0.05
V1e4ra: calls €0.05
*** TURN *** [3h 7c Ah] [4h]
V1e4ra: checks 
maitreyoda59: checks 
*** RIVER *** [3h 7c Ah 4h] [9d]
V1e4ra: bets €0.16
maitreyoda59: folds 
Uncalled bet (€0.16) returned to V1e4ra
V1e4ra collected €0.19 from pot
V1e4ra: doesn't show hand 
*** SUMMARY ***
Total pot €0.20 | Rake €0.01 
Board [3h 7c Ah 4h 9d]
Seat 1: pipinoelbreve9 (button) folded before Flop (didn't bet)
Seat 2: V1e4ra (small blind) collected (€0.19)
Seat 3: leobcn9 (big blind) folded before Flop
Seat 4: 34pluto folded before Flop (didn't bet)
Seat 5: maitreyoda59 folded on the River
Seat 6: Tyrandes4pattes folded before Flop (didn't bet)



PokerStars Zoom Hand #257661028993:  Hold'em No Limit (€0.01/€0.02) - 2025/09/08 15:05:35 CET [2025/09/08 9:05:35 ET]
Table 'Arneb' 6-max Seat #1 is the button
Seat 1: Kasiborn (€0.96 in chips) 
Seat 2: pipinoelbreve9 (€2 in chips) 
Seat 3: combinius1 (€2.68 in chips) 
Seat 4: yunowme (€2.14 in chips) 
Seat 5: chitigordi78 (€6.79 in chips) 
Seat 6: Jackeuj32 (€0.80 in chips) 
pipinoelbreve9: posts small blind €0.01
combinius1: posts big blind €0.02
*** HOLE CARDS ***
Dealt to pipinoelbreve9 [9d Ac]
yunowme: folds 
chitigordi78: calls €0.02
Jackeuj32: calls €0.02
Kasiborn: folds 
pipinoelbreve9: calls €0.01
combinius1: checks 
*** FLOP *** [2s 9s Jc]
pipinoelbreve9: checks 
combinius1: checks 
chitigordi78: checks 
Jackeuj32: checks 
*** TURN *** [2s 9s Jc] [7c]
pipinoelbreve9: bets €0.04
combinius1: calls €0.04
chitigordi78: folds 
Jackeuj32: calls €0.04
*** RIVER *** [2s 9s Jc 7c] [Qd]
pipinoelbreve9: checks 
combinius1: checks 
Jackeuj32: checks 
*** SHOW DOWN ***
pipinoelbreve9: shows [9d Ac] (a pair of Nines)
combinius1: mucks hand 
Jackeuj32: mucks hand 
pipinoelbreve9 collected €0.19 from pot
*** SUMMARY ***
Total pot €0.20 | Rake €0.01 
Board [2s 9s Jc 7c Qd]
Seat 1: Kasiborn (button) folded before Flop (didn't bet)
Seat 2: pipinoelbreve9 (small blind) showed [9d Ac] and won (€0.19) with a pair of Nines
Seat 3: combinius1 (big blind) mucked [7s Ad]
Seat 4: yunowme folded before Flop (didn't bet)
Seat 5: chitigordi78 folded on the Turn
Seat 6: Jackeuj32 mucked [8d 5s]



PokerStars Zoom Hand #257661047228:  Hold'em No Limit (€0.01/€0.02) - 2025/09/08 15:07:50 CET [2025/09/08 9:07:50 ET]
Table 'Arneb' 6-max Seat #1 is the button
Seat 1: Tyrandes4pattes (€2.36 in chips) 
Seat 2: rccmonteiro27 (€2.03 in chips) 
Seat 3: soyeterno (€2 in chips) 
Seat 4: Jackeuj32 (€0.74 in chips) 
Seat 5: xaratax (€2.23 in chips) 
Seat 6: pipinoelbreve9 (€2.13 in chips) 
rccmonteiro27: posts small blind €0.01
soyeterno: posts big blind €0.02
*** HOLE CARDS ***
Dealt to pipinoelbreve9 [8s Qh]
Jackeuj32 has timed out
Jackeuj32: folds 
xaratax: folds 
pipinoelbreve9: raises €0.04 to €0.06
Tyrandes4pattes: folds 
rccmonteiro27: folds 
soyeterno: folds 
Uncalled bet (€0.04) returned to pipinoelbreve9
pipinoelbreve9 collected €0.05 from pot
pipinoelbreve9: doesn't show hand 
*** SUMMARY ***
Total pot €0.05 | Rake €0 
Seat 1: Tyrandes4pattes (button) folded before Flop (didn't bet)
Seat 2: rccmonteiro27 (small blind) folded before Flop
Seat 3: soyeterno (big blind) folded before Flop
Seat 4: Jackeuj32 folded before Flop (didn't bet)
Seat 5: xaratax folded before Flop (didn't bet)
Seat 6: pipinoelbreve9 collected (€0.05)



PokerStars Zoom Hand #257661054485:  Hold'em No Limit (€0.01/€0.02) - 2025/09/08 15:08:45 CET [2025/09/08 9:08:45 ET]
Table 'Arneb' 6-max Seat #1 is the button
Seat 1: Tyrandes4pattes (€3.60 in chips) 
Seat 2: pipinoelbreve9 (€2.10 in chips) 
Seat 3: MDKristian (€2 in chips) 
Seat 4: GamerVidal (€7.10 in chips) 
Seat 5: SUNTZU47 (€1.41 in chips) 
Seat 6: soyeterno (€3.80 in chips) 
pipinoelbreve9: posts small blind €0.01
MDKristian: posts big blind €0.02
*** HOLE CARDS ***
Dealt to pipinoelbreve9 [Ad Ts]
GamerVidal: folds 
SUNTZU47: folds 
soyeterno: folds 
Tyrandes4pattes: folds 
pipinoelbreve9: raises €0.04 to €0.06
MDKristian: folds 
Uncalled bet (€0.04) returned to pipinoelbreve9
pipinoelbreve9 collected €0.04 from pot
pipinoelbreve9: doesn't show hand 
*** SUMMARY ***
Total pot €0.04 | Rake €0 
Seat 1: Tyrandes4pattes (button) folded before Flop (didn't bet)
Seat 2: pipinoelbreve9 (small blind) collected (€0.04)
Seat 3: MDKristian (big blind) folded before Flop
Seat 4: GamerVidal folded before Flop (didn't bet)
Seat 5: SUNTZU47 folded before Flop (didn't bet)
Seat 6: soyeterno folded before Flop (didn't bet)



PokerStars Zoom Hand #257661049921:  Hold'em No Limit (€0.01/€0.02) - 2025/09/08 15:08:10 CET [2025/09/08 9:08:10 ET]
Table 'Arneb' 6-max Seat #1 is the button
Seat 1: MDKristian (€2.19 in chips) 
Seat 2: V1e4ra (€4.17 in chips) 
Seat 3: MichaëLR7 (€1.93 in chips) 
Seat 4: pipinoelbreve9 (€2.16 in chips) 
Seat 5: rccmonteiro27 (€2.02 in chips) 
Seat 6: Bestiote (€0.88 in chips) 
V1e4ra: posts small blind €0.01
MichaëLR7: posts big blind €0.02
*** HOLE CARDS ***
Dealt to pipinoelbreve9 [Qs 3d]
pipinoelbreve9: folds 
rccmonteiro27: folds 
Bestiote: folds 
MDKristian: raises €0.02 to €0.04
V1e4ra: folds 
MichaëLR7: calls €0.02
*** FLOP *** [Jh As 7d]
MichaëLR7: checks 
MDKristian: bets €0.09
MichaëLR7: calls €0.09
*** TURN *** [Jh As 7d] [8h]
MichaëLR7: checks 
MDKristian: bets €0.20
MichaëLR7: calls €0.20
*** RIVER *** [Jh As 7d 8h] [4d]
MichaëLR7: checks 
MDKristian: bets €0.32
MichaëLR7: folds 
Uncalled bet (€0.32) returned to MDKristian
MDKristian collected €0.64 from pot
MDKristian: doesn't show hand 
*** SUMMARY ***
Total pot €0.67 | Rake €0.03 
Board [Jh As 7d 8h 4d]
Seat 1: MDKristian (button) collected (€0.64)
Seat 2: V1e4ra (small blind) folded before Flop
Seat 3: MichaëLR7 (big blind) folded on the River
Seat 4: pipinoelbreve9 folded before Flop (didn't bet)
Seat 5: rccmonteiro27 folded before Flop (didn't bet)
Seat 6: Bestiote folded before Flop (didn't bet)



PokerStars Zoom Hand #257661050722:  Hold'em No Limit (€0.01/€0.02) - 2025/09/08 15:08:16 CET [2025/09/08 9:08:16 ET]
Table 'Arneb' 6-max Seat #1 is the button
Seat 1: -M-Cedric-78 (€1.06 in chips) 
Seat 2: soyeterno (€2 in chips) 
Seat 3: xaratax (€2.22 in chips) 
Seat 4: ocsur (€2.96 in chips) 
Seat 5: pipinoelbreve9 (€2.16 in chips) 
Seat 6: SMN242 (€2.65 in chips) 
soyeterno: posts small blind €0.01
xaratax: posts big blind €0.02
*** HOLE CARDS ***
Dealt to pipinoelbreve9 [8c 8h]
ocsur: folds 
pipinoelbreve9: raises €0.04 to €0.06
SMN242: folds 
-M-Cedric-78: calls €0.06
soyeterno: folds 
xaratax: raises €0.18 to €0.24
pipinoelbreve9: folds 
-M-Cedric-78: calls €0.18
*** FLOP *** [Ah 3c 4d]
xaratax: checks 
-M-Cedric-78: bets €0.26
xaratax: calls €0.26
*** TURN *** [Ah 3c 4d] [6d]
xaratax: checks 
-M-Cedric-78: bets €0.51
xaratax: calls €0.51
*** RIVER *** [Ah 3c 4d 6d] [Jc]
xaratax: checks 
-M-Cedric-78: bets €0.05 and is all-in
xaratax: calls €0.05
*** SHOW DOWN ***
-M-Cedric-78: shows [Ad Ks] (a pair of Aces)
xaratax: shows [Qs Ac] (a pair of Aces - lower kicker)
-M-Cedric-78 collected €2.08 from pot
*** SUMMARY ***
Total pot €2.19 | Rake €0.11 
Board [Ah 3c 4d 6d Jc]
Seat 1: -M-Cedric-78 (button) showed [Ad Ks] and won (€2.08) with a pair of Aces
Seat 2: soyeterno (small blind) folded before Flop
Seat 3: xaratax (big blind) showed [Qs Ac] and lost with a pair of Aces
Seat 4: ocsur folded before Flop (didn't bet)
Seat 5: pipinoelbreve9 folded before Flop
Seat 6: SMN242 folded before Flop (didn't bet)



PokerStars Zoom Hand #257661059556:  Hold'em No Limit (€0.01/€0.02) - 2025/09/08 15:09:22 CET [2025/09/08 9:09:22 ET]
Table 'Arneb' 6-max Seat #1 is the button
Seat 1: pipinoelbreve9 (€2.10 in chips) 
Seat 2: MDKristian (€2 in chips) 
Seat 3: pucelay.29 (€1.28 in chips) 
Seat 4: V1e4ra (€4.16 in chips) 
Seat 5: xaratax (€2 in chips) 
Seat 6: 34pluto (€1.36 in chips) 
MDKristian: posts small blind €0.01
pucelay.29: posts big blind €0.02
*** HOLE CARDS ***
Dealt to pipinoelbreve9 [6c Tc]
V1e4ra: folds 
xaratax: folds 
34pluto: raises €0.02 to €0.04
pipinoelbreve9: folds 
MDKristian: folds 
pucelay.29: folds 
Uncalled bet (€0.02) returned to 34pluto
34pluto collected €0.05 from pot
34pluto: doesn't show hand 
*** SUMMARY ***
Total pot €0.05 | Rake €0 
Seat 1: pipinoelbreve9 (button) folded before Flop (didn't bet)
Seat 2: MDKristian (small blind) folded before Flop
Seat 3: pucelay.29 (big blind) folded before Flop
Seat 4: V1e4ra folded before Flop (didn't bet)
Seat 5: xaratax folded before Flop (didn't bet)
Seat 6: 34pluto collected (€0.05)



PokerStars Zoom Hand #257661059026:  Hold'em No Limit (€0.01/€0.02) - 2025/09/08 15:09:18 CET [2025/09/08 9:09:18 ET]
Table 'Arneb' 6-max Seat #1 is the button
Seat 1: xaratax (€2 in chips) 
Seat 2: 34pluto (€1.37 in chips) 
Seat 3: HDFUNRS1 (€1.97 in chips) 
Seat 4: pipinoelbreve9 (€2.10 in chips) 
Seat 5: MDKristian (€2.17 in chips) 
Seat 6: -M-Cedric-78 (€2.08 in chips) 
34pluto: posts small blind €0.01
HDFUNRS1: posts big blind €0.02
*** HOLE CARDS ***
Dealt to pipinoelbreve9 [8d 7d]
pipinoelbreve9: folds 
MDKristian: folds 
-M-Cedric-78: raises €0.02 to €0.04
xaratax: folds 
34pluto: folds 
HDFUNRS1: calls €0.02
*** FLOP *** [4h 4d 2c]
HDFUNRS1: checks 
-M-Cedric-78: checks 
*** TURN *** [4h 4d 2c] [Qh]
HDFUNRS1: checks 
-M-Cedric-78: bets €0.05
HDFUNRS1: folds 
Uncalled bet (€0.05) returned to -M-Cedric-78
-M-Cedric-78 collected €0.09 from pot
-M-Cedric-78: doesn't show hand 
*** SUMMARY ***
Total pot €0.09 | Rake €0 
Board [4h 4d 2c Qh]
Seat 1: xaratax (button) folded before Flop (didn't bet)
Seat 2: 34pluto (small blind) folded before Flop
Seat 3: HDFUNRS1 (big blind) folded on the Turn
Seat 4: pipinoelbreve9 folded before Flop (didn't bet)
Seat 5: MDKristian folded before Flop (didn't bet)
Seat 6: -M-Cedric-78 collected (€0.09)



PokerStars Zoom Hand #257661057478:  Hold'em No Limit (€0.01/€0.02) - 2025/09/08 15:09:07 CET [2025/09/08 9:09:07 ET]
Table 'Arneb' 6-max Seat #1 is the button
Seat 1: ecuinas (€2.51 in chips) 
Seat 2: Flowter1_3 (€1.42 in chips) 
Seat 3: pipinoelbreve9 (€2.12 in chips) 
Seat 4: pucelay.29 (€1.30 in chips) 
Seat 5: manolo1953 (€0.67 in chips) 
Seat 6: vclx (€3.32 in chips) 
Flowter1_3: posts small blind €0.01
pipinoelbreve9: posts big blind €0.02
*** HOLE CARDS ***
Dealt to pipinoelbreve9 [Th 2d]
pucelay.29: calls €0.02
manolo1953: folds 
vclx: folds 
ecuinas: raises €0.07 to €0.09
Flowter1_3: calls €0.08
pipinoelbreve9: folds 
pucelay.29: folds 
*** FLOP *** [8h 4h Tc]
Flowter1_3: checks 
ecuinas: checks 
*** TURN *** [8h 4h Tc] [5c]
Flowter1_3: checks 
ecuinas: bets €0.11
Flowter1_3: calls €0.11
*** RIVER *** [8h 4h Tc 5c] [Qd]
Flowter1_3: checks 
ecuinas: checks 
*** SHOW DOWN ***
Flowter1_3: shows [3s 3c] (a pair of Threes)
ecuinas: mucks hand 
Flowter1_3 collected €0.42 from pot
*** SUMMARY ***
Total pot €0.44 | Rake €0.02 
Board [8h 4h Tc 5c Qd]
Seat 1: ecuinas (button) mucked [Js As]
Seat 2: Flowter1_3 (small blind) showed [3s 3c] and won (€0.42) with a pair of Threes
Seat 3: pipinoelbreve9 (big blind) folded before Flop
Seat 4: pucelay.29 folded before Flop
Seat 5: manolo1953 folded before Flop (didn't bet)
Seat 6: vclx folded before Flop (didn't bet)



PokerStars Zoom Hand #257661060024:  Hold'em No Limit (€0.01/€0.02) - 2025/09/08 15:09:25 CET [2025/09/08 9:09:25 ET]
Table 'Arneb' 6-max Seat #1 is the button
Seat 1: chitigordi78 (€5.82 in chips) 
Seat 2: combinius1 (€2.08 in chips) 
Seat 3: palmito8745 (€1.60 in chips) 
Seat 4: Tyrandes4pattes (€3.05 in chips) 
Seat 5: MDKristian (€2.50 in chips) 
Seat 6: pipinoelbreve9 (€2.10 in chips) 
combinius1: posts small blind €0.01
palmito8745: posts big blind €0.02
*** HOLE CARDS ***
Dealt to pipinoelbreve9 [Ac 9c]
Tyrandes4pattes: folds 
MDKristian: raises €0.04 to €0.06
pipinoelbreve9: calls €0.06
chitigordi78: calls €0.06
combinius1: calls €0.05
palmito8745: folds 
*** FLOP *** [7s 7d 5c]
combinius1: checks 
MDKristian: bets €0.25
pipinoelbreve9: folds 
chitigordi78: folds 
combinius1: folds 
Uncalled bet (€0.25) returned to MDKristian
MDKristian collected €0.25 from pot
MDKristian: doesn't show hand 
*** SUMMARY ***
Total pot €0.26 | Rake €0.01 
Board [7s 7d 5c]
Seat 1: chitigordi78 (button) folded on the Flop
Seat 2: combinius1 (small blind) folded on the Flop
Seat 3: palmito8745 (big blind) folded before Flop
Seat 4: Tyrandes4pattes folded before Flop (didn't bet)
Seat 5: MDKristian collected (€0.25)
Seat 6: pipinoelbreve9 folded on the Flop



PokerStars Zoom Hand #257661063160:  Hold'em No Limit (€0.01/€0.02) - 2025/09/08 15:09:48 CET [2025/09/08 9:09:48 ET]
Table 'Arneb' 6-max Seat #1 is the button
Seat 1: pipinoelbreve9 (€2.04 in chips) 
Seat 2: combinius1 (€2.42 in chips) 
Seat 3: madbikeman (€2.36 in chips) 
Seat 4: ecuinas (€2.31 in chips) 
Seat 5: SUNTZU47 (€1.72 in chips) 
Seat 6: Abrelatas787 (€2.59 in chips) 
combinius1: posts small blind €0.01
madbikeman: posts big blind €0.02
*** HOLE CARDS ***
Dealt to pipinoelbreve9 [2c 9c]
ecuinas: raises €0.04 to €0.06
SUNTZU47: folds 
Abrelatas787: folds 
pipinoelbreve9: folds 
combinius1: folds 
madbikeman: folds 
Uncalled bet (€0.04) returned to ecuinas
ecuinas collected €0.05 from pot
ecuinas: doesn't show hand 
*** SUMMARY ***
Total pot €0.05 | Rake €0 
Seat 1: pipinoelbreve9 (button) folded before Flop (didn't bet)
Seat 2: combinius1 (small blind) folded before Flop
Seat 3: madbikeman (big blind) folded before Flop
Seat 4: ecuinas collected (€0.05)
Seat 5: SUNTZU47 folded before Flop (didn't bet)
Seat 6: Abrelatas787 folded before Flop (didn't bet)



PokerStars Zoom Hand #257661064993:  Hold'em No Limit (€0.01/€0.02) - 2025/09/08 15:10:02 CET [2025/09/08 9:10:02 ET]
Table 'Arneb' 6-max Seat #1 is the button
Seat 1: V1e4ra (€4.14 in chips) 
Seat 2: pipinoelbreve9 (€2.02 in chips) 
Seat 3: MDKristian (€2 in chips) 
Seat 4: soyeterno (€2 in chips) 
Seat 5: Abrelatas787 (€2.59 in chips) 
Seat 6: sanje35 (€1.17 in chips) 
pipinoelbreve9: posts small blind €0.01
MDKristian: posts big blind €0.02
*** HOLE CARDS ***
Dealt to pipinoelbreve9 [As 7s]
soyeterno: folds 
Abrelatas787: folds 
sanje35: folds 
V1e4ra: folds 
pipinoelbreve9: raises €0.04 to €0.06
MDKristian: folds 
Uncalled bet (€0.04) returned to pipinoelbreve9
pipinoelbreve9 collected €0.04 from pot
pipinoelbreve9: doesn't show hand 
*** SUMMARY ***
Total pot €0.04 | Rake €0 
Seat 1: V1e4ra (button) folded before Flop (didn't bet)
Seat 2: pipinoelbreve9 (small blind) collected (€0.04)
Seat 3: MDKristian (big blind) folded before Flop
Seat 4: soyeterno folded before Flop (didn't bet)
Seat 5: Abrelatas787 folded before Flop (didn't bet)
Seat 6: sanje35 folded before Flop (didn't bet)



PokerStars Zoom Hand #257661064234:  Hold'em No Limit (€0.01/€0.02) - 2025/09/08 15:09:56 CET [2025/09/08 9:09:56 ET]
Table 'Arneb' 6-max Seat #1 is the button
Seat 1: Tyrandes4pattes (€3.02 in chips) 
Seat 2: KillVerlaine (€5.03 in chips) 
Seat 3: pipinoelbreve9 (€2.04 in chips) 
Seat 4: franday (€0.70 in chips) 
Seat 5: ptrclicli28 (€1.94 in chips) 
Seat 6: ranchim (€2.08 in chips) 
KillVerlaine: posts small blind €0.01
pipinoelbreve9: posts big blind €0.02
*** HOLE CARDS ***
Dealt to pipinoelbreve9 [Td 4s]
franday: raises €0.02 to €0.04
ptrclicli28: raises €0.18 to €0.22
ranchim: folds 
Tyrandes4pattes: folds 
KillVerlaine: folds 
pipinoelbreve9: folds 
franday: folds 
Uncalled bet (€0.18) returned to ptrclicli28
ptrclicli28 collected €0.11 from pot
ptrclicli28: doesn't show hand 
*** SUMMARY ***
Total pot €0.11 | Rake €0 
Seat 1: Tyrandes4pattes (button) folded before Flop (didn't bet)
Seat 2: KillVerlaine (small blind) folded before Flop
Seat 3: pipinoelbreve9 (big blind) folded before Flop
Seat 4: franday folded before Flop
Seat 5: ptrclicli28 collected (€0.11)
Seat 6: ranchim folded before Flop (didn't bet)



PokerStars Zoom Hand #257661063808:  Hold'em No Limit (€0.01/€0.02) - 2025/09/08 15:09:53 CET [2025/09/08 9:09:53 ET]
Table 'Arneb' 6-max Seat #1 is the button
Seat 1: franday (€0.70 in chips) 
Seat 2: yunowme (€2 in chips) 
Seat 3: pepetoni60 (€2 in chips) 
Seat 4: rccmonteiro27 (€1.99 in chips) 
Seat 5: pipinoelbreve9 (€2.04 in chips) 
Seat 6: Ctr Alt Surp (€0.99 in chips) 
yunowme: posts small blind €0.01
pepetoni60: posts big blind €0.02
*** HOLE CARDS ***
Dealt to pipinoelbreve9 [8d 5c]
rccmonteiro27: folds 
pipinoelbreve9: folds 
Ctr Alt Surp: folds 
franday: folds 
yunowme: raises €0.03 to €0.05
pepetoni60: folds 
Uncalled bet (€0.03) returned to yunowme
yunowme collected €0.04 from pot
yunowme: doesn't show hand 
*** SUMMARY ***
Total pot €0.04 | Rake €0 
Seat 1: franday (button) folded before Flop (didn't bet)
Seat 2: yunowme (small blind) collected (€0.04)
Seat 3: pepetoni60 (big blind) folded before Flop
Seat 4: rccmonteiro27 folded before Flop (didn't bet)
Seat 5: pipinoelbreve9 folded before Flop (didn't bet)
Seat 6: Ctr Alt Surp folded before Flop (didn't bet)



PokerStars Zoom Hand #257661066587:  Hold'em No Limit (€0.01/€0.02) - 2025/09/08 15:10:13 CET [2025/09/08 9:10:13 ET]
Table 'Arneb' 6-max Seat #1 is the button
Seat 1: MDKristian (€2 in chips) 
Seat 2: franday (€0.66 in chips) 
Seat 3: V1e4ra (€3.71 in chips) 
Seat 4: Tyrandes4pattes (€2.37 in chips) 
Seat 5: pipinoelbreve9 (€2.04 in chips) 
Seat 6: soyeterno (€2 in chips) 
franday: posts small blind €0.01
V1e4ra: posts big blind €0.02
*** HOLE CARDS ***
Dealt to pipinoelbreve9 [8h Td]
Tyrandes4pattes: folds 
pipinoelbreve9: folds 
soyeterno: folds 
MDKristian: raises €0.02 to €0.04
franday: folds 
V1e4ra: folds 
Uncalled bet (€0.02) returned to MDKristian
MDKristian collected €0.05 from pot
MDKristian: doesn't show hand 
*** SUMMARY ***
Total pot €0.05 | Rake €0 
Seat 1: MDKristian (button) collected (€0.05)
Seat 2: franday (small blind) folded before Flop
Seat 3: V1e4ra (big blind) folded before Flop
Seat 4: Tyrandes4pattes folded before Flop (didn't bet)
Seat 5: pipinoelbreve9 folded before Flop (didn't bet)
Seat 6: soyeterno folded before Flop (didn't bet)



PokerStars Zoom Hand #257661067853:  Hold'em No Limit (€0.01/€0.02) - 2025/09/08 15:10:22 CET [2025/09/08 9:10:22 ET]
Table 'Arneb' 6-max Seat #1 is the button
Seat 1: llocant (€1.05 in chips) 
Seat 2: kurikutela53 (€1.01 in chips) 
Seat 3: Tyrandes4pattes (€2.37 in chips) 
Seat 4: pipinoelbreve9 (€2.04 in chips) 
Seat 5: vclx (€3.85 in chips) 
Seat 6: juradopilas (€0.66 in chips) 
kurikutela53: posts small blind €0.01
Tyrandes4pattes: posts big blind €0.02
*** HOLE CARDS ***
Dealt to pipinoelbreve9 [4h 6c]
pipinoelbreve9: folds 
vclx: folds 
juradopilas: raises €0.02 to €0.04
llocant: raises €0.11 to €0.15
kurikutela53: folds 
Tyrandes4pattes: folds 
juradopilas: folds 
Uncalled bet (€0.11) returned to llocant
llocant collected €0.11 from pot
llocant: doesn't show hand 
*** SUMMARY ***
Total pot €0.11 | Rake €0 
Seat 1: llocant (button) collected (€0.11)
Seat 2: kurikutela53 (small blind) folded before Flop
Seat 3: Tyrandes4pattes (big blind) folded before Flop
Seat 4: pipinoelbreve9 folded before Flop (didn't bet)
Seat 5: vclx folded before Flop (didn't bet)
Seat 6: juradopilas folded before Flop



PokerStars Zoom Hand #257661068601:  Hold'em No Limit (€0.01/€0.02) - 2025/09/08 15:10:27 CET [2025/09/08 9:10:27 ET]
Table 'Arneb' 6-max Seat #1 is the button
Seat 1: Percu32 (€2.59 in chips) 
Seat 2: pucelay.29 (€1.23 in chips) 
Seat 3: pipinoelbreve9 (€2.04 in chips) 
Seat 4: combinius1 (€2.41 in chips) 
Seat 5: MDKristian (€2.14 in chips) 
Seat 6: Jackeuj32 (€1.37 in chips) 
pucelay.29: posts small blind €0.01
pipinoelbreve9: posts big blind €0.02
*** HOLE CARDS ***
Dealt to pipinoelbreve9 [Jh 8d]
combinius1: folds 
MDKristian: folds 
Jackeuj32: calls €0.02
Percu32: raises €0.09 to €0.11
pucelay.29: folds 
pipinoelbreve9: folds 
Jackeuj32: folds 
Uncalled bet (€0.09) returned to Percu32
Percu32 collected €0.07 from pot
Percu32: doesn't show hand 
*** SUMMARY ***
Total pot €0.07 | Rake €0 
Seat 1: Percu32 (button) collected (€0.07)
Seat 2: pucelay.29 (small blind) folded before Flop
Seat 3: pipinoelbreve9 (big blind) folded before Flop
Seat 4: combinius1 folded before Flop (didn't bet)
Seat 5: MDKristian folded before Flop (didn't bet)
Seat 6: Jackeuj32 folded before Flop



PokerStars Zoom Hand #257661067265:  Hold'em No Limit (€0.01/€0.02) - 2025/09/08 15:10:18 CET [2025/09/08 9:10:18 ET]
Table 'Arneb' 6-max Seat #1 is the button
Seat 1: SUNTZU47 (€1.42 in chips) 
Seat 2: pucelay.29 (€2.63 in chips) 
Seat 3: soyeterno (€2 in chips) 
Seat 4: combinius1 (€2.41 in chips) 
Seat 5: franday (€0.65 in chips) 
Seat 6: pipinoelbreve9 (€2.04 in chips) 
pucelay.29: posts small blind €0.01
soyeterno: posts big blind €0.02
*** HOLE CARDS ***
Dealt to pipinoelbreve9 [6s 8h]
combinius1: folds 
franday: folds 
pipinoelbreve9: folds 
SUNTZU47: folds 
pucelay.29: calls €0.01
soyeterno: checks 
*** FLOP *** [7s 2d 4d]
pucelay.29: checks 
soyeterno: checks 
*** TURN *** [7s 2d 4d] [9s]
pucelay.29: checks 
soyeterno: checks 
*** RIVER *** [7s 2d 4d 9s] [Jh]
pucelay.29: checks 
soyeterno: bets €0.04
pucelay.29: folds 
Uncalled bet (€0.04) returned to soyeterno
soyeterno collected €0.04 from pot
soyeterno: doesn't show hand 
*** SUMMARY ***
Total pot €0.04 | Rake €0 
Board [7s 2d 4d 9s Jh]
Seat 1: SUNTZU47 (button) folded before Flop (didn't bet)
Seat 2: pucelay.29 (small blind) folded on the River
Seat 3: soyeterno (big blind) collected (€0.04)
Seat 4: combinius1 folded before Flop (didn't bet)
Seat 5: franday folded before Flop (didn't bet)
Seat 6: pipinoelbreve9 folded before Flop (didn't bet)



PokerStars Zoom Hand #257661071047:  Hold'em No Limit (€0.01/€0.02) - 2025/09/08 15:10:45 CET [2025/09/08 9:10:45 ET]
Table 'Arneb' 6-max Seat #1 is the button
Seat 1: pipinoelbreve9 (€2.02 in chips) 
Seat 2: soyeterno (€3.53 in chips) 
Seat 3: RMOT100A (€1.94 in chips) 
Seat 4: Tyrandes4pattes (€3.57 in chips) 
Seat 5: 34pluto (€0.71 in chips) 
Seat 6: osking118 (€2 in chips) 
soyeterno: posts small blind €0.01
RMOT100A: posts big blind €0.02
*** HOLE CARDS ***
Dealt to pipinoelbreve9 [5d 8s]
Tyrandes4pattes: raises €0.04 to €0.06
34pluto: folds 
osking118: calls €0.06
pipinoelbreve9: folds 
soyeterno: folds 
RMOT100A: folds 
*** FLOP *** [Tc Jh 9h]
Tyrandes4pattes: bets €0.06
osking118: folds 
Uncalled bet (€0.06) returned to Tyrandes4pattes
Tyrandes4pattes collected €0.14 from pot
Tyrandes4pattes: doesn't show hand 
*** SUMMARY ***
Total pot €0.15 | Rake €0.01 
Board [Tc Jh 9h]
Seat 1: pipinoelbreve9 (button) folded before Flop (didn't bet)
Seat 2: soyeterno (small blind) folded before Flop
Seat 3: RMOT100A (big blind) folded before Flop
Seat 4: Tyrandes4pattes collected (€0.14)
Seat 5: 34pluto folded before Flop (didn't bet)
Seat 6: osking118 folded on the Flop



PokerStars Zoom Hand #257661071571:  Hold'em No Limit (€0.01/€0.02) - 2025/09/08 15:10:49 CET [2025/09/08 9:10:49 ET]
Table 'Arneb' 6-max Seat #1 is the button
Seat 1: requerimento256 (€1.58 in chips) 
Seat 2: pipinoelbreve9 (€2.02 in chips) 
Seat 3: V1e4ra (€3.68 in chips) 
Seat 4: soyeterno (€3.52 in chips) 
Seat 5: Jackeuj32 (€1.35 in chips) 
Seat 6: EiramSenpai (€8.06 in chips) 
pipinoelbreve9: posts small blind €0.01
V1e4ra: posts big blind €0.02
*** HOLE CARDS ***
Dealt to pipinoelbreve9 [4c 4s]
soyeterno: folds 
Jackeuj32 has timed out
Jackeuj32: folds 
EiramSenpai: raises €0.02 to €0.04
requerimento256: calls €0.04
pipinoelbreve9: calls €0.03
V1e4ra: folds 
*** FLOP *** [Jh 3c 4h]
pipinoelbreve9: checks 
EiramSenpai: checks 
requerimento256: bets €0.07
pipinoelbreve9: calls €0.07
EiramSenpai: folds 
*** TURN *** [Jh 3c 4h] [Kh]
pipinoelbreve9: checks 
requerimento256: bets €0.27
pipinoelbreve9: calls €0.27
*** RIVER *** [Jh 3c 4h Kh] [2d]
pipinoelbreve9: checks 
requerimento256: checks 
*** SHOW DOWN ***
pipinoelbreve9: shows [4c 4s] (three of a kind, Fours)
requerimento256: mucks hand 
pipinoelbreve9 collected €0.78 from pot
*** SUMMARY ***
Total pot €0.82 | Rake €0.04 
Board [Jh 3c 4h Kh 2d]
Seat 1: requerimento256 (button) mucked [Ac Ks]
Seat 2: pipinoelbreve9 (small blind) showed [4c 4s] and won (€0.78) with three of a kind, Fours
Seat 3: V1e4ra (big blind) folded before Flop
Seat 4: soyeterno folded before Flop (didn't bet)
Seat 5: Jackeuj32 folded before Flop (didn't bet)
Seat 6: EiramSenpai folded on the Flop



PokerStars Zoom Hand #257661080429:  Hold'em No Limit (€0.01/€0.02) - 2025/09/08 15:11:52 CET [2025/09/08 9:11:52 ET]
Table 'Arneb' 6-max Seat #1 is the button
Seat 1: pipinoelbreve9 (€2.42 in chips) 
Seat 2: HDFUNRS1 (€1.84 in chips) 
Seat 3: V1e4ra (€2.97 in chips) 
Seat 4: ranchim (€1.99 in chips) 
Seat 5: crissstal (€1.42 in chips) 
Seat 6: combinius1 (€2.38 in chips) 
HDFUNRS1: posts small blind €0.01
V1e4ra: posts big blind €0.02
*** HOLE CARDS ***
Dealt to pipinoelbreve9 [5s 7d]
ranchim: raises €0.03 to €0.05
crissstal: folds 
combinius1: folds 
pipinoelbreve9: folds 
HDFUNRS1: folds 
V1e4ra: folds 
Uncalled bet (€0.03) returned to ranchim
ranchim collected €0.05 from pot
ranchim: doesn't show hand 
*** SUMMARY ***
Total pot €0.05 | Rake €0 
Seat 1: pipinoelbreve9 (button) folded before Flop (didn't bet)
Seat 2: HDFUNRS1 (small blind) folded before Flop
Seat 3: V1e4ra (big blind) folded before Flop
Seat 4: ranchim collected (€0.05)
Seat 5: crissstal folded before Flop (didn't bet)
Seat 6: combinius1 folded before Flop (didn't bet)



PokerStars Zoom Hand #257661079512:  Hold'em No Limit (€0.01/€0.02) - 2025/09/08 15:11:46 CET [2025/09/08 9:11:46 ET]
Table 'Arneb' 6-max Seat #1 is the button
Seat 1: MDKristian (€2.40 in chips) 
Seat 2: requerimento256 (€1.20 in chips) 
Seat 3: combinius1 (€2.71 in chips) 
Seat 4: V1e4ra (€2.64 in chips) 
Seat 5: pipinoelbreve9 (€2.42 in chips) 
Seat 6: crissstal (€1.42 in chips) 
requerimento256: posts small blind €0.01
combinius1: posts big blind €0.02
*** HOLE CARDS ***
Dealt to pipinoelbreve9 [Qs 3c]
V1e4ra: folds 
pipinoelbreve9: folds 
crissstal: folds 
MDKristian: raises €0.02 to €0.04
requerimento256 is disconnected 
requerimento256 has timed out while disconnected
requerimento256: folds 
combinius1: folds 
Uncalled bet (€0.02) returned to MDKristian
MDKristian collected €0.05 from pot
MDKristian: doesn't show hand 
*** SUMMARY ***
Total pot €0.05 | Rake €0 
Seat 1: MDKristian (button) collected (€0.05)
Seat 2: requerimento256 (small blind) folded before Flop
Seat 3: combinius1 (big blind) folded before Flop
Seat 4: V1e4ra folded before Flop (didn't bet)
Seat 5: pipinoelbreve9 folded before Flop (didn't bet)
Seat 6: crissstal folded before Flop (didn't bet)



PokerStars Zoom Hand #257661081081:  Hold'em No Limit (€0.01/€0.02) - 2025/09/08 15:11:57 CET [2025/09/08 9:11:57 ET]
Table 'Arneb' 6-max Seat #1 is the button
Seat 1: HDFUNRS1 (€1.83 in chips) 
Seat 2: GamerVidal (€2.10 in chips) 
Seat 3: Tyrandes4pattes (€2.21 in chips) 
Seat 4: crissstal (€1.42 in chips) 
Seat 5: pepetoni60 (€2.08 in chips) 
Seat 6: pipinoelbreve9 (€2.42 in chips) 
GamerVidal: posts small blind €0.01
Tyrandes4pattes: posts big blind €0.02
*** HOLE CARDS ***
Dealt to pipinoelbreve9 [8s 8d]
crissstal: folds 
pepetoni60: folds 
pipinoelbreve9: raises €0.04 to €0.06
HDFUNRS1: folds 
GamerVidal: folds 
Tyrandes4pattes: folds 
Uncalled bet (€0.04) returned to pipinoelbreve9
pipinoelbreve9 collected €0.05 from pot
pipinoelbreve9: doesn't show hand 
*** SUMMARY ***
Total pot €0.05 | Rake €0 
Seat 1: HDFUNRS1 (button) folded before Flop (didn't bet)
Seat 2: GamerVidal (small blind) folded before Flop
Seat 3: Tyrandes4pattes (big blind) folded before Flop
Seat 4: crissstal folded before Flop (didn't bet)
Seat 5: pepetoni60 folded before Flop (didn't bet)
Seat 6: pipinoelbreve9 collected (€0.05)



PokerStars Zoom Hand #257661085404:  Hold'em No Limit (€0.01/€0.02) - 2025/09/08 15:12:29 CET [2025/09/08 9:12:29 ET]
Table 'Arneb' 6-max Seat #1 is the button
Seat 1: V1e4ra (€2.77 in chips) 
Seat 2: SUNTZU47 (€1.31 in chips) 
Seat 3: pipinoelbreve9 (€2.44 in chips) 
Seat 4: Tyrandes4pattes (€2.21 in chips) 
Seat 5: madbikeman (€1.63 in chips) 
Seat 6: Ctr Alt Surp (€0.73 in chips) 
SUNTZU47: posts small blind €0.01
pipinoelbreve9: posts big blind €0.02
*** HOLE CARDS ***
Dealt to pipinoelbreve9 [7c 5c]
Tyrandes4pattes: folds 
madbikeman: folds 
Ctr Alt Surp: raises €0.08 to €0.10
V1e4ra: folds 
SUNTZU47: folds 
pipinoelbreve9: folds 
Uncalled bet (€0.08) returned to Ctr Alt Surp
Ctr Alt Surp collected €0.05 from pot
Ctr Alt Surp: doesn't show hand 
*** SUMMARY ***
Total pot €0.05 | Rake €0 
Seat 1: V1e4ra (button) folded before Flop (didn't bet)
Seat 2: SUNTZU47 (small blind) folded before Flop
Seat 3: pipinoelbreve9 (big blind) folded before Flop
Seat 4: Tyrandes4pattes folded before Flop (didn't bet)
Seat 5: madbikeman folded before Flop (didn't bet)
Seat 6: Ctr Alt Surp collected (€0.05)



PokerStars Zoom Hand #257661084753:  Hold'em No Limit (€0.01/€0.02) - 2025/09/08 15:12:25 CET [2025/09/08 9:12:25 ET]
Table 'Arneb' 6-max Seat #1 is the button
Seat 1: juradopilas (€0.72 in chips) 
Seat 2: pipinoelbreve9 (€2.45 in chips) 
Seat 3: pucelay.29 (€2.05 in chips) 
Seat 4: Gonzalo_PB1 (€1.97 in chips) 
Seat 5: Ctr Alt Surp (€0.73 in chips) 
Seat 6: madbikeman (€1.63 in chips) 
pipinoelbreve9: posts small blind €0.01
pucelay.29: posts big blind €0.02
*** HOLE CARDS ***
Dealt to pipinoelbreve9 [3d 4c]
Gonzalo_PB1: folds 
Ctr Alt Surp: folds 
madbikeman: folds 
juradopilas: raises €0.70 to €0.72 and is all-in
pipinoelbreve9: folds 
pucelay.29: folds 
Uncalled bet (€0.70) returned to juradopilas
juradopilas collected €0.05 from pot
juradopilas: doesn't show hand 
*** SUMMARY ***
Total pot €0.05 | Rake €0 
Seat 1: juradopilas (button) collected (€0.05)
Seat 2: pipinoelbreve9 (small blind) folded before Flop
Seat 3: pucelay.29 (big blind) folded before Flop
Seat 4: Gonzalo_PB1 folded before Flop (didn't bet)
Seat 5: Ctr Alt Surp folded before Flop (didn't bet)
Seat 6: madbikeman folded before Flop (didn't bet)



PokerStars Zoom Hand #257661086822:  Hold'em No Limit (€0.01/€0.02) - 2025/09/08 15:12:39 CET [2025/09/08 9:12:39 ET]
Table 'Arneb' 6-max Seat #1 is the button
Seat 1: osking118 (€1.80 in chips) 
Seat 2: V1e4ra (€2.59 in chips) 
Seat 3: SUNTZU47 (€1.30 in chips) 
Seat 4: KillVerlaine (€5.56 in chips) 
Seat 5: 34pluto (€0.71 in chips) 
Seat 6: pipinoelbreve9 (€2.42 in chips) 
V1e4ra: posts small blind €0.01
SUNTZU47: posts big blind €0.02
*** HOLE CARDS ***
Dealt to pipinoelbreve9 [Kh Js]
KillVerlaine: folds 
34pluto: folds 
pipinoelbreve9: raises €0.04 to €0.06
osking118: folds 
V1e4ra: folds 
SUNTZU47: folds 
Uncalled bet (€0.04) returned to pipinoelbreve9
pipinoelbreve9 collected €0.05 from pot
pipinoelbreve9: doesn't show hand 
*** SUMMARY ***
Total pot €0.05 | Rake €0 
Seat 1: osking118 (button) folded before Flop (didn't bet)
Seat 2: V1e4ra (small blind) folded before Flop
Seat 3: SUNTZU47 (big blind) folded before Flop
Seat 4: KillVerlaine folded before Flop (didn't bet)
Seat 5: 34pluto folded before Flop (didn't bet)
Seat 6: pipinoelbreve9 collected (€0.05)



PokerStars Zoom Hand #257661084067:  Hold'em No Limit (€0.01/€0.02) - 2025/09/08 15:12:19 CET [2025/09/08 9:12:19 ET]
Table 'Arneb' 6-max Seat #1 is the button
Seat 1: V1e4ra (€2.61 in chips) 
Seat 2: pepetoni60 (€1.89 in chips) 
Seat 3: swiitx (€1.97 in chips) 
Seat 4: pipinoelbreve9 (€2.45 in chips) 
Seat 5: Tyrandes4pattes (€2.18 in chips) 
Seat 6: MDKristian (€2.43 in chips) 
pepetoni60: posts small blind €0.01
swiitx: posts big blind €0.02
*** HOLE CARDS ***
Dealt to pipinoelbreve9 [3d 9s]
pipinoelbreve9: folds 
Tyrandes4pattes: folds 
MDKristian: raises €0.02 to €0.04
V1e4ra: folds 
pepetoni60: calls €0.03
swiitx: calls €0.02
*** FLOP *** [Ks 9d Kh]
pepetoni60: checks 
swiitx: checks 
MDKristian: checks 
*** TURN *** [Ks 9d Kh] [Qc]
pepetoni60: checks 
swiitx: checks 
MDKristian: checks 
*** RIVER *** [Ks 9d Kh Qc] [5s]
pepetoni60: checks 
swiitx: bets €0.06
MDKristian: folds 
pepetoni60: calls €0.06
*** SHOW DOWN ***
swiitx: shows [8h Jh] (a pair of Kings)
pepetoni60: shows [6h 5h] (two pair, Kings and Fives)
pepetoni60 collected €0.23 from pot
*** SUMMARY ***
Total pot €0.24 | Rake €0.01 
Board [Ks 9d Kh Qc 5s]
Seat 1: V1e4ra (button) folded before Flop (didn't bet)
Seat 2: pepetoni60 (small blind) showed [6h 5h] and won (€0.23) with two pair, Kings and Fives
Seat 3: swiitx (big blind) showed [8h Jh] and lost with a pair of Kings
Seat 4: pipinoelbreve9 folded before Flop (didn't bet)
Seat 5: Tyrandes4pattes folded before Flop (didn't bet)
Seat 6: MDKristian folded on the River



PokerStars Zoom Hand #257661088697:  Hold'em No Limit (€0.01/€0.02) - 2025/09/08 15:12:53 CET [2025/09/08 9:12:53 ET]
Table 'Arneb' 6-max Seat #1 is the button
Seat 1: pipinoelbreve9 (€2.45 in chips) 
Seat 2: Ctr Alt Surp (€0.76 in chips) 
Seat 3: KillVerlaine (€5.56 in chips) 
Seat 4: pucelay.29 (€2.57 in chips) 
Seat 5: MDKristian (€2 in chips) 
Seat 6: RMOT100A (€1.86 in chips) 
Ctr Alt Surp: posts small blind €0.01
KillVerlaine: posts big blind €0.02
*** HOLE CARDS ***
Dealt to pipinoelbreve9 [4c 8c]
pucelay.29: folds 
MDKristian: folds 
RMOT100A: calls €0.02
pipinoelbreve9: folds 
Ctr Alt Surp: folds 
KillVerlaine: checks 
*** FLOP *** [8d Td 5h]
KillVerlaine: checks 
RMOT100A: bets €0.02
KillVerlaine: folds 
Uncalled bet (€0.02) returned to RMOT100A
RMOT100A collected €0.05 from pot
RMOT100A: doesn't show hand 
*** SUMMARY ***
Total pot €0.05 | Rake €0 
Board [8d Td 5h]
Seat 1: pipinoelbreve9 (button) folded before Flop (didn't bet)
Seat 2: Ctr Alt Surp (small blind) folded before Flop
Seat 3: KillVerlaine (big blind) folded on the Flop
Seat 4: pucelay.29 folded before Flop (didn't bet)
Seat 5: MDKristian folded before Flop (didn't bet)
Seat 6: RMOT100A collected (€0.05)



PokerStars Zoom Hand #257661089380:  Hold'em No Limit (€0.01/€0.02) - 2025/09/08 15:12:58 CET [2025/09/08 9:12:58 ET]
Table 'Arneb' 6-max Seat #1 is the button
Seat 1: Percu32 (€2.79 in chips) 
Seat 2: tapirMM9 (€2.65 in chips) 
Seat 3: V1e4ra (€3.53 in chips) 
Seat 4: RMOT100A (€1.99 in chips) 
Seat 5: pipinoelbreve9 (€2.45 in chips) 
Seat 6: MDKristian (€2 in chips) 
tapirMM9: posts small blind €0.01
V1e4ra: posts big blind €0.02
*** HOLE CARDS ***
Dealt to pipinoelbreve9 [Th Ks]
RMOT100A: folds 
pipinoelbreve9: raises €0.04 to €0.06
MDKristian: folds 
Percu32: folds 
tapirMM9: raises €0.10 to €0.16
V1e4ra: folds 
pipinoelbreve9: calls €0.10
*** FLOP *** [Jh 5d Kd]
tapirMM9: bets €0.12
pipinoelbreve9: calls €0.12
*** TURN *** [Jh 5d Kd] [9s]
tapirMM9: checks 
pipinoelbreve9: bets €0.28
tapirMM9: calls €0.28
*** RIVER *** [Jh 5d Kd 9s] [2c]
tapirMM9: checks 
pipinoelbreve9: checks 
*** SHOW DOWN ***
tapirMM9: shows [Ac Td] (high card Ace)
pipinoelbreve9: shows [Th Ks] (a pair of Kings)
pipinoelbreve9 collected €1.08 from pot
*** SUMMARY ***
Total pot €1.14 | Rake €0.06 
Board [Jh 5d Kd 9s 2c]
Seat 1: Percu32 (button) folded before Flop (didn't bet)
Seat 2: tapirMM9 (small blind) showed [Ac Td] and lost with high card Ace
Seat 3: V1e4ra (big blind) folded before Flop
Seat 4: RMOT100A folded before Flop (didn't bet)
Seat 5: pipinoelbreve9 showed [Th Ks] and won (€1.08) with a pair of Kings
Seat 6: MDKristian folded before Flop (didn't bet)



PokerStars Zoom Hand #257661095701:  Hold'em No Limit (€0.01/€0.02) - 2025/09/08 15:13:46 CET [2025/09/08 9:13:46 ET]
Table 'Arneb' 6-max Seat #1 is the button
Seat 1: V1e4ra (€2.71 in chips) 
Seat 2: Ctr Alt Surp (€0.74 in chips) 
Seat 3: 34pluto (€1.50 in chips) 
Seat 4: pepetoni60 (€2.05 in chips) 
Seat 5: pipinoelbreve9 (€2.97 in chips) 
Seat 6: vclx (€2.19 in chips) 
Ctr Alt Surp: posts small blind €0.01
34pluto: posts big blind €0.02
*** HOLE CARDS ***
Dealt to pipinoelbreve9 [Ac 3c]
pepetoni60: folds 
pipinoelbreve9: raises €0.04 to €0.06
vclx: folds 
V1e4ra: folds 
Ctr Alt Surp: folds 
34pluto: folds 
Uncalled bet (€0.04) returned to pipinoelbreve9
pipinoelbreve9 collected €0.05 from pot
pipinoelbreve9: doesn't show hand 
*** SUMMARY ***
Total pot €0.05 | Rake €0 
Seat 1: V1e4ra (button) folded before Flop (didn't bet)
Seat 2: Ctr Alt Surp (small blind) folded before Flop
Seat 3: 34pluto (big blind) folded before Flop
Seat 4: pepetoni60 folded before Flop (didn't bet)
Seat 5: pipinoelbreve9 collected (€0.05)
Seat 6: vclx folded before Flop (didn't bet)



PokerStars Zoom Hand #257661094657:  Hold'em No Limit (€0.01/€0.02) - 2025/09/08 15:13:38 CET [2025/09/08 9:13:38 ET]
Table 'Arneb' 6-max Seat #1 is the button
Seat 1: vclx (€3.85 in chips) 
Seat 2: HDFUNRS1 (€1.85 in chips) 
Seat 3: Olga197153 (€0.80 in chips) 
Seat 4: pipinoelbreve9 (€2.97 in chips) 
Seat 5: V1e4ra (€2.55 in chips) 
Seat 6: pepetoni60 (€2.05 in chips) 
HDFUNRS1: posts small blind €0.01
Olga197153: posts big blind €0.02
*** HOLE CARDS ***
Dealt to pipinoelbreve9 [8d 9h]
pipinoelbreve9: folds 
V1e4ra: folds 
pepetoni60: folds 
vclx: raises €0.04 to €0.06
HDFUNRS1: calls €0.05
Olga197153: raises €0.74 to €0.80 and is all-in
vclx: folds 
HDFUNRS1: folds 
Uncalled bet (€0.74) returned to Olga197153
Olga197153 collected €0.18 from pot
Olga197153: doesn't show hand 
*** SUMMARY ***
Total pot €0.18 | Rake €0 
Seat 1: vclx (button) folded before Flop
Seat 2: HDFUNRS1 (small blind) folded before Flop
Seat 3: Olga197153 (big blind) collected (€0.18)
Seat 4: pipinoelbreve9 folded before Flop (didn't bet)
Seat 5: V1e4ra folded before Flop (didn't bet)
Seat 6: pepetoni60 folded before Flop (didn't bet)



PokerStars Zoom Hand #257661098000:  Hold'em No Limit (€0.01/€0.02) - 2025/09/08 15:14:03 CET [2025/09/08 9:14:03 ET]
Table 'Arneb' 6-max Seat #1 is the button
Seat 1: manolo1953 (€0.98 in chips) 
Seat 2: osking118 (€2.04 in chips) 
Seat 3: pipinoelbreve9 (€3 in chips) 
Seat 4: yunowme (€2.09 in chips) 
Seat 5: Gonzalo_PB1 (€2.03 in chips) 
Seat 6: Popins0011 (€6.71 in chips) 
osking118: posts small blind €0.01
pipinoelbreve9: posts big blind €0.02
*** HOLE CARDS ***
Dealt to pipinoelbreve9 [3c 2s]
yunowme: raises €0.03 to €0.05
Gonzalo_PB1: folds 
Popins0011: folds 
manolo1953: folds 
osking118: folds 
pipinoelbreve9: folds 
Uncalled bet (€0.03) returned to yunowme
yunowme collected €0.05 from pot
yunowme: doesn't show hand 
*** SUMMARY ***
Total pot €0.05 | Rake €0 
Seat 1: manolo1953 (button) folded before Flop (didn't bet)
Seat 2: osking118 (small blind) folded before Flop
Seat 3: pipinoelbreve9 (big blind) folded before Flop
Seat 4: yunowme collected (€0.05)
Seat 5: Gonzalo_PB1 folded before Flop (didn't bet)
Seat 6: Popins0011 folded before Flop (didn't bet)



PokerStars Zoom Hand #257661099765:  Hold'em No Limit (€0.01/€0.02) - 2025/09/08 15:14:16 CET [2025/09/08 9:14:16 ET]
Table 'Arneb' 6-max Seat #1 is the button
Seat 1: pepetoni60 (€2.02 in chips) 
Seat 2: soyeterno (€3 in chips) 
Seat 3: ecuinas (€2.50 in chips) 
Seat 4: Tyrandes4pattes (€3.58 in chips) 
Seat 5: MDKristian (€2.58 in chips) 
Seat 6: pipinoelbreve9 (€2.97 in chips) 
soyeterno: posts small blind €0.01
ecuinas: posts big blind €0.02
*** HOLE CARDS ***
Dealt to pipinoelbreve9 [Ah 4s]
Tyrandes4pattes: raises €0.04 to €0.06
MDKristian: folds 
pipinoelbreve9: folds 
pepetoni60: calls €0.06
soyeterno: folds 
ecuinas: folds 
*** FLOP *** [Ks 9c 2d]
Tyrandes4pattes: bets €0.04
pepetoni60: folds 
Uncalled bet (€0.04) returned to Tyrandes4pattes
Tyrandes4pattes collected €0.14 from pot
Tyrandes4pattes: doesn't show hand 
*** SUMMARY ***
Total pot €0.15 | Rake €0.01 
Board [Ks 9c 2d]
Seat 1: pepetoni60 (button) folded on the Flop
Seat 2: soyeterno (small blind) folded before Flop
Seat 3: ecuinas (big blind) folded before Flop
Seat 4: Tyrandes4pattes collected (€0.14)
Seat 5: MDKristian folded before Flop (didn't bet)
Seat 6: pipinoelbreve9 folded before Flop (didn't bet)



PokerStars Zoom Hand #257661100875:  Hold'em No Limit (€0.01/€0.02) - 2025/09/08 15:14:25 CET [2025/09/08 9:14:25 ET]
Table 'Arneb' 6-max Seat #1 is the button
Seat 1: pipinoelbreve9 (€2.97 in chips) 
Seat 2: MDKristian (€2.26 in chips) 
Seat 3: Ctr Alt Surp (€0.79 in chips) 
Seat 4: Popins0011 (€6.72 in chips) 
Seat 5: swiitx (€2.09 in chips) 
Seat 6: V1e4ra (€3.88 in chips) 
MDKristian: posts small blind €0.01
Ctr Alt Surp: posts big blind €0.02
*** HOLE CARDS ***
Dealt to pipinoelbreve9 [9c 3d]
Popins0011: raises €0.02 to €0.04
swiitx: folds 
V1e4ra: folds 
pipinoelbreve9: folds 
MDKristian: folds 
Ctr Alt Surp: raises €0.06 to €0.10
Popins0011: raises €6.62 to €6.72 and is all-in
Ctr Alt Surp: calls €0.69 and is all-in
Uncalled bet (€5.93) returned to Popins0011
*** FLOP *** [8c 5h 5c]
*** TURN *** [8c 5h 5c] [4c]
*** RIVER *** [8c 5h 5c 4c] [9h]
*** SHOW DOWN ***
Ctr Alt Surp: shows [Ah 4h] (two pair, Fives and Fours)
Popins0011: shows [Kc As] (a pair of Fives)
Ctr Alt Surp collected €1.51 from pot
*** SUMMARY ***
Total pot €1.59 | Rake €0.08 
Board [8c 5h 5c 4c 9h]
Seat 1: pipinoelbreve9 (button) folded before Flop (didn't bet)
Seat 2: MDKristian (small blind) folded before Flop
Seat 3: Ctr Alt Surp (big blind) showed [Ah 4h] and won (€1.51) with two pair, Fives and Fours
Seat 4: Popins0011 showed [Kc As] and lost with a pair of Fives
Seat 5: swiitx folded before Flop (didn't bet)
Seat 6: V1e4ra folded before Flop (didn't bet)



PokerStars Zoom Hand #257661102287:  Hold'em No Limit (€0.01/€0.02) - 2025/09/08 15:14:35 CET [2025/09/08 9:14:35 ET]
Table 'Arneb' 6-max Seat #1 is the button
Seat 1: SUNTZU47 (€5.18 in chips) 
Seat 2: combinius1 (€2.54 in chips) 
Seat 3: HDFUNRS1 (€1.79 in chips) 
Seat 4: pipinoelbreve9 (€2.97 in chips) 
Seat 5: V1e4ra (€3.88 in chips) 
Seat 6: RMOT100A (€2.18 in chips) 
combinius1: posts small blind €0.01
HDFUNRS1: posts big blind €0.02
*** HOLE CARDS ***
Dealt to pipinoelbreve9 [Ks 4h]
pipinoelbreve9: folds 
V1e4ra: folds 
RMOT100A: folds 
SUNTZU47: folds 
combinius1: folds 
Uncalled bet (€0.01) returned to HDFUNRS1
HDFUNRS1 collected €0.02 from pot
HDFUNRS1: doesn't show hand 
*** SUMMARY ***
Total pot €0.02 | Rake €0 
Seat 1: SUNTZU47 (button) folded before Flop (didn't bet)
Seat 2: combinius1 (small blind) folded before Flop
Seat 3: HDFUNRS1 (big blind) collected (€0.02)
Seat 4: pipinoelbreve9 folded before Flop (didn't bet)
Seat 5: V1e4ra folded before Flop (didn't bet)
Seat 6: RMOT100A folded before Flop (didn't bet)



PokerStars Zoom Hand #257661099256:  Hold'em No Limit (€0.01/€0.02) - 2025/09/08 15:14:12 CET [2025/09/08 9:14:12 ET]
Table 'Arneb' 6-max Seat #1 is the button
Seat 1: madbikeman (€1.63 in chips) 
Seat 2: pipinoelbreve9 (€2.98 in chips) 
Seat 3: yunowme (€2.06 in chips) 
Seat 4: combinius1 (€2.53 in chips) 
Seat 5: FAUCES (€1.97 in chips) 
Seat 6: Dr animals (€1.60 in chips) 
pipinoelbreve9: posts small blind €0.01
yunowme: posts big blind €0.02
*** HOLE CARDS ***
Dealt to pipinoelbreve9 [3c 4s]
combinius1: folds 
FAUCES: raises €0.04 to €0.06
Dr animals: folds 
madbikeman: folds 
pipinoelbreve9: folds 
yunowme: calls €0.04
*** FLOP *** [Tc Ac Kc]
yunowme: checks 
FAUCES: checks 
*** TURN *** [Tc Ac Kc] [4h]
yunowme: checks 
FAUCES: bets €0.04
yunowme: folds 
Uncalled bet (€0.04) returned to FAUCES
FAUCES collected €0.12 from pot
FAUCES: doesn't show hand 
*** SUMMARY ***
Total pot €0.13 | Rake €0.01 
Board [Tc Ac Kc 4h]
Seat 1: madbikeman (button) folded before Flop (didn't bet)
Seat 2: pipinoelbreve9 (small blind) folded before Flop
Seat 3: yunowme (big blind) folded on the Turn
Seat 4: combinius1 folded before Flop (didn't bet)
Seat 5: FAUCES collected (€0.12)
Seat 6: Dr animals folded before Flop (didn't bet)



PokerStars Zoom Hand #257661101536:  Hold'em No Limit (€0.01/€0.02) - 2025/09/08 15:14:30 CET [2025/09/08 9:14:30 ET]
Table 'Arneb' 6-max Seat #1 is the button
Seat 1: Dr animals (€1.58 in chips) 
Seat 2: madbikeman (€1.61 in chips) 
Seat 3: EiramSenpai (€2.82 in chips) 
Seat 4: MDKristian (€2.25 in chips) 
Seat 5: SUNTZU47 (€5.18 in chips) 
Seat 6: pipinoelbreve9 (€2.97 in chips) 
madbikeman: posts small blind €0.01
EiramSenpai: posts big blind €0.02
*** HOLE CARDS ***
Dealt to pipinoelbreve9 [4c 6d]
MDKristian: raises €0.02 to €0.04
SUNTZU47: folds 
pipinoelbreve9: folds 
Dr animals: folds 
madbikeman: calls €0.03
EiramSenpai: folds 
*** FLOP *** [Kd Jc 8d]
madbikeman: checks 
MDKristian: checks 
*** TURN *** [Kd Jc 8d] [Qd]
madbikeman: checks 
MDKristian: bets €0.08
madbikeman: folds 
Uncalled bet (€0.08) returned to MDKristian
MDKristian collected €0.10 from pot
MDKristian: doesn't show hand 
*** SUMMARY ***
Total pot €0.10 | Rake €0 
Board [Kd Jc 8d Qd]
Seat 1: Dr animals (button) folded before Flop (didn't bet)
Seat 2: madbikeman (small blind) folded on the Turn
Seat 3: EiramSenpai (big blind) folded before Flop
Seat 4: MDKristian collected (€0.10)
Seat 5: SUNTZU47 folded before Flop (didn't bet)
Seat 6: pipinoelbreve9 folded before Flop (didn't bet)



PokerStars Zoom Hand #257661104603:  Hold'em No Limit (€0.01/€0.02) - 2025/09/08 15:14:52 CET [2025/09/08 9:14:52 ET]
Table 'Arneb' 6-max Seat #1 is the button
Seat 1: SMN242 (€2.27 in chips) 
Seat 2: pipinoelbreve9 (€2.95 in chips) 
Seat 3: Tyrandes4pattes (€3.66 in chips) 
Seat 4: guizzado16 (€3.21 in chips) 
Seat 5: ecuinas (€2.47 in chips) 
Seat 6: yunowme (€2 in chips) 
pipinoelbreve9: posts small blind €0.01
Tyrandes4pattes: posts big blind €0.02
*** HOLE CARDS ***
Dealt to pipinoelbreve9 [4h 8h]
guizzado16: folds 
ecuinas: raises €0.04 to €0.06
yunowme: folds 
SMN242: folds 
pipinoelbreve9: folds 
Tyrandes4pattes: folds 
Uncalled bet (€0.04) returned to ecuinas
ecuinas collected €0.05 from pot
ecuinas: doesn't show hand 
*** SUMMARY ***
Total pot €0.05 | Rake €0 
Seat 1: SMN242 (button) folded before Flop (didn't bet)
Seat 2: pipinoelbreve9 (small blind) folded before Flop
Seat 3: Tyrandes4pattes (big blind) folded before Flop
Seat 4: guizzado16 folded before Flop (didn't bet)
Seat 5: ecuinas collected (€0.05)
Seat 6: yunowme folded before Flop (didn't bet)



PokerStars Zoom Hand #257661103099:  Hold'em No Limit (€0.01/€0.02) - 2025/09/08 15:14:41 CET [2025/09/08 9:14:41 ET]
Table 'Arneb' 6-max Seat #1 is the button
Seat 1: ABotillo12 (€3.54 in chips) 
Seat 2: RMOT100A (€2.18 in chips) 
Seat 3: pipinoelbreve9 (€2.97 in chips) 
Seat 4: soyeterno (€2.97 in chips) 
Seat 5: ecuinas (€2.47 in chips) 
Seat 6: llocant (€1.66 in chips) 
RMOT100A: posts small blind €0.01
pipinoelbreve9: posts big blind €0.02
*** HOLE CARDS ***
Dealt to pipinoelbreve9 [9c 4h]
soyeterno: raises €0.04 to €0.06
ecuinas: folds 
llocant has timed out
llocant: folds 
ABotillo12: folds 
RMOT100A: calls €0.05
pipinoelbreve9: folds 
*** FLOP *** [Th 6c Kh]
RMOT100A: checks 
soyeterno: bets €0.07
RMOT100A: folds 
Uncalled bet (€0.07) returned to soyeterno
soyeterno collected €0.13 from pot
soyeterno: doesn't show hand 
*** SUMMARY ***
Total pot €0.14 | Rake €0.01 
Board [Th 6c Kh]
Seat 1: ABotillo12 (button) folded before Flop (didn't bet)
Seat 2: RMOT100A (small blind) folded on the Flop
Seat 3: pipinoelbreve9 (big blind) folded before Flop
Seat 4: soyeterno collected (€0.13)
Seat 5: ecuinas folded before Flop (didn't bet)
Seat 6: llocant folded before Flop (didn't bet)



PokerStars Zoom Hand #257661105134:  Hold'em No Limit (€0.01/€0.02) - 2025/09/08 15:14:56 CET [2025/09/08 9:14:56 ET]
Table 'Arneb' 6-max Seat #1 is the button
Seat 1: pipinoelbreve9 (€2.94 in chips) 
Seat 2: 34pluto (€1.46 in chips) 
Seat 3: Ivanovich960 (€6.01 in chips) 
Seat 4: Dr animals (€1.57 in chips) 
Seat 5: swiitx (€2.05 in chips) 
Seat 6: vclx (€2.17 in chips) 
34pluto: posts small blind €0.01
Ivanovich960: posts big blind €0.02
*** HOLE CARDS ***
Dealt to pipinoelbreve9 [Ad Kc]
Dr animals: calls €0.02
swiitx: folds 
vclx: folds 
pipinoelbreve9: raises €0.08 to €0.10
34pluto: folds 
Ivanovich960: folds 
Dr animals: folds 
Uncalled bet (€0.08) returned to pipinoelbreve9
pipinoelbreve9 collected €0.07 from pot
pipinoelbreve9: doesn't show hand 
*** SUMMARY ***
Total pot €0.07 | Rake €0 
Seat 1: pipinoelbreve9 (button) collected (€0.07)
Seat 2: 34pluto (small blind) folded before Flop
Seat 3: Ivanovich960 (big blind) folded before Flop
Seat 4: Dr animals folded before Flop
Seat 5: swiitx folded before Flop (didn't bet)
Seat 6: vclx folded before Flop (didn't bet)



PokerStars Zoom Hand #257661110613:  Hold'em No Limit (€0.01/€0.02) - 2025/09/08 15:15:36 CET [2025/09/08 9:15:36 ET]
Table 'Arneb' 6-max Seat #1 is the button
Seat 1: FAUCES (€1.95 in chips) 
Seat 2: combinius1 (€2 in chips) 
Seat 3: SUNTZU47 (€1.58 in chips) 
Seat 4: KillVerlaine (€5.45 in chips) 
Seat 5: pipinoelbreve9 (€2.99 in chips) 
Seat 6: ABotillo12 (€3.55 in chips) 
combinius1: posts small blind €0.01
SUNTZU47: posts big blind €0.02
*** HOLE CARDS ***
Dealt to pipinoelbreve9 [Kd 5h]
KillVerlaine: folds 
pipinoelbreve9: folds 
ABotillo12: folds 
FAUCES: folds 
combinius1: raises €0.04 to €0.06
SUNTZU47: folds 
Uncalled bet (€0.04) returned to combinius1
combinius1 collected €0.04 from pot
combinius1: doesn't show hand 
*** SUMMARY ***
Total pot €0.04 | Rake €0 
Seat 1: FAUCES (button) folded before Flop (didn't bet)
Seat 2: combinius1 (small blind) collected (€0.04)
Seat 3: SUNTZU47 (big blind) folded before Flop
Seat 4: KillVerlaine folded before Flop (didn't bet)
Seat 5: pipinoelbreve9 folded before Flop (didn't bet)
Seat 6: ABotillo12 folded before Flop (didn't bet)



PokerStars Zoom Hand #257661111269:  Hold'em No Limit (€0.01/€0.02) - 2025/09/08 15:15:41 CET [2025/09/08 9:15:41 ET]
Table 'Arneb' 6-max Seat #1 is the button
Seat 1: SUNTZU47 (€5.11 in chips) 
Seat 2: EiramSenpai (€7.84 in chips) 
Seat 3: pepetoni60 (€2.17 in chips) 
Seat 4: pipinoelbreve9 (€2.99 in chips) 
Seat 5: combinius1 (€2.70 in chips) 
Seat 6: Utusuchaz (€2 in chips) 
EiramSenpai: posts small blind €0.01
pepetoni60: posts big blind €0.02
*** HOLE CARDS ***
Dealt to pipinoelbreve9 [7s Ts]
pipinoelbreve9: folds 
combinius1: raises €0.03 to €0.05
Utusuchaz: folds 
SUNTZU47: folds 
EiramSenpai: folds 
pepetoni60: folds 
Uncalled bet (€0.03) returned to combinius1
combinius1 collected €0.05 from pot
combinius1: doesn't show hand 
*** SUMMARY ***
Total pot €0.05 | Rake €0 
Seat 1: SUNTZU47 (button) folded before Flop (didn't bet)
Seat 2: EiramSenpai (small blind) folded before Flop
Seat 3: pepetoni60 (big blind) folded before Flop
Seat 4: pipinoelbreve9 folded before Flop (didn't bet)
Seat 5: combinius1 collected (€0.05)
Seat 6: Utusuchaz folded before Flop (didn't bet)



PokerStars Zoom Hand #257661111800:  Hold'em No Limit (€0.01/€0.02) - 2025/09/08 15:15:45 CET [2025/09/08 9:15:45 ET]
Table 'Arneb' 6-max Seat #1 is the button
Seat 1: Olga197153 (€0.02 in chips) 
Seat 2: SUNTZU47 (€1.23 in chips) 
Seat 3: MDKristian (€2.11 in chips) 
Seat 4: pipinoelbreve9 (€2.99 in chips) 
Seat 5: Tyrandes4pattes (€2.98 in chips) 
Seat 6: Percu32 (€2.86 in chips) 
SUNTZU47: posts small blind €0.01
MDKristian: posts big blind €0.02
*** HOLE CARDS ***
Dealt to pipinoelbreve9 [3d 4s]
pipinoelbreve9: folds 
Tyrandes4pattes: folds 
Percu32: raises €0.04 to €0.06
Olga197153: calls €0.02 and is all-in
SUNTZU47: folds 
MDKristian: folds 
Uncalled bet (€0.04) returned to Percu32
*** FLOP *** [Jh Kd 7d]
*** TURN *** [Jh Kd 7d] [3c]
*** RIVER *** [Jh Kd 7d 3c] [9h]
*** SHOW DOWN ***
Percu32: shows [Td 8d] (a straight, Seven to Jack)
Olga197153: shows [Kc 3h] (two pair, Kings and Threes)
Percu32 collected €0.07 from pot
*** SUMMARY ***
Total pot €0.07 | Rake €0 
Board [Jh Kd 7d 3c 9h]
Seat 1: Olga197153 (button) showed [Kc 3h] and lost with two pair, Kings and Threes
Seat 2: SUNTZU47 (small blind) folded before Flop
Seat 3: MDKristian (big blind) folded before Flop
Seat 4: pipinoelbreve9 folded before Flop (didn't bet)
Seat 5: Tyrandes4pattes folded before Flop (didn't bet)
Seat 6: Percu32 showed [Td 8d] and won (€0.07) with a straight, Seven to Jack



PokerStars Zoom Hand #257661112347:  Hold'em No Limit (€0.01/€0.02) - 2025/09/08 15:15:48 CET [2025/09/08 9:15:48 ET]
Table 'Arneb' 6-max Seat #1 is the button
Seat 1: MDKristian (€2 in chips) 
Seat 2: 34pluto (€0.74 in chips) 
Seat 3: pipinoelbreve9 (€2.99 in chips) 
Seat 4: Jackeuj32 (€1.44 in chips) 
Seat 5: manolo1953 (€0.83 in chips) 
Seat 6: pucelay.29 (€2.58 in chips) 
34pluto: posts small blind €0.01
pipinoelbreve9: posts big blind €0.02
*** HOLE CARDS ***
Dealt to pipinoelbreve9 [5s 6s]
Jackeuj32 has timed out
Jackeuj32: folds 
manolo1953: folds 
pucelay.29: folds 
MDKristian: folds 
34pluto: folds 
Uncalled bet (€0.01) returned to pipinoelbreve9
pipinoelbreve9 collected €0.02 from pot
pipinoelbreve9: doesn't show hand 
*** SUMMARY ***
Total pot €0.02 | Rake €0 
Seat 1: MDKristian (button) folded before Flop (didn't bet)
Seat 2: 34pluto (small blind) folded before Flop
Seat 3: pipinoelbreve9 (big blind) collected (€0.02)
Seat 4: Jackeuj32 folded before Flop (didn't bet)
Seat 5: manolo1953 folded before Flop (didn't bet)
Seat 6: pucelay.29 folded before Flop (didn't bet)



PokerStars Zoom Hand #257661116948:  Hold'em No Limit (€0.01/€0.02) - 2025/09/08 15:16:22 CET [2025/09/08 9:16:22 ET]
Table 'Arneb' 6-max Seat #1 is the button
Seat 1: V1e4ra (€2.66 in chips) 
Seat 2: soyeterno (€3.07 in chips) 
Seat 3: RMOT100A (€2.03 in chips) 
Seat 4: MDKristian (€2 in chips) 
Seat 5: crissstal (€1.40 in chips) 
Seat 6: pipinoelbreve9 (€2.99 in chips) 
soyeterno: posts small blind €0.01
RMOT100A: posts big blind €0.02
*** HOLE CARDS ***
Dealt to pipinoelbreve9 [Jh 9c]
MDKristian: folds 
crissstal: folds 
pipinoelbreve9: folds 
V1e4ra: folds 
soyeterno: folds 
Uncalled bet (€0.01) returned to RMOT100A
RMOT100A collected €0.02 from pot
RMOT100A: doesn't show hand 
*** SUMMARY ***
Total pot €0.02 | Rake €0 
Seat 1: V1e4ra (button) folded before Flop (didn't bet)
Seat 2: soyeterno (small blind) folded before Flop
Seat 3: RMOT100A (big blind) collected (€0.02)
Seat 4: MDKristian folded before Flop (didn't bet)
Seat 5: crissstal folded before Flop (didn't bet)
Seat 6: pipinoelbreve9 folded before Flop (didn't bet)



PokerStars Zoom Hand #257661117819:  Hold'em No Limit (€0.01/€0.02) - 2025/09/08 15:16:28 CET [2025/09/08 9:16:28 ET]
Table 'Arneb' 6-max Seat #1 is the button
Seat 1: pepetoni60 (€1.89 in chips) 
Seat 2: ABotillo12 (€3.55 in chips) 
Seat 3: MDKristian (€2.08 in chips) 
Seat 4: V1e4ra (€2.66 in chips) 
Seat 5: pipinoelbreve9 (€2.99 in chips) 
Seat 6: Popins0011 (€6.66 in chips) 
ABotillo12: posts small blind €0.01
MDKristian: posts big blind €0.02
*** HOLE CARDS ***
Dealt to pipinoelbreve9 [3c Jd]
V1e4ra: folds 
pipinoelbreve9: folds 
Popins0011: folds 
pepetoni60: folds 
ABotillo12: folds 
Uncalled bet (€0.01) returned to MDKristian
MDKristian collected €0.02 from pot
MDKristian: doesn't show hand 
*** SUMMARY ***
Total pot €0.02 | Rake €0 
Seat 1: pepetoni60 (button) folded before Flop (didn't bet)
Seat 2: ABotillo12 (small blind) folded before Flop
Seat 3: MDKristian (big blind) collected (€0.02)
Seat 4: V1e4ra folded before Flop (didn't bet)
Seat 5: pipinoelbreve9 folded before Flop (didn't bet)
Seat 6: Popins0011 folded before Flop (didn't bet)



PokerStars Zoom Hand #257661118626:  Hold'em No Limit (€0.01/€0.02) - 2025/09/08 15:16:34 CET [2025/09/08 9:16:34 ET]
Table 'Arneb' 6-max Seat #1 is the button
Seat 1: pipinoelbreve9 (€2.99 in chips) 
Seat 2: Gonzalo_PB1 (€2.01 in chips) 
Seat 3: Tyrandes4pattes (€2.28 in chips) 
Seat 4: EiramSenpai (€2.66 in chips) 
Seat 5: tapirMM9 (€2.52 in chips) 
Seat 6: FAUCES (€2 in chips) 
Gonzalo_PB1: posts small blind €0.01
Tyrandes4pattes: posts big blind €0.02
*** HOLE CARDS ***
Dealt to pipinoelbreve9 [Kc Ks]
EiramSenpai: folds 
tapirMM9: raises €0.04 to €0.06
FAUCES: calls €0.06
pipinoelbreve9: raises €0.18 to €0.24
Gonzalo_PB1: folds 
Tyrandes4pattes: folds 
tapirMM9: calls €0.18
FAUCES: folds 
*** FLOP *** [6c Tc 4h]
tapirMM9: checks 
pipinoelbreve9: bets €0.21
tapirMM9: folds 
Uncalled bet (€0.21) returned to pipinoelbreve9
pipinoelbreve9 collected €0.54 from pot
pipinoelbreve9: doesn't show hand 
*** SUMMARY ***
Total pot €0.57 | Rake €0.03 
Board [6c Tc 4h]
Seat 1: pipinoelbreve9 (button) collected (€0.54)
Seat 2: Gonzalo_PB1 (small blind) folded before Flop
Seat 3: Tyrandes4pattes (big blind) folded before Flop
Seat 4: EiramSenpai folded before Flop (didn't bet)
Seat 5: tapirMM9 folded on the Flop
Seat 6: FAUCES folded before Flop



PokerStars Zoom Hand #257661125715:  Hold'em No Limit (€0.01/€0.02) - 2025/09/08 15:17:26 CET [2025/09/08 9:17:26 ET]
Table 'Arneb' 6-max Seat #1 is the button
Seat 1: Gonzalo_PB1 (€2 in chips) 
Seat 2: xaratax (€3.62 in chips) 
Seat 3: pipinoelbreve9 (€3.29 in chips) 
Seat 4: Jackeuj32 (€1.38 in chips) 
Seat 5: madbikeman (€1.90 in chips) 
Seat 6: FabRib1978 (€0.93 in chips) 
xaratax: posts small blind €0.01
pipinoelbreve9: posts big blind €0.02
*** HOLE CARDS ***
Dealt to pipinoelbreve9 [5c 4d]
Jackeuj32: folds 
madbikeman: folds 
FabRib1978: folds 
Gonzalo_PB1: raises €0.03 to €0.05
xaratax: folds 
pipinoelbreve9: folds 
Uncalled bet (€0.03) returned to Gonzalo_PB1
Gonzalo_PB1 collected €0.05 from pot
Gonzalo_PB1: doesn't show hand 
*** SUMMARY ***
Total pot €0.05 | Rake €0 
Seat 1: Gonzalo_PB1 (button) collected (€0.05)
Seat 2: xaratax (small blind) folded before Flop
Seat 3: pipinoelbreve9 (big blind) folded before Flop
Seat 4: Jackeuj32 folded before Flop (didn't bet)
Seat 5: madbikeman folded before Flop (didn't bet)
Seat 6: FabRib1978 folded before Flop (didn't bet)



PokerStars Zoom Hand #257661116216:  Hold'em No Limit (€0.01/€0.02) - 2025/09/08 15:16:16 CET [2025/09/08 9:16:16 ET]
Table 'Arneb' 6-max Seat #1 is the button
Seat 1: Utusuchaz (€2 in chips) 
Seat 2: pipinoelbreve9 (€3 in chips) 
Seat 3: 34pluto (€1.47 in chips) 
Seat 4: pucelay.29 (€2.41 in chips) 
Seat 5: Abrelatas787 (€2.45 in chips) 
Seat 6: MDKristian (€2.08 in chips) 
pipinoelbreve9: posts small blind €0.01
34pluto: posts big blind €0.02
*** HOLE CARDS ***
Dealt to pipinoelbreve9 [Jh 4d]
pucelay.29: calls €0.02
Abrelatas787: folds 
MDKristian: folds 
Utusuchaz: folds 
pipinoelbreve9: folds 
34pluto: checks 
*** FLOP *** [5s Qh 6h]
34pluto: checks 
pucelay.29: checks 
*** TURN *** [5s Qh 6h] [8d]
34pluto: checks 
pucelay.29: checks 
*** RIVER *** [5s Qh 6h 8d] [8s]
34pluto: checks 
pucelay.29: checks 
*** SHOW DOWN ***
34pluto: shows [2h 6d] (two pair, Eights and Sixes)
pucelay.29: mucks hand 
34pluto collected €0.05 from pot
*** SUMMARY ***
Total pot €0.05 | Rake €0 
Board [5s Qh 6h 8d 8s]
Seat 1: Utusuchaz (button) folded before Flop (didn't bet)
Seat 2: pipinoelbreve9 (small blind) folded before Flop
Seat 3: 34pluto (big blind) showed [2h 6d] and won (€0.05) with two pair, Eights and Sixes
Seat 4: pucelay.29 mucked [Kc Ts]
Seat 5: Abrelatas787 folded before Flop (didn't bet)
Seat 6: MDKristian folded before Flop (didn't bet)



PokerStars Zoom Hand #257661128498:  Hold'em No Limit (€0.01/€0.02) - 2025/09/08 15:17:46 CET [2025/09/08 9:17:46 ET]
Table 'Arneb' 6-max Seat #1 is the button
Seat 1: FabRib1978 (€0.94 in chips) 
Seat 2: pipinoelbreve9 (€3.27 in chips) 
Seat 3: xaratax (€3.61 in chips) 
Seat 4: Gonzalo_PB1 (€2.03 in chips) 
Seat 5: Percu32 (€2.83 in chips) 
Seat 6: V1e4ra (€2.61 in chips) 
pipinoelbreve9: posts small blind €0.01
xaratax: posts big blind €0.02
*** HOLE CARDS ***
Dealt to pipinoelbreve9 [6s 3s]
Gonzalo_PB1: raises €0.02 to €0.04
Percu32: folds 
V1e4ra: folds 
FabRib1978: folds 
pipinoelbreve9: folds 
xaratax: folds 
Uncalled bet (€0.02) returned to Gonzalo_PB1
Gonzalo_PB1 collected €0.05 from pot
Gonzalo_PB1: doesn't show hand 
*** SUMMARY ***
Total pot €0.05 | Rake €0 
Seat 1: FabRib1978 (button) folded before Flop (didn't bet)
Seat 2: pipinoelbreve9 (small blind) folded before Flop
Seat 3: xaratax (big blind) folded before Flop
Seat 4: Gonzalo_PB1 collected (€0.05)
Seat 5: Percu32 folded before Flop (didn't bet)
Seat 6: V1e4ra folded before Flop (didn't bet)



PokerStars Zoom Hand #257661127909:  Hold'em No Limit (€0.01/€0.02) - 2025/09/08 15:17:42 CET [2025/09/08 9:17:42 ET]
Table 'Arneb' 6-max Seat #1 is the button
Seat 1: pepetoni60 (€1.86 in chips) 
Seat 2: EiramSenpai (€2.58 in chips) 
Seat 3: Utusuchaz (€2.18 in chips) 
Seat 4: HDFUNRS1 (€1.71 in chips) 
Seat 5: Gonzalo_PB1 (€2.03 in chips) 
Seat 6: pipinoelbreve9 (€3.27 in chips) 
EiramSenpai: posts small blind €0.01
Utusuchaz: posts big blind €0.02
*** HOLE CARDS ***
Dealt to pipinoelbreve9 [4c Jh]
HDFUNRS1: folds 
Gonzalo_PB1: folds 
pipinoelbreve9: folds 
pepetoni60: raises €0.04 to €0.06
EiramSenpai: folds 
Utusuchaz: calls €0.04
*** FLOP *** [2s As 7c]
Utusuchaz: checks 
pepetoni60: bets €0.06
Utusuchaz: calls €0.06
*** TURN *** [2s As 7c] [Jc]
Utusuchaz: checks 
pepetoni60: checks 
*** RIVER *** [2s As 7c Jc] [4d]
Utusuchaz: checks 
pepetoni60: checks 
*** SHOW DOWN ***
Utusuchaz: shows [Qs Js] (a pair of Jacks)
pepetoni60: shows [Kh Ks] (a pair of Kings)
pepetoni60 collected €0.24 from pot
*** SUMMARY ***
Total pot €0.25 | Rake €0.01 
Board [2s As 7c Jc 4d]
Seat 1: pepetoni60 (button) showed [Kh Ks] and won (€0.24) with a pair of Kings
Seat 2: EiramSenpai (small blind) folded before Flop
Seat 3: Utusuchaz (big blind) showed [Qs Js] and lost with a pair of Jacks
Seat 4: HDFUNRS1 folded before Flop (didn't bet)
Seat 5: Gonzalo_PB1 folded before Flop (didn't bet)
Seat 6: pipinoelbreve9 folded before Flop (didn't bet)



PokerStars Zoom Hand #257661129064:  Hold'em No Limit (€0.01/€0.02) - 2025/09/08 15:17:50 CET [2025/09/08 9:17:50 ET]
Table 'Arneb' 6-max Seat #1 is the button
Seat 1: EiramSenpai (€2.57 in chips) 
Seat 2: HDFUNRS1 (€1.71 in chips) 
Seat 3: Ctr Alt Surp (€1.70 in chips) 
Seat 4: pipinoelbreve9 (€3.26 in chips) 
Seat 5: soyeterno (€2.87 in chips) 
Seat 6: SUNTZU47 (€1.37 in chips) 
HDFUNRS1: posts small blind €0.01
Ctr Alt Surp: posts big blind €0.02
*** HOLE CARDS ***
Dealt to pipinoelbreve9 [Ah Qs]
pipinoelbreve9: raises €0.04 to €0.06
soyeterno: folds 
SUNTZU47: folds 
EiramSenpai: calls €0.06
HDFUNRS1: folds 
Ctr Alt Surp: folds 
*** FLOP *** [4c 6c 5d]
pipinoelbreve9: checks 
EiramSenpai: bets €0.08
pipinoelbreve9: calls €0.08
*** TURN *** [4c 6c 5d] [9s]
pipinoelbreve9: checks 
EiramSenpai: checks 
*** RIVER *** [4c 6c 5d 9s] [Td]
pipinoelbreve9: checks 
EiramSenpai: checks 
*** SHOW DOWN ***
pipinoelbreve9: shows [Ah Qs] (high card Ace)
EiramSenpai: shows [3d 3h] (a pair of Threes)
EiramSenpai collected €0.29 from pot
*** SUMMARY ***
Total pot €0.31 | Rake €0.02 
Board [4c 6c 5d 9s Td]
Seat 1: EiramSenpai (button) showed [3d 3h] and won (€0.29) with a pair of Threes
Seat 2: HDFUNRS1 (small blind) folded before Flop
Seat 3: Ctr Alt Surp (big blind) folded before Flop
Seat 4: pipinoelbreve9 showed [Ah Qs] and lost with high card Ace
Seat 5: soyeterno folded before Flop (didn't bet)
Seat 6: SUNTZU47 folded before Flop (didn't bet)



PokerStars Zoom Hand #257661135231:  Hold'em No Limit (€0.01/€0.02) - 2025/09/08 15:18:35 CET [2025/09/08 9:18:35 ET]
Table 'Arneb' 6-max Seat #1 is the button
Seat 1: HDFUNRS1 (€1.67 in chips) 
Seat 2: Ivanovich960 (€6.21 in chips) 
Seat 3: 34pluto (€1.52 in chips) 
Seat 4: MDKristian (€2 in chips) 
Seat 5: xaratax (€3.56 in chips) 
Seat 6: pipinoelbreve9 (€3.12 in chips) 
Ivanovich960: posts small blind €0.01
34pluto: posts big blind €0.02
*** HOLE CARDS ***
Dealt to pipinoelbreve9 [Qd 5c]
MDKristian: folds 
xaratax: folds 
pipinoelbreve9: folds 
HDFUNRS1: folds 
Ivanovich960: folds 
Uncalled bet (€0.01) returned to 34pluto
34pluto collected €0.02 from pot
34pluto: doesn't show hand 
*** SUMMARY ***
Total pot €0.02 | Rake €0 
Seat 1: HDFUNRS1 (button) folded before Flop (didn't bet)
Seat 2: Ivanovich960 (small blind) folded before Flop
Seat 3: 34pluto (big blind) collected (€0.02)
Seat 4: MDKristian folded before Flop (didn't bet)
Seat 5: xaratax folded before Flop (didn't bet)
Seat 6: pipinoelbreve9 folded before Flop (didn't bet)



PokerStars Zoom Hand #257661134463:  Hold'em No Limit (€0.01/€0.02) - 2025/09/08 15:18:29 CET [2025/09/08 9:18:29 ET]
Table 'Arneb' 6-max Seat #1 is the button
Seat 1: pantojafeli (€2.09 in chips) 
Seat 2: Tyrandes4pattes (€2.36 in chips) 
Seat 3: SMN242 (€2.37 in chips) 
Seat 4: pipinoelbreve9 (€3.12 in chips) 
Seat 5: EiramSenpai (€2.72 in chips) 
Seat 6: MDKristian (€2.40 in chips) 
Tyrandes4pattes: posts small blind €0.01
SMN242: posts big blind €0.02
*** HOLE CARDS ***
Dealt to pipinoelbreve9 [Qs 7h]
pipinoelbreve9: folds 
EiramSenpai: raises €0.02 to €0.04
MDKristian: raises €0.08 to €0.12
pantojafeli: folds 
Tyrandes4pattes: folds 
SMN242: folds 
EiramSenpai: folds 
Uncalled bet (€0.08) returned to MDKristian
MDKristian collected €0.11 from pot
MDKristian: doesn't show hand 
*** SUMMARY ***
Total pot €0.11 | Rake €0 
Seat 1: pantojafeli (button) folded before Flop (didn't bet)
Seat 2: Tyrandes4pattes (small blind) folded before Flop
Seat 3: SMN242 (big blind) folded before Flop
Seat 4: pipinoelbreve9 folded before Flop (didn't bet)
Seat 5: EiramSenpai folded before Flop
Seat 6: MDKristian collected (€0.11)



PokerStars Zoom Hand #257661127038:  Hold'em No Limit (€0.01/€0.02) - 2025/09/08 15:17:36 CET [2025/09/08 9:17:36 ET]
Table 'Arneb' 6-max Seat #1 is the button
Seat 1: pucelay.29 (€2.13 in chips) 
Seat 2: MDKristian (€2.39 in chips) 
Seat 3: ecuinas (€2.26 in chips) 
Seat 4: V1e4ra (€2.41 in chips) 
Seat 5: pipinoelbreve9 (€3.27 in chips) 
Seat 6: vclx (€3.57 in chips) 
MDKristian: posts small blind €0.01
ecuinas: posts big blind €0.02
*** HOLE CARDS ***
Dealt to pipinoelbreve9 [7c Jd]
V1e4ra: raises €0.05 to €0.07
pipinoelbreve9: folds 
vclx: calls €0.07
pucelay.29: raises €0.24 to €0.31
MDKristian: folds 
ecuinas: folds 
V1e4ra: calls €0.24
vclx: folds 
*** FLOP *** [Td Kd 9s]
V1e4ra: checks 
pucelay.29: bets €0.52
V1e4ra: raises €1.58 to €2.10 and is all-in
pucelay.29: calls €1.30 and is all-in
Uncalled bet (€0.28) returned to V1e4ra
*** TURN *** [Td Kd 9s] [Qh]
*** RIVER *** [Td Kd 9s Qh] [Kc]
*** SHOW DOWN ***
V1e4ra: shows [Ah Ac] (two pair, Aces and Kings)
pucelay.29: shows [Tc Ts] (a full house, Tens full of Kings)
pucelay.29 collected €4.14 from pot
*** SUMMARY ***
Total pot €4.36 | Rake €0.22 
Board [Td Kd 9s Qh Kc]
Seat 1: pucelay.29 (button) showed [Tc Ts] and won (€4.14) with a full house, Tens full of Kings
Seat 2: MDKristian (small blind) folded before Flop
Seat 3: ecuinas (big blind) folded before Flop
Seat 4: V1e4ra showed [Ah Ac] and lost with two pair, Aces and Kings
Seat 5: pipinoelbreve9 folded before Flop (didn't bet)
Seat 6: vclx folded before Flop



PokerStars Zoom Hand #257661135680:  Hold'em No Limit (€0.01/€0.02) - 2025/09/08 15:18:38 CET [2025/09/08 9:18:38 ET]
Table 'Arneb' 6-max Seat #1 is the button
Seat 1: pipinoelbreve9 (€3.12 in chips) 
Seat 2: ecuinas (€2.27 in chips) 
Seat 3: combinius1 (€2.19 in chips) 
Seat 4: MDKristian (€2 in chips) 
Seat 5: soyeterno (€2 in chips) 
Seat 6: rodries4 (€1.33 in chips) 
ecuinas: posts small blind €0.01
combinius1: posts big blind €0.02
*** HOLE CARDS ***
Dealt to pipinoelbreve9 [As 2d]
MDKristian: folds 
soyeterno: folds 
rodries4: calls €0.02
pipinoelbreve9: folds 
ecuinas: folds 
combinius1: checks 
*** FLOP *** [7h Tc Ts]
combinius1: checks 
rodries4: checks 
*** TURN *** [7h Tc Ts] [Jc]
combinius1: checks 
rodries4: checks 
*** RIVER *** [7h Tc Ts Jc] [3d]
combinius1: checks 
rodries4: checks 
*** SHOW DOWN ***
combinius1: shows [4s 6d] (a pair of Tens)
rodries4: shows [Qc Kc] (a pair of Tens - King kicker)
rodries4 collected €0.05 from pot
*** SUMMARY ***
Total pot €0.05 | Rake €0 
Board [7h Tc Ts Jc 3d]
Seat 1: pipinoelbreve9 (button) folded before Flop (didn't bet)
Seat 2: ecuinas (small blind) folded before Flop
Seat 3: combinius1 (big blind) showed [4s 6d] and lost with a pair of Tens
Seat 4: MDKristian folded before Flop (didn't bet)
Seat 5: soyeterno folded before Flop (didn't bet)
Seat 6: rodries4 showed [Qc Kc] and won (€0.05) with a pair of Tens



PokerStars Zoom Hand #257661137139:  Hold'em No Limit (€0.01/€0.02) - 2025/09/08 15:18:49 CET [2025/09/08 9:18:49 ET]
Table 'Arneb' 6-max Seat #1 is the button
Seat 1: 34pluto (€1.53 in chips) 
Seat 2: pantojafeli (€2.09 in chips) 
Seat 3: pipinoelbreve9 (€3.12 in chips) 
Seat 4: EiramSenpai (€2.68 in chips) 
Seat 5: ecuinas (€2.26 in chips) 
Seat 6: Percu32 (€2.83 in chips) 
pantojafeli: posts small blind €0.01
pipinoelbreve9: posts big blind €0.02
*** HOLE CARDS ***
Dealt to pipinoelbreve9 [7s 2h]
EiramSenpai: folds 
ecuinas: folds 
Percu32: raises €0.04 to €0.06
34pluto: folds 
pantojafeli: folds 
pipinoelbreve9: folds 
Uncalled bet (€0.04) returned to Percu32
Percu32 collected €0.05 from pot
Percu32: doesn't show hand 
*** SUMMARY ***
Total pot €0.05 | Rake €0 
Seat 1: 34pluto (button) folded before Flop (didn't bet)
Seat 2: pantojafeli (small blind) folded before Flop
Seat 3: pipinoelbreve9 (big blind) folded before Flop
Seat 4: EiramSenpai folded before Flop (didn't bet)
Seat 5: ecuinas folded before Flop (didn't bet)
Seat 6: Percu32 collected (€0.05)



PokerStars Zoom Hand #257661139515:  Hold'em No Limit (€0.01/€0.02) - 2025/09/08 15:19:06 CET [2025/09/08 9:19:06 ET]
Table 'Arneb' 6-max Seat #1 is the button
Seat 1: pepetoni60 (€1.96 in chips) 
Seat 2: MDKristian (€2 in chips) 
Seat 3: DarthRose (€2.03 in chips) 
Seat 4: pipinoelbreve9 (€3.10 in chips) 
Seat 5: HDFUNRS1 (€1.64 in chips) 
Seat 6: Jackeuj32 (€1.33 in chips) 
MDKristian: posts small blind €0.01
DarthRose: posts big blind €0.02
*** HOLE CARDS ***
Dealt to pipinoelbreve9 [7s As]
pipinoelbreve9: raises €0.04 to €0.06
HDFUNRS1: folds 
Jackeuj32: calls €0.06
pepetoni60: folds 
MDKristian: calls €0.05
DarthRose: calls €0.04
*** FLOP *** [5c 8c 4s]
MDKristian: checks 
DarthRose: checks 
pipinoelbreve9: bets €0.08
Jackeuj32: folds 
MDKristian: folds 
DarthRose: calls €0.08
*** TURN *** [5c 8c 4s] [Td]
DarthRose: checks 
pipinoelbreve9: checks 
*** RIVER *** [5c 8c 4s Td] [3d]
DarthRose: bets €0.29
pipinoelbreve9: folds 
Uncalled bet (€0.29) returned to DarthRose
DarthRose collected €0.38 from pot
DarthRose: doesn't show hand 
*** SUMMARY ***
Total pot €0.40 | Rake €0.02 
Board [5c 8c 4s Td 3d]
Seat 1: pepetoni60 (button) folded before Flop (didn't bet)
Seat 2: MDKristian (small blind) folded on the Flop
Seat 3: DarthRose (big blind) collected (€0.38)
Seat 4: pipinoelbreve9 folded on the River
Seat 5: HDFUNRS1 folded before Flop (didn't bet)
Seat 6: Jackeuj32 folded on the Flop



PokerStars Zoom Hand #257661145354:  Hold'em No Limit (€0.01/€0.02) - 2025/09/08 15:19:49 CET [2025/09/08 9:19:49 ET]
Table 'Arneb' 6-max Seat #1 is the button
Seat 1: rodries4 (€1.33 in chips) 
Seat 2: pipinoelbreve9 (€2.96 in chips) 
Seat 3: Utusuchaz (€2 in chips) 
Seat 4: soyeterno (€2 in chips) 
Seat 5: Tyrandes4pattes (€6.92 in chips) 
Seat 6: EiramSenpai (€2.69 in chips) 
pipinoelbreve9: posts small blind €0.01
Utusuchaz: posts big blind €0.02
*** HOLE CARDS ***
Dealt to pipinoelbreve9 [8h 9h]
soyeterno: folds 
Tyrandes4pattes: folds 
EiramSenpai: raises €0.04 to €0.06
rodries4: calls €0.06
pipinoelbreve9: calls €0.05
Utusuchaz: folds 
*** FLOP *** [5s Kc 7h]
pipinoelbreve9: checks 
EiramSenpai: bets €0.12
rodries4: folds 
pipinoelbreve9: calls €0.12
*** TURN *** [5s Kc 7h] [2h]
pipinoelbreve9: checks 
EiramSenpai: checks 
*** RIVER *** [5s Kc 7h 2h] [2c]
pipinoelbreve9: checks 
EiramSenpai: bets €0.22
pipinoelbreve9: folds 
Uncalled bet (€0.22) returned to EiramSenpai
EiramSenpai collected €0.42 from pot
EiramSenpai: doesn't show hand 
*** SUMMARY ***
Total pot €0.44 | Rake €0.02 
Board [5s Kc 7h 2h 2c]
Seat 1: rodries4 (button) folded on the Flop
Seat 2: pipinoelbreve9 (small blind) folded on the River
Seat 3: Utusuchaz (big blind) folded before Flop
Seat 4: soyeterno folded before Flop (didn't bet)
Seat 5: Tyrandes4pattes folded before Flop (didn't bet)
Seat 6: EiramSenpai collected (€0.42)



PokerStars Zoom Hand #257661154442:  Hold'em No Limit (€0.01/€0.02) - 2025/09/08 15:20:55 CET [2025/09/08 9:20:55 ET]
Table 'Arneb' 6-max Seat #1 is the button
Seat 1: Utusuchaz (€2.10 in chips) 
Seat 2: guizzado16 (€3.81 in chips) 
Seat 3: MDKristian (€2.25 in chips) 
Seat 4: pipinoelbreve9 (€2.78 in chips) 
Seat 5: pucelay.29 (€2.18 in chips) 
Seat 6: Tyrandes4pattes (€2.55 in chips) 
guizzado16: posts small blind €0.01
MDKristian: posts big blind €0.02
*** HOLE CARDS ***
Dealt to pipinoelbreve9 [Kh Jh]
pipinoelbreve9 has timed out
pipinoelbreve9: folds 
pucelay.29: folds 
Tyrandes4pattes: folds 
Utusuchaz: folds 
guizzado16: raises €0.04 to €0.06
MDKristian: folds 
Uncalled bet (€0.04) returned to guizzado16
guizzado16 collected €0.04 from pot
guizzado16: doesn't show hand 
*** SUMMARY ***
Total pot €0.04 | Rake €0 
Seat 1: Utusuchaz (button) folded before Flop (didn't bet)
Seat 2: guizzado16 (small blind) collected (€0.04)
Seat 3: MDKristian (big blind) folded before Flop
Seat 4: pipinoelbreve9 folded before Flop (didn't bet)
Seat 5: pucelay.29 folded before Flop (didn't bet)
Seat 6: Tyrandes4pattes folded before Flop (didn't bet)



PokerStars Zoom Hand #257661156822:  Hold'em No Limit (€0.01/€0.02) - 2025/09/08 15:21:13 CET [2025/09/08 9:21:13 ET]
Table 'Arneb' 6-max Seat #1 is the button
Seat 1: pipinoelbreve9 (€2.78 in chips) 
Seat 2: GamerVidal (€7.33 in chips) 
Seat 3: MDKristian (€2.09 in chips) 
Seat 4: pucelay.29 (€4.06 in chips) 
Seat 5: tapirMM9 (€2.32 in chips) 
Seat 6: combinius1 (€2 in chips) 
GamerVidal: posts small blind €0.01
MDKristian: posts big blind €0.02
*** HOLE CARDS ***
Dealt to pipinoelbreve9 [Tc 6h]
pucelay.29: folds 
tapirMM9: raises €0.04 to €0.06
combinius1: folds 
pipinoelbreve9: folds 
GamerVidal: folds 
MDKristian: folds 
Uncalled bet (€0.04) returned to tapirMM9
tapirMM9 collected €0.05 from pot
tapirMM9: doesn't show hand 
*** SUMMARY ***
Total pot €0.05 | Rake €0 
Seat 1: pipinoelbreve9 (button) folded before Flop (didn't bet)
Seat 2: GamerVidal (small blind) folded before Flop
Seat 3: MDKristian (big blind) folded before Flop
Seat 4: pucelay.29 folded before Flop (didn't bet)
Seat 5: tapirMM9 collected (€0.05)
Seat 6: combinius1 folded before Flop (didn't bet)



PokerStars Zoom Hand #257661156347:  Hold'em No Limit (€0.01/€0.02) - 2025/09/08 15:21:09 CET [2025/09/08 9:21:09 ET]
Table 'Arneb' 6-max Seat #1 is the button
Seat 1: Abrelatas787 (€2.78 in chips) 
Seat 2: DarthRose (€2.23 in chips) 
Seat 3: Utusuchaz (€2.22 in chips) 
Seat 4: osking118 (€1.67 in chips) 
Seat 5: pipinoelbreve9 (€2.78 in chips) 
Seat 6: tapirMM9 (€2.32 in chips) 
DarthRose: posts small blind €0.01
Utusuchaz: posts big blind €0.02
*** HOLE CARDS ***
Dealt to pipinoelbreve9 [5s Kd]
osking118: raises €0.02 to €0.04
pipinoelbreve9: folds 
tapirMM9: folds 
Abrelatas787: calls €0.04
DarthRose: folds 
Utusuchaz: raises €0.24 to €0.28
osking118: folds 
Abrelatas787: folds 
Uncalled bet (€0.24) returned to Utusuchaz
Utusuchaz collected €0.13 from pot
Utusuchaz: doesn't show hand 
*** SUMMARY ***
Total pot €0.13 | Rake €0 
Seat 1: Abrelatas787 (button) folded before Flop
Seat 2: DarthRose (small blind) folded before Flop
Seat 3: Utusuchaz (big blind) collected (€0.13)
Seat 4: osking118 folded before Flop
Seat 5: pipinoelbreve9 folded before Flop (didn't bet)
Seat 6: tapirMM9 folded before Flop (didn't bet)



PokerStars Zoom Hand #257661157549:  Hold'em No Limit (€0.01/€0.02) - 2025/09/08 15:21:18 CET [2025/09/08 9:21:18 ET]
Table 'Arneb' 6-max Seat #1 is the button
Seat 1: vclx (€3.45 in chips) 
Seat 2: 34pluto (€0.78 in chips) 
Seat 3: pipinoelbreve9 (€2.78 in chips) 
Seat 4: GamerVidal (€1.86 in chips) 
Seat 5: combinius1 (€2 in chips) 
Seat 6: guizzado16 (€3.83 in chips) 
34pluto: posts small blind €0.01
pipinoelbreve9: posts big blind €0.02
*** HOLE CARDS ***
Dealt to pipinoelbreve9 [3c 6d]
GamerVidal: raises €0.04 to €0.06
combinius1: folds 
guizzado16: folds 
vclx: folds 
34pluto: folds 
pipinoelbreve9: folds 
Uncalled bet (€0.04) returned to GamerVidal
GamerVidal collected €0.05 from pot
GamerVidal: doesn't show hand 
*** SUMMARY ***
Total pot €0.05 | Rake €0 
Seat 1: vclx (button) folded before Flop (didn't bet)
Seat 2: 34pluto (small blind) folded before Flop
Seat 3: pipinoelbreve9 (big blind) folded before Flop
Seat 4: GamerVidal collected (€0.05)
Seat 5: combinius1 folded before Flop (didn't bet)
Seat 6: guizzado16 folded before Flop (didn't bet)



PokerStars Zoom Hand #257661160446:  Hold'em No Limit (€0.01/€0.02) - 2025/09/08 15:21:39 CET [2025/09/08 9:21:39 ET]
Table 'Arneb' 6-max Seat #1 is the button
Seat 1: pucelay.29 (€2.22 in chips) 
Seat 2: lucky_rookie060 (€0.75 in chips) 
Seat 3: pepetoni60 (€3.59 in chips) 
Seat 4: Tyrandes4pattes (€3.44 in chips) 
Seat 5: pipinoelbreve9 (€2.75 in chips) 
Seat 6: Utusuchaz (€2.31 in chips) 
lucky_rookie060: posts small blind €0.01
pepetoni60: posts big blind €0.02
*** HOLE CARDS ***
Dealt to pipinoelbreve9 [8c 3h]
Tyrandes4pattes: folds 
pipinoelbreve9: folds 
Utusuchaz: folds 
pucelay.29: folds 
lucky_rookie060: folds 
Uncalled bet (€0.01) returned to pepetoni60
pepetoni60 collected €0.02 from pot
pepetoni60: doesn't show hand 
*** SUMMARY ***
Total pot €0.02 | Rake €0 
Seat 1: pucelay.29 (button) folded before Flop (didn't bet)
Seat 2: lucky_rookie060 (small blind) folded before Flop
Seat 3: pepetoni60 (big blind) collected (€0.02)
Seat 4: Tyrandes4pattes folded before Flop (didn't bet)
Seat 5: pipinoelbreve9 folded before Flop (didn't bet)
Seat 6: Utusuchaz folded before Flop (didn't bet)



PokerStars Zoom Hand #257661161435:  Hold'em No Limit (€0.01/€0.02) - 2025/09/08 15:21:46 CET [2025/09/08 9:21:46 ET]
Table 'Arneb' 6-max Seat #1 is the button
Seat 1: pipinoelbreve9 (€2.75 in chips) 
Seat 2: pucelay.29 (€2.22 in chips) 
Seat 3: crissstal (€1.65 in chips) 
Seat 4: Tyrandes4pattes (€3.44 in chips) 
Seat 5: chitigordi78 (€3.22 in chips) 
Seat 6: Jackeuj32 (€1.12 in chips) 
pucelay.29: posts small blind €0.01
crissstal: posts big blind €0.02
*** HOLE CARDS ***
Dealt to pipinoelbreve9 [9c 7s]
Tyrandes4pattes: folds 
chitigordi78: calls €0.02
Jackeuj32: calls €0.02
pipinoelbreve9: folds 
pucelay.29: calls €0.01
crissstal: checks 
*** FLOP *** [3s 7c 8h]
pucelay.29: checks 
crissstal: bets €0.04
chitigordi78: folds 
Jackeuj32: folds 
pucelay.29: folds 
Uncalled bet (€0.04) returned to crissstal
crissstal collected €0.08 from pot
crissstal: doesn't show hand 
*** SUMMARY ***
Total pot €0.08 | Rake €0 
Board [3s 7c 8h]
Seat 1: pipinoelbreve9 (button) folded before Flop (didn't bet)
Seat 2: pucelay.29 (small blind) folded on the Flop
Seat 3: crissstal (big blind) collected (€0.08)
Seat 4: Tyrandes4pattes folded before Flop (didn't bet)
Seat 5: chitigordi78 folded on the Flop
Seat 6: Jackeuj32 folded on the Flop



PokerStars Zoom Hand #257661163025:  Hold'em No Limit (€0.01/€0.02) - 2025/09/08 15:21:58 CET [2025/09/08 9:21:58 ET]
Table 'Arneb' 6-max Seat #1 is the button
Seat 1: soyeterno (€2.01 in chips) 
Seat 2: SMN242 (€2.43 in chips) 
Seat 3: 34pluto (€0.77 in chips) 
Seat 4: Abrelatas787 (€2.73 in chips) 
Seat 5: pipinoelbreve9 (€2.75 in chips) 
Seat 6: MDKristian (€2 in chips) 
SMN242: posts small blind €0.01
34pluto: posts big blind €0.02
*** HOLE CARDS ***
Dealt to pipinoelbreve9 [Qc Kc]
Abrelatas787: folds 
pipinoelbreve9: raises €0.04 to €0.06
MDKristian: folds 
soyeterno: folds 
SMN242: folds 
34pluto: folds 
Uncalled bet (€0.04) returned to pipinoelbreve9
pipinoelbreve9 collected €0.05 from pot
pipinoelbreve9: doesn't show hand 
*** SUMMARY ***
Total pot €0.05 | Rake €0 
Seat 1: soyeterno (button) folded before Flop (didn't bet)
Seat 2: SMN242 (small blind) folded before Flop
Seat 3: 34pluto (big blind) folded before Flop
Seat 4: Abrelatas787 folded before Flop (didn't bet)
Seat 5: pipinoelbreve9 collected (€0.05)
Seat 6: MDKristian folded before Flop (didn't bet)



PokerStars Zoom Hand #257661159972:  Hold'em No Limit (€0.01/€0.02) - 2025/09/08 15:21:35 CET [2025/09/08 9:21:35 ET]
Table 'Arneb' 6-max Seat #1 is the button
Seat 1: Popins0011 (€7.95 in chips) 
Seat 2: pipinoelbreve9 (€2.76 in chips) 
Seat 3: madbikeman (€1.60 in chips) 
Seat 4: ABotillo12 (€3.88 in chips) 
Seat 5: SMN242 (€2.45 in chips) 
Seat 6: xaratax (€3.57 in chips) 
pipinoelbreve9: posts small blind €0.01
madbikeman: posts big blind €0.02
*** HOLE CARDS ***
Dealt to pipinoelbreve9 [8h 9s]
ABotillo12 has timed out
ABotillo12: folds 
SMN242: folds 
xaratax: raises €0.03 to €0.05
Popins0011: calls €0.05
pipinoelbreve9: folds 
madbikeman: calls €0.03
*** FLOP *** [Th 9c 5h]
madbikeman: checks 
xaratax: bets €0.05
Popins0011: calls €0.05
madbikeman: calls €0.05
*** TURN *** [Th 9c 5h] [Qc]
madbikeman: checks 
xaratax: bets €0.14
Popins0011: calls €0.14
madbikeman: folds 
*** RIVER *** [Th 9c 5h Qc] [Qd]
xaratax: bets €0.41
Popins0011: folds 
Uncalled bet (€0.41) returned to xaratax
xaratax collected €0.56 from pot
xaratax: doesn't show hand 
*** SUMMARY ***
Total pot €0.59 | Rake €0.03 
Board [Th 9c 5h Qc Qd]
Seat 1: Popins0011 (button) folded on the River
Seat 2: pipinoelbreve9 (small blind) folded before Flop
Seat 3: madbikeman (big blind) folded on the Turn
Seat 4: ABotillo12 folded before Flop (didn't bet)
Seat 5: SMN242 folded before Flop (didn't bet)
Seat 6: xaratax collected (€0.56)



PokerStars Zoom Hand #257661165046:  Hold'em No Limit (€0.01/€0.02) - 2025/09/08 15:22:13 CET [2025/09/08 9:22:13 ET]
Table 'Arneb' 6-max Seat #1 is the button
Seat 1: 34pluto (€0.75 in chips) 
Seat 2: pucelay.29 (€4.04 in chips) 
Seat 3: vclx (€2 in chips) 
Seat 4: yunowme (€2.14 in chips) 
Seat 5: madbikeman (€1.50 in chips) 
Seat 6: pipinoelbreve9 (€2.78 in chips) 
pucelay.29: posts small blind €0.01
vclx: posts big blind €0.02
*** HOLE CARDS ***
Dealt to pipinoelbreve9 [3s 4d]
yunowme: folds 
madbikeman: folds 
pipinoelbreve9: folds 
34pluto: folds 
pucelay.29: folds 
Uncalled bet (€0.01) returned to vclx
vclx collected €0.02 from pot
vclx: doesn't show hand 
*** SUMMARY ***
Total pot €0.02 | Rake €0 
Seat 1: 34pluto (button) folded before Flop (didn't bet)
Seat 2: pucelay.29 (small blind) folded before Flop
Seat 3: vclx (big blind) collected (€0.02)
Seat 4: yunowme folded before Flop (didn't bet)
Seat 5: madbikeman folded before Flop (didn't bet)
Seat 6: pipinoelbreve9 folded before Flop (didn't bet)



PokerStars Zoom Hand #257661162062:  Hold'em No Limit (€0.01/€0.02) - 2025/09/08 15:21:51 CET [2025/09/08 9:21:51 ET]
Table 'Arneb' 6-max Seat #1 is the button
Seat 1: yunowme (€2.06 in chips) 
Seat 2: Dr animals (€1.41 in chips) 
Seat 3: Tyrandes4pattes (€3.44 in chips) 
Seat 4: 34pluto (€0.77 in chips) 
Seat 5: Ivanovich960 (€6.11 in chips) 
Seat 6: pipinoelbreve9 (€2.75 in chips) 
Dr animals: posts small blind €0.01
Tyrandes4pattes: posts big blind €0.02
*** HOLE CARDS ***
Dealt to pipinoelbreve9 [8d 3h]
34pluto: folds 
Ivanovich960: folds 
pipinoelbreve9: folds 
yunowme: folds 
Dr animals: calls €0.01
Tyrandes4pattes: raises €0.04 to €0.06
Dr animals: calls €0.04
*** FLOP *** [6d 2c 5s]
Dr animals: checks 
Tyrandes4pattes: checks 
*** TURN *** [6d 2c 5s] [9c]
Dr animals: checks 
Tyrandes4pattes: bets €0.06
Dr animals: calls €0.06
*** RIVER *** [6d 2c 5s 9c] [Qs]
Dr animals: checks 
Tyrandes4pattes: checks 
*** SHOW DOWN ***
Dr animals: shows [Qc Jc] (a pair of Queens)
Tyrandes4pattes: mucks hand 
Dr animals collected €0.23 from pot
*** SUMMARY ***
Total pot €0.24 | Rake €0.01 
Board [6d 2c 5s 9c Qs]
Seat 1: yunowme (button) folded before Flop (didn't bet)
Seat 2: Dr animals (small blind) showed [Qc Jc] and won (€0.23) with a pair of Queens
Seat 3: Tyrandes4pattes (big blind) mucked [As 7d]
Seat 4: 34pluto folded before Flop (didn't bet)
Seat 5: Ivanovich960 folded before Flop (didn't bet)
Seat 6: pipinoelbreve9 folded before Flop (didn't bet)



PokerStars Zoom Hand #257661165901:  Hold'em No Limit (€0.01/€0.02) - 2025/09/08 15:22:19 CET [2025/09/08 9:22:19 ET]
Table 'Arneb' 6-max Seat #1 is the button
Seat 1: Tyrandes4pattes (€6.02 in chips) 
Seat 2: maitreyoda59 (€0.32 in chips) 
Seat 3: pipinoelbreve9 (€2.78 in chips) 
Seat 4: GamerVidal (€1.89 in chips) 
Seat 5: lucky_rookie060 (€2 in chips) 
Seat 6: pucelay.29 (€4.03 in chips) 
maitreyoda59: posts small blind €0.01
pipinoelbreve9: posts big blind €0.02
*** HOLE CARDS ***
Dealt to pipinoelbreve9 [Ac 6s]
GamerVidal: folds 
lucky_rookie060: raises €0.02 to €0.04
pucelay.29: folds 
Tyrandes4pattes: folds 
maitreyoda59: folds 
pipinoelbreve9: calls €0.02
*** FLOP *** [6c Ad Ks]
pipinoelbreve9: checks 
lucky_rookie060: checks 
*** TURN *** [6c Ad Ks] [Qd]
pipinoelbreve9: bets €0.05
lucky_rookie060: raises €0.05 to €0.10
pipinoelbreve9: calls €0.05
*** RIVER *** [6c Ad Ks Qd] [7c]
pipinoelbreve9: checks 
lucky_rookie060: bets €0.28
pipinoelbreve9: folds 
Uncalled bet (€0.28) returned to lucky_rookie060
lucky_rookie060 collected €0.28 from pot
lucky_rookie060: doesn't show hand 
*** SUMMARY ***
Total pot €0.29 | Rake €0.01 
Board [6c Ad Ks Qd 7c]
Seat 1: Tyrandes4pattes (button) folded before Flop (didn't bet)
Seat 2: maitreyoda59 (small blind) folded before Flop
Seat 3: pipinoelbreve9 (big blind) folded on the River
Seat 4: GamerVidal folded before Flop (didn't bet)
Seat 5: lucky_rookie060 collected (€0.28)
Seat 6: pucelay.29 folded before Flop (didn't bet)



PokerStars Zoom Hand #257661176915:  Hold'em No Limit (€0.01/€0.02) - 2025/09/08 15:23:40 CET [2025/09/08 9:23:40 ET]
Table 'Arneb' 6-max Seat #1 is the button
Seat 1: pipinoelbreve9 (€2.63 in chips) 
Seat 2: pucelay.29 (€2.04 in chips) 
Seat 3: swiitx (€1.68 in chips) 
Seat 4: xaratax (€4.39 in chips) 
Seat 5: 34pluto (€1.30 in chips) 
Seat 6: FAUCES (€1.78 in chips) 
pucelay.29: posts small blind €0.01
swiitx: posts big blind €0.02
*** HOLE CARDS ***
Dealt to pipinoelbreve9 [Jc 9c]
xaratax: folds 
34pluto: folds 
FAUCES: folds 
pipinoelbreve9: raises €0.04 to €0.06
pucelay.29: folds 
swiitx: calls €0.04
*** FLOP *** [Ks 8s Qh]
swiitx: checks 
pipinoelbreve9: bets €0.06
swiitx: calls €0.06
*** TURN *** [Ks 8s Qh] [5h]
swiitx: checks 
pipinoelbreve9: checks 
*** RIVER *** [Ks 8s Qh 5h] [Jh]
swiitx: checks 
pipinoelbreve9: checks 
*** SHOW DOWN ***
swiitx: shows [Kh Ts] (a pair of Kings)
pipinoelbreve9: mucks hand 
swiitx collected €0.24 from pot
*** SUMMARY ***
Total pot €0.25 | Rake €0.01 
Board [Ks 8s Qh 5h Jh]
Seat 1: pipinoelbreve9 (button) mucked [Jc 9c]
Seat 2: pucelay.29 (small blind) folded before Flop
Seat 3: swiitx (big blind) showed [Kh Ts] and won (€0.24) with a pair of Kings
Seat 4: xaratax folded before Flop (didn't bet)
Seat 5: 34pluto folded before Flop (didn't bet)
Seat 6: FAUCES folded before Flop (didn't bet)



PokerStars Zoom Hand #257661176350:  Hold'em No Limit (€0.01/€0.02) - 2025/09/08 15:23:35 CET [2025/09/08 9:23:35 ET]
Table 'Arneb' 6-max Seat #1 is the button
Seat 1: MDKristian (€2.22 in chips) 
Seat 2: pipinoelbreve9 (€2.64 in chips) 
Seat 3: soyeterno (€2.54 in chips) 
Seat 4: Utusuchaz (€2.05 in chips) 
Seat 5: GamerVidal (€1.82 in chips) 
Seat 6: vclx (€2.02 in chips) 
pipinoelbreve9: posts small blind €0.01
soyeterno: posts big blind €0.02
*** HOLE CARDS ***
Dealt to pipinoelbreve9 [6c 2h]
Utusuchaz: raises €0.03 to €0.05
GamerVidal: folds 
vclx: calls €0.05
MDKristian: folds 
pipinoelbreve9: folds 
soyeterno: calls €0.03
*** FLOP *** [4h 7h 4c]
soyeterno: bets €0.08
Utusuchaz: folds 
vclx: folds 
Uncalled bet (€0.08) returned to soyeterno
soyeterno collected €0.15 from pot
soyeterno: doesn't show hand 
*** SUMMARY ***
Total pot €0.16 | Rake €0.01 
Board [4h 7h 4c]
Seat 1: MDKristian (button) folded before Flop (didn't bet)
Seat 2: pipinoelbreve9 (small blind) folded before Flop
Seat 3: soyeterno (big blind) collected (€0.15)
Seat 4: Utusuchaz folded on the Flop
Seat 5: GamerVidal folded before Flop (didn't bet)
Seat 6: vclx folded on the Flop



PokerStars Zoom Hand #257661181847:  Hold'em No Limit (€0.01/€0.02) - 2025/09/08 15:24:16 CET [2025/09/08 9:24:16 ET]
Table 'Arneb' 6-max Seat #1 is the button
Seat 1: 34pluto (€1.28 in chips) 
Seat 2: Tyrandes4pattes (€3.37 in chips) 
Seat 3: pipinoelbreve9 (€2.51 in chips) 
Seat 4: soyeterno (€2.64 in chips) 
Seat 5: swiitx (€1.80 in chips) 
Seat 6: vclx (€3.35 in chips) 
Tyrandes4pattes: posts small blind €0.01
pipinoelbreve9: posts big blind €0.02
*** HOLE CARDS ***
Dealt to pipinoelbreve9 [Jh Kd]
soyeterno: folds 
swiitx: folds 
vclx: raises €0.04 to €0.06
34pluto: folds 
Tyrandes4pattes: folds 
pipinoelbreve9: calls €0.04
*** FLOP *** [8s 5d 4s]
pipinoelbreve9: checks 
vclx: bets €0.07
pipinoelbreve9: calls €0.07
*** TURN *** [8s 5d 4s] [3d]
pipinoelbreve9: checks 
vclx: bets €0.15
pipinoelbreve9: folds 
Uncalled bet (€0.15) returned to vclx
vclx collected €0.26 from pot
vclx: doesn't show hand 
*** SUMMARY ***
Total pot €0.27 | Rake €0.01 
Board [8s 5d 4s 3d]
Seat 1: 34pluto (button) folded before Flop (didn't bet)
Seat 2: Tyrandes4pattes (small blind) folded before Flop
Seat 3: pipinoelbreve9 (big blind) folded on the Turn
Seat 4: soyeterno folded before Flop (didn't bet)
Seat 5: swiitx folded before Flop (didn't bet)
Seat 6: vclx collected (€0.26)



PokerStars Zoom Hand #257661188307:  Hold'em No Limit (€0.01/€0.02) - 2025/09/08 15:25:02 CET [2025/09/08 9:25:02 ET]
Table 'Arneb' 6-max Seat #1 is the button
Seat 1: vclx (€2 in chips) 
Seat 2: Utusuchaz (€2.01 in chips) 
Seat 3: Tyrandes4pattes (€3.39 in chips) 
Seat 4: SMN242 (€2.09 in chips) 
Seat 5: soyeterno (€2.64 in chips) 
Seat 6: pipinoelbreve9 (€2.38 in chips) 
Utusuchaz: posts small blind €0.01
Tyrandes4pattes: posts big blind €0.02
*** HOLE CARDS ***
Dealt to pipinoelbreve9 [4d Kd]
SMN242: folds 
soyeterno: folds 
pipinoelbreve9: folds 
vclx: folds 
Utusuchaz: folds 
Uncalled bet (€0.01) returned to Tyrandes4pattes
Tyrandes4pattes collected €0.02 from pot
Tyrandes4pattes: doesn't show hand 
*** SUMMARY ***
Total pot €0.02 | Rake €0 
Seat 1: vclx (button) folded before Flop (didn't bet)
Seat 2: Utusuchaz (small blind) folded before Flop
Seat 3: Tyrandes4pattes (big blind) collected (€0.02)
Seat 4: SMN242 folded before Flop (didn't bet)
Seat 5: soyeterno folded before Flop (didn't bet)
Seat 6: pipinoelbreve9 folded before Flop (didn't bet)



PokerStars Zoom Hand #257661188931:  Hold'em No Limit (€0.01/€0.02) - 2025/09/08 15:25:07 CET [2025/09/08 9:25:07 ET]
Table 'Arneb' 6-max Seat #1 is the button
Seat 1: guizzado16 (€3.87 in chips) 
Seat 2: Utusuchaz (€2.31 in chips) 
Seat 3: MDKristian (€2.14 in chips) 
Seat 4: pepetoni60 (€3.86 in chips) 
Seat 5: pipinoelbreve9 (€2.38 in chips) 
Seat 6: GamerVidal (€7.82 in chips) 
Utusuchaz: posts small blind €0.01
MDKristian: posts big blind €0.02
*** HOLE CARDS ***
Dealt to pipinoelbreve9 [5d Ks]
pepetoni60: folds 
pipinoelbreve9: folds 
GamerVidal: folds 
guizzado16: folds 
Utusuchaz: folds 
Uncalled bet (€0.01) returned to MDKristian
MDKristian collected €0.02 from pot
MDKristian: doesn't show hand 
*** SUMMARY ***
Total pot €0.02 | Rake €0 
Seat 1: guizzado16 (button) folded before Flop (didn't bet)
Seat 2: Utusuchaz (small blind) folded before Flop
Seat 3: MDKristian (big blind) collected (€0.02)
Seat 4: pepetoni60 folded before Flop (didn't bet)
Seat 5: pipinoelbreve9 folded before Flop (didn't bet)
Seat 6: GamerVidal folded before Flop (didn't bet)



PokerStars Zoom Hand #257661189557:  Hold'em No Limit (€0.01/€0.02) - 2025/09/08 15:25:11 CET [2025/09/08 9:25:11 ET]
Table 'Arneb' 6-max Seat #1 is the button
Seat 1: Utusuchaz (€2 in chips) 
Seat 2: soyeterno (€3.14 in chips) 
Seat 3: 34pluto (€1.27 in chips) 
Seat 4: pipinoelbreve9 (€2.38 in chips) 
Seat 5: Abrelatas787 (€2.73 in chips) 
Seat 6: juradopilas (€1.36 in chips) 
soyeterno: posts small blind €0.01
34pluto: posts big blind €0.02
*** HOLE CARDS ***
Dealt to pipinoelbreve9 [4h 9h]
pipinoelbreve9: folds 
Abrelatas787: folds 
juradopilas: folds 
Utusuchaz: raises €0.03 to €0.05
soyeterno: folds 
34pluto: calls €0.03
*** FLOP *** [8s Ts 8h]
34pluto: checks 
Utusuchaz: bets €0.03
34pluto: folds 
Uncalled bet (€0.03) returned to Utusuchaz
Utusuchaz collected €0.10 from pot
Utusuchaz: doesn't show hand 
*** SUMMARY ***
Total pot €0.11 | Rake €0.01 
Board [8s Ts 8h]
Seat 1: Utusuchaz (button) collected (€0.10)
Seat 2: soyeterno (small blind) folded before Flop
Seat 3: 34pluto (big blind) folded on the Flop
Seat 4: pipinoelbreve9 folded before Flop (didn't bet)
Seat 5: Abrelatas787 folded before Flop (didn't bet)
Seat 6: juradopilas folded before Flop (didn't bet)



PokerStars Zoom Hand #257661190065:  Hold'em No Limit (€0.01/€0.02) - 2025/09/08 15:25:15 CET [2025/09/08 9:25:15 ET]
Table 'Arneb' 6-max Seat #1 is the button
Seat 1: soyeterno (€2.64 in chips) 
Seat 2: pipinoelbreve9 (€2.38 in chips) 
Seat 3: NCabral_SCP (€1.63 in chips) 
Seat 4: Percu32 (€3.02 in chips) 
Seat 5: maitreyoda59 (€0.45 in chips) 
Seat 6: vclx (€2 in chips) 
pipinoelbreve9: posts small blind €0.01
NCabral_SCP: posts big blind €0.02
*** HOLE CARDS ***
Dealt to pipinoelbreve9 [Ac 3h]
Percu32: folds 
maitreyoda59: raises €0.02 to €0.04
vclx: folds 
soyeterno: folds 
pipinoelbreve9: calls €0.03
NCabral_SCP: calls €0.02
*** FLOP *** [8s Jh Td]
pipinoelbreve9: checks 
NCabral_SCP: checks 
maitreyoda59: checks 
*** TURN *** [8s Jh Td] [Qc]
pipinoelbreve9: checks 
NCabral_SCP: bets €0.11
maitreyoda59: folds 
pipinoelbreve9: folds 
Uncalled bet (€0.11) returned to NCabral_SCP
NCabral_SCP collected €0.11 from pot
NCabral_SCP: doesn't show hand 
*** SUMMARY ***
Total pot €0.12 | Rake €0.01 
Board [8s Jh Td Qc]
Seat 1: soyeterno (button) folded before Flop (didn't bet)
Seat 2: pipinoelbreve9 (small blind) folded on the Turn
Seat 3: NCabral_SCP (big blind) collected (€0.11)
Seat 4: Percu32 folded before Flop (didn't bet)
Seat 5: maitreyoda59 folded on the Turn
Seat 6: vclx folded before Flop (didn't bet)



PokerStars Zoom Hand #257661196806:  Hold'em No Limit (€0.01/€0.02) - 2025/09/08 15:26:04 CET [2025/09/08 9:26:04 ET]
Table 'Arneb' 6-max Seat #1 is the button
Seat 1: MDKristian (€2.26 in chips) 
Seat 2: maitreyoda59 (€0.41 in chips) 
Seat 3: osking118 (€1.74 in chips) 
Seat 4: pipinoelbreve9 (€2.34 in chips) 
Seat 5: SMN242 (€2.06 in chips) 
Seat 6: MichaëLR7 (€2.51 in chips) 
maitreyoda59: posts small blind €0.01
osking118: posts big blind €0.02
*** HOLE CARDS ***
Dealt to pipinoelbreve9 [8s 2d]
pipinoelbreve9: folds 
SMN242: folds 
MichaëLR7: raises €0.02 to €0.04
MDKristian: folds 
maitreyoda59: folds 
osking118: raises €0.09 to €0.13
MichaëLR7: calls €0.09
*** FLOP *** [7c Js Ac]
osking118: bets €0.26
MichaëLR7: folds 
Uncalled bet (€0.26) returned to osking118
osking118 collected €0.26 from pot
osking118: doesn't show hand 
*** SUMMARY ***
Total pot €0.27 | Rake €0.01 
Board [7c Js Ac]
Seat 1: MDKristian (button) folded before Flop (didn't bet)
Seat 2: maitreyoda59 (small blind) folded before Flop
Seat 3: osking118 (big blind) collected (€0.26)
Seat 4: pipinoelbreve9 folded before Flop (didn't bet)
Seat 5: SMN242 folded before Flop (didn't bet)
Seat 6: MichaëLR7 folded on the Flop



PokerStars Zoom Hand #257661195991:  Hold'em No Limit (€0.01/€0.02) - 2025/09/08 15:25:59 CET [2025/09/08 9:25:59 ET]
Table 'Arneb' 6-max Seat #1 is the button
Seat 1: pipinoelbreve9 (€2.34 in chips) 
Seat 2: crissstal (€1.76 in chips) 
Seat 3: 77samuel33 (€2 in chips) 
Seat 4: HDFUNRS1 (€1.55 in chips) 
Seat 5: Utusuchaz (€2.05 in chips) 
Seat 6: manolo1953 (€0.34 in chips) 
crissstal: posts small blind €0.01
77samuel33: posts big blind €0.02
*** HOLE CARDS ***
Dealt to pipinoelbreve9 [5s Th]
HDFUNRS1: folds 
Utusuchaz: folds 
manolo1953: folds 
pipinoelbreve9: folds 
crissstal: calls €0.01
77samuel33: checks 
*** FLOP *** [2d Qd 7s]
crissstal: checks 
77samuel33: checks 
*** TURN *** [2d Qd 7s] [9c]
crissstal: checks 
77samuel33: bets €0.06
crissstal: calls €0.06
*** RIVER *** [2d Qd 7s 9c] [Kh]
crissstal: checks 
77samuel33: checks 
*** SHOW DOWN ***
crissstal: shows [8d 6d] (high card King)
77samuel33: shows [9h 4c] (a pair of Nines)
77samuel33 collected €0.15 from pot
*** SUMMARY ***
Total pot €0.16 | Rake €0.01 
Board [2d Qd 7s 9c Kh]
Seat 1: pipinoelbreve9 (button) folded before Flop (didn't bet)
Seat 2: crissstal (small blind) showed [8d 6d] and lost with high card King
Seat 3: 77samuel33 (big blind) showed [9h 4c] and won (€0.15) with a pair of Nines
Seat 4: HDFUNRS1 folded before Flop (didn't bet)
Seat 5: Utusuchaz folded before Flop (didn't bet)
Seat 6: manolo1953 folded before Flop (didn't bet)



PokerStars Zoom Hand #257661197155:  Hold'em No Limit (€0.01/€0.02) - 2025/09/08 15:26:07 CET [2025/09/08 9:26:07 ET]
Table 'Arneb' 6-max Seat #1 is the button
Seat 1: Utusuchaz (€2.05 in chips) 
Seat 2: 77samuel33 (€2.05 in chips) 
Seat 3: Benedicto45 (€2.08 in chips) 
Seat 4: manolo1953 (€0.34 in chips) 
Seat 5: GamerVidal (€1.98 in chips) 
Seat 6: pipinoelbreve9 (€2.34 in chips) 
77samuel33: posts small blind €0.01
Benedicto45: posts big blind €0.02
*** HOLE CARDS ***
Dealt to pipinoelbreve9 [Qd 6c]
manolo1953: raises €0.02 to €0.04
GamerVidal: folds 
pipinoelbreve9: folds 
Utusuchaz: folds 
77samuel33: calls €0.03
Benedicto45: calls €0.02
*** FLOP *** [8s 7s Ad]
77samuel33: checks 
Benedicto45: checks 
manolo1953: bets €0.04
77samuel33: calls €0.04
Benedicto45: folds 
*** TURN *** [8s 7s Ad] [Ts]
77samuel33: checks 
manolo1953: bets €0.04
77samuel33: folds 
Uncalled bet (€0.04) returned to manolo1953
manolo1953 collected €0.19 from pot
manolo1953: doesn't show hand 
*** SUMMARY ***
Total pot €0.20 | Rake €0.01 
Board [8s 7s Ad Ts]
Seat 1: Utusuchaz (button) folded before Flop (didn't bet)
Seat 2: 77samuel33 (small blind) folded on the Turn
Seat 3: Benedicto45 (big blind) folded on the Flop
Seat 4: manolo1953 collected (€0.19)
Seat 5: GamerVidal folded before Flop (didn't bet)
Seat 6: pipinoelbreve9 folded before Flop (didn't bet)



PokerStars Zoom Hand #257661196368:  Hold'em No Limit (€0.01/€0.02) - 2025/09/08 15:26:01 CET [2025/09/08 9:26:01 ET]
Table 'Arneb' 6-max Seat #1 is the button
Seat 1: Gonzalo_PB1 (€2.77 in chips) 
Seat 2: tapirMM9 (€0.63 in chips) 
Seat 3: yunowme (€2.08 in chips) 
Seat 4: pipinoelbreve9 (€2.34 in chips) 
Seat 5: pucelay.29 (€2.43 in chips) 
Seat 6: NCabral_SCP (€1.70 in chips) 
tapirMM9: posts small blind €0.01
yunowme: posts big blind €0.02
*** HOLE CARDS ***
Dealt to pipinoelbreve9 [2c Ad]
pipinoelbreve9: folds 
pucelay.29: folds 
NCabral_SCP: folds 
Gonzalo_PB1: folds 
tapirMM9: raises €0.04 to €0.06
yunowme: calls €0.04
*** FLOP *** [6c Kh 6d]
tapirMM9: bets €0.04
yunowme: calls €0.04
*** TURN *** [6c Kh 6d] [5c]
tapirMM9: bets €0.08
yunowme: folds 
Uncalled bet (€0.08) returned to tapirMM9
tapirMM9 collected €0.19 from pot
tapirMM9: doesn't show hand 
*** SUMMARY ***
Total pot €0.20 | Rake €0.01 
Board [6c Kh 6d 5c]
Seat 1: Gonzalo_PB1 (button) folded before Flop (didn't bet)
Seat 2: tapirMM9 (small blind) collected (€0.19)
Seat 3: yunowme (big blind) folded on the Turn
Seat 4: pipinoelbreve9 folded before Flop (didn't bet)
Seat 5: pucelay.29 folded before Flop (didn't bet)
Seat 6: NCabral_SCP folded before Flop (didn't bet)



PokerStars Zoom Hand #257661201002:  Hold'em No Limit (€0.01/€0.02) - 2025/09/08 15:26:35 CET [2025/09/08 9:26:35 ET]
Table 'Arneb' 6-max Seat #1 is the button
Seat 1: 77samuel33 (€2 in chips) 
Seat 2: Ctr Alt Surp (€2.63 in chips) 
Seat 3: EiramSenpai (€1.71 in chips) 
Seat 4: pipinoelbreve9 (€2.31 in chips) 
Seat 5: guizzado16 (€3.67 in chips) 
Seat 6: pucelay.29 (€2.45 in chips) 
Ctr Alt Surp: posts small blind €0.01
EiramSenpai: posts big blind €0.02
*** HOLE CARDS ***
Dealt to pipinoelbreve9 [Tc 6s]
pipinoelbreve9: folds 
guizzado16: folds 
pucelay.29: folds 
77samuel33: raises €0.04 to €0.06
Ctr Alt Surp: folds 
EiramSenpai: calls €0.04
*** FLOP *** [Jc 5s 7d]
EiramSenpai: checks 
77samuel33: bets €0.09
EiramSenpai: folds 
Uncalled bet (€0.09) returned to 77samuel33
77samuel33 collected €0.12 from pot
77samuel33: doesn't show hand 
*** SUMMARY ***
Total pot €0.13 | Rake €0.01 
Board [Jc 5s 7d]
Seat 1: 77samuel33 (button) collected (€0.12)
Seat 2: Ctr Alt Surp (small blind) folded before Flop
Seat 3: EiramSenpai (big blind) folded on the Flop
Seat 4: pipinoelbreve9 folded before Flop (didn't bet)
Seat 5: guizzado16 folded before Flop (didn't bet)
Seat 6: pucelay.29 folded before Flop (didn't bet)



PokerStars Zoom Hand #257661201898:  Hold'em No Limit (€0.01/€0.02) - 2025/09/08 15:26:42 CET [2025/09/08 9:26:42 ET]
Table 'Arneb' 6-max Seat #1 is the button
Seat 1: pipinoelbreve9 (€2.31 in chips) 
Seat 2: HDFUNRS1 (€1.63 in chips) 
Seat 3: maitreyoda59 (€0.36 in chips) 
Seat 4: GamerVidal (€1.97 in chips) 
Seat 5: Utusuchaz (€2.35 in chips) 
Seat 6: MDKristian (€2.25 in chips) 
HDFUNRS1: posts small blind €0.01
maitreyoda59: posts big blind €0.02
*** HOLE CARDS ***
Dealt to pipinoelbreve9 [2s Kh]
GamerVidal: folds 
Utusuchaz: folds 
MDKristian: raises €0.02 to €0.04
pipinoelbreve9: folds 
HDFUNRS1: folds 
maitreyoda59: calls €0.02
*** FLOP *** [5c 5d 2d]
maitreyoda59: checks 
MDKristian: checks 
*** TURN *** [5c 5d 2d] [Js]
maitreyoda59: checks 
MDKristian: bets €0.07
maitreyoda59: folds 
Uncalled bet (€0.07) returned to MDKristian
MDKristian collected €0.09 from pot
MDKristian: doesn't show hand 
*** SUMMARY ***
Total pot €0.09 | Rake €0 
Board [5c 5d 2d Js]
Seat 1: pipinoelbreve9 (button) folded before Flop (didn't bet)
Seat 2: HDFUNRS1 (small blind) folded before Flop
Seat 3: maitreyoda59 (big blind) folded on the Turn
Seat 4: GamerVidal folded before Flop (didn't bet)
Seat 5: Utusuchaz folded before Flop (didn't bet)
Seat 6: MDKristian collected (€0.09)



PokerStars Zoom Hand #257661200530:  Hold'em No Limit (€0.01/€0.02) - 2025/09/08 15:26:31 CET [2025/09/08 9:26:31 ET]
Table 'Arneb' 6-max Seat #1 is the button
Seat 1: EiramSenpai (€1.71 in chips) 
Seat 2: pipinoelbreve9 (€2.32 in chips) 
Seat 3: Andricap (€2 in chips) 
Seat 4: Utusuchaz (€2.05 in chips) 
Seat 5: vclx (€2.03 in chips) 
Seat 6: Ctr Alt Surp (€2.63 in chips) 
pipinoelbreve9: posts small blind €0.01
Andricap: posts big blind €0.02
*** HOLE CARDS ***
Dealt to pipinoelbreve9 [6d 3s]
Utusuchaz: raises €0.03 to €0.05
vclx: folds 
Ctr Alt Surp: folds 
EiramSenpai: folds 
pipinoelbreve9: folds 
Andricap: calls €0.03
*** FLOP *** [5h 4h 9s]
Andricap: checks 
Utusuchaz: bets €0.03
Andricap: calls €0.03
*** TURN *** [5h 4h 9s] [4d]
Andricap: checks 
Utusuchaz: bets €0.08
Andricap: calls €0.08
*** RIVER *** [5h 4h 9s 4d] [4s]
Andricap: checks 
Utusuchaz: checks 
*** SHOW DOWN ***
Andricap: shows [6s 6c] (a full house, Fours full of Sixes)
Utusuchaz: mucks hand 
Andricap collected €0.31 from pot
*** SUMMARY ***
Total pot €0.33 | Rake €0.02 
Board [5h 4h 9s 4d 4s]
Seat 1: EiramSenpai (button) folded before Flop (didn't bet)
Seat 2: pipinoelbreve9 (small blind) folded before Flop
Seat 3: Andricap (big blind) showed [6s 6c] and won (€0.31) with a full house, Fours full of Sixes
Seat 4: Utusuchaz mucked [Kc 8c]
Seat 5: vclx folded before Flop (didn't bet)
Seat 6: Ctr Alt Surp folded before Flop (didn't bet)



PokerStars Zoom Hand #257661198902:  Hold'em No Limit (€0.01/€0.02) - 2025/09/08 15:26:20 CET [2025/09/08 9:26:20 ET]
Table 'Arneb' 6-max Seat #1 is the button
Seat 1: pepetoni60 (€3.79 in chips) 
Seat 2: chitigordi78 (€1.88 in chips) 
Seat 3: pipinoelbreve9 (€2.34 in chips) 
Seat 4: soyeterno (€3.08 in chips) 
Seat 5: -M-Cedric-78 (€0.31 in chips) 
Seat 6: EiramSenpai (€1.71 in chips) 
chitigordi78: posts small blind €0.01
pipinoelbreve9: posts big blind €0.02
*** HOLE CARDS ***
Dealt to pipinoelbreve9 [6c Js]
soyeterno: raises €0.04 to €0.06
-M-Cedric-78: calls €0.06
EiramSenpai: folds 
pepetoni60: folds 
chitigordi78: calls €0.05
pipinoelbreve9: folds 
*** FLOP *** [3c 8c 9d]
chitigordi78: checks 
soyeterno: bets €0.10
-M-Cedric-78: calls €0.10
chitigordi78: calls €0.10
*** TURN *** [3c 8c 9d] [7s]
chitigordi78: checks 
soyeterno: checks 
-M-Cedric-78: checks 
*** RIVER *** [3c 8c 9d 7s] [Th]
chitigordi78: checks 
soyeterno: checks 
-M-Cedric-78: bets €0.15 and is all-in
chitigordi78: folds 
soyeterno: folds 
Uncalled bet (€0.15) returned to -M-Cedric-78
-M-Cedric-78 collected €0.48 from pot
-M-Cedric-78: doesn't show hand 
*** SUMMARY ***
Total pot €0.50 | Rake €0.02 
Board [3c 8c 9d 7s Th]
Seat 1: pepetoni60 (button) folded before Flop (didn't bet)
Seat 2: chitigordi78 (small blind) folded on the River
Seat 3: pipinoelbreve9 (big blind) folded before Flop
Seat 4: soyeterno folded on the River
Seat 5: -M-Cedric-78 collected (€0.48)
Seat 6: EiramSenpai folded before Flop (didn't bet)



PokerStars Zoom Hand #257661209545:  Hold'em No Limit (€0.01/€0.02) - 2025/09/08 15:27:37 CET [2025/09/08 9:27:37 ET]
Table 'Arneb' 6-max Seat #1 is the button
Seat 1: pucelay.29 (€1.62 in chips) 
Seat 2: DarthRose (€2.05 in chips) 
Seat 3: pipinoelbreve9 (€2.25 in chips) 
Seat 4: snowstorm-C9 (€5.60 in chips) 
Seat 5: FAUCES (€2.25 in chips) 
Seat 6: pepetoni60 (€3.82 in chips) 
DarthRose: posts small blind €0.01
pipinoelbreve9: posts big blind €0.02
*** HOLE CARDS ***
Dealt to pipinoelbreve9 [6h 5s]
snowstorm-C9: raises €0.02 to €0.04
FAUCES: folds 
pepetoni60: folds 
pucelay.29: folds 
DarthRose: folds 
pipinoelbreve9: folds 
Uncalled bet (€0.02) returned to snowstorm-C9
snowstorm-C9 collected €0.05 from pot
snowstorm-C9: doesn't show hand 
*** SUMMARY ***
Total pot €0.05 | Rake €0 
Seat 1: pucelay.29 (button) folded before Flop (didn't bet)
Seat 2: DarthRose (small blind) folded before Flop
Seat 3: pipinoelbreve9 (big blind) folded before Flop
Seat 4: snowstorm-C9 collected (€0.05)
Seat 5: FAUCES folded before Flop (didn't bet)
Seat 6: pepetoni60 folded before Flop (didn't bet)



PokerStars Zoom Hand #257661202380:  Hold'em No Limit (€0.01/€0.02) - 2025/09/08 15:26:45 CET [2025/09/08 9:26:45 ET]
Table 'Arneb' 6-max Seat #1 is the button
Seat 1: osking118 (€1.87 in chips) 
Seat 2: PReGarcia (€2.01 in chips) 
Seat 3: GamerVidal (€1.97 in chips) 
Seat 4: 34pluto (€1.20 in chips) 
Seat 5: Tyrandes4pattes (€6.51 in chips) 
Seat 6: pipinoelbreve9 (€2.31 in chips) 
PReGarcia: posts small blind €0.01
GamerVidal: posts big blind €0.02
*** HOLE CARDS ***
Dealt to pipinoelbreve9 [Kc Jh]
34pluto: folds 
Tyrandes4pattes has timed out
Tyrandes4pattes: folds 
pipinoelbreve9: raises €0.04 to €0.06
osking118: calls €0.06
PReGarcia: calls €0.05
GamerVidal: folds 
*** FLOP *** [As 8c Qd]
PReGarcia: checks 
pipinoelbreve9: checks 
osking118: bets €0.14
PReGarcia: calls €0.14
pipinoelbreve9: folds 
*** TURN *** [As 8c Qd] [6s]
PReGarcia: checks 
osking118: bets €0.46
PReGarcia: calls €0.46
*** RIVER *** [As 8c Qd 6s] [6c]
PReGarcia: checks 
osking118: checks 
*** SHOW DOWN ***
PReGarcia: shows [7s 9s] (a pair of Sixes)
osking118: shows [Jc Ts] (a pair of Sixes - Ace+Queen+Jack kicker)
osking118 collected €1.33 from pot
*** SUMMARY ***
Total pot €1.40 | Rake €0.07 
Board [As 8c Qd 6s 6c]
Seat 1: osking118 (button) showed [Jc Ts] and won (€1.33) with a pair of Sixes
Seat 2: PReGarcia (small blind) showed [7s 9s] and lost with a pair of Sixes
Seat 3: GamerVidal (big blind) folded before Flop
Seat 4: 34pluto folded before Flop (didn't bet)
Seat 5: Tyrandes4pattes folded before Flop (didn't bet)
Seat 6: pipinoelbreve9 folded on the Flop



PokerStars Zoom Hand #257661212458:  Hold'em No Limit (€0.01/€0.02) - 2025/09/08 15:27:58 CET [2025/09/08 9:27:58 ET]
Table 'Arneb' 6-max Seat #1 is the button
Seat 1: MDKristian (€2.11 in chips) 
Seat 2: Zusiak (€2 in chips) 
Seat 3: maitreyoda59 (€0.31 in chips) 
Seat 4: Tyrandes4pattes (€6.17 in chips) 
Seat 5: chitigordi78 (€1.90 in chips) 
Seat 6: pipinoelbreve9 (€2.22 in chips) 
Zusiak: posts small blind €0.01
maitreyoda59: posts big blind €0.02
*** HOLE CARDS ***
Dealt to pipinoelbreve9 [6h Td]
Tyrandes4pattes: folds 
chitigordi78: raises €0.02 to €0.04
pipinoelbreve9: folds 
MDKristian: folds 
Zusiak: folds 
maitreyoda59: calls €0.02
*** FLOP *** [7s 5h 3h]
maitreyoda59: checks 
chitigordi78: bets €0.02
maitreyoda59: calls €0.02
*** TURN *** [7s 5h 3h] [2h]
maitreyoda59: checks 
chitigordi78: checks 
*** RIVER *** [7s 5h 3h 2h] [Ac]
maitreyoda59: bets €0.06
chitigordi78: calls €0.06
*** SHOW DOWN ***
maitreyoda59: shows [As 4h] (a straight, Ace to Five)
chitigordi78: shows [4s Qs] (a straight, Ace to Five)
maitreyoda59 collected €0.12 from pot
chitigordi78 collected €0.12 from pot
*** SUMMARY ***
Total pot €0.25 | Rake €0.01 
Board [7s 5h 3h 2h Ac]
Seat 1: MDKristian (button) folded before Flop (didn't bet)
Seat 2: Zusiak (small blind) folded before Flop
Seat 3: maitreyoda59 (big blind) showed [As 4h] and won (€0.12) with a straight, Ace to Five
Seat 4: Tyrandes4pattes folded before Flop (didn't bet)
Seat 5: chitigordi78 showed [4s Qs] and won (€0.12) with a straight, Ace to Five
Seat 6: pipinoelbreve9 folded before Flop (didn't bet)



PokerStars Zoom Hand #257661211396:  Hold'em No Limit (€0.01/€0.02) - 2025/09/08 15:27:51 CET [2025/09/08 9:27:51 ET]
Table 'Arneb' 6-max Seat #1 is the button
Seat 1: Popins0011 (€8.15 in chips) 
Seat 2: pipinoelbreve9 (€2.23 in chips) 
Seat 3: Tyrandes4pattes (€6.53 in chips) 
Seat 4: FAUCES (€2.25 in chips) 
Seat 5: pucelay.29 (€1.62 in chips) 
Seat 6: SMN242 (€2 in chips) 
pipinoelbreve9: posts small blind €0.01
Tyrandes4pattes: posts big blind €0.02
*** HOLE CARDS ***
Dealt to pipinoelbreve9 [9c 4h]
FAUCES: raises €0.04 to €0.06
pucelay.29: calls €0.06
SMN242: folds 
Popins0011: calls €0.06
pipinoelbreve9: folds 
Tyrandes4pattes: calls €0.04
*** FLOP *** [As 4s 8d]
Tyrandes4pattes: checks 
FAUCES: checks 
pucelay.29: bets €0.24
Popins0011: folds 
Tyrandes4pattes: folds 
FAUCES: folds 
Uncalled bet (€0.24) returned to pucelay.29
pucelay.29 collected €0.24 from pot
pucelay.29: doesn't show hand 
*** SUMMARY ***
Total pot €0.25 | Rake €0.01 
Board [As 4s 8d]
Seat 1: Popins0011 (button) folded on the Flop
Seat 2: pipinoelbreve9 (small blind) folded before Flop
Seat 3: Tyrandes4pattes (big blind) folded on the Flop
Seat 4: FAUCES folded on the Flop
Seat 5: pucelay.29 collected (€0.24)
Seat 6: SMN242 folded before Flop (didn't bet)



PokerStars Zoom Hand #257661213057:  Hold'em No Limit (€0.01/€0.02) - 2025/09/08 15:28:03 CET [2025/09/08 9:28:03 ET]
Table 'Arneb' 6-max Seat #1 is the button
Seat 1: pipinoelbreve9 (€2.22 in chips) 
Seat 2: crissstal (€1.64 in chips) 
Seat 3: lucky_rookie060 (€2.15 in chips) 
Seat 4: Tyrandes4pattes (€3.35 in chips) 
Seat 5: MDKristian (€2.09 in chips) 
Seat 6: Ctr Alt Surp (€2.87 in chips) 
crissstal: posts small blind €0.01
lucky_rookie060: posts big blind €0.02
*** HOLE CARDS ***
Dealt to pipinoelbreve9 [Qh 5h]
Tyrandes4pattes: folds 
MDKristian: raises €0.02 to €0.04
Ctr Alt Surp: folds 
pipinoelbreve9: calls €0.04
crissstal: folds 
lucky_rookie060: calls €0.02
*** FLOP *** [As Ts 8h]
lucky_rookie060: checks 
MDKristian: checks 
pipinoelbreve9: checks 
*** TURN *** [As Ts 8h] [Kc]
lucky_rookie060: checks 
MDKristian: checks 
pipinoelbreve9: checks 
*** RIVER *** [As Ts 8h Kc] [3h]
lucky_rookie060: bets €0.20
MDKristian: folds 
pipinoelbreve9: folds 
Uncalled bet (€0.20) returned to lucky_rookie060
lucky_rookie060 collected €0.12 from pot
lucky_rookie060: doesn't show hand 
*** SUMMARY ***
Total pot €0.13 | Rake €0.01 
Board [As Ts 8h Kc 3h]
Seat 1: pipinoelbreve9 (button) folded on the River
Seat 2: crissstal (small blind) folded before Flop
Seat 3: lucky_rookie060 (big blind) collected (€0.12)
Seat 4: Tyrandes4pattes folded before Flop (didn't bet)
Seat 5: MDKristian folded on the River
Seat 6: Ctr Alt Surp folded before Flop (didn't bet)



PokerStars Zoom Hand #257661219078:  Hold'em No Limit (€0.01/€0.02) - 2025/09/08 15:28:47 CET [2025/09/08 9:28:47 ET]
Table 'Arneb' 6-max Seat #1 is the button
Seat 1: GamerVidal (€7.21 in chips) 
Seat 2: Tyrandes4pattes (€6.58 in chips) 
Seat 3: 34pluto (€1.19 in chips) 
Seat 4: pucelay.29 (€4.52 in chips) 
Seat 5: pipinoelbreve9 (€2.18 in chips) 
Seat 6: soyeterno (€1.56 in chips) 
Tyrandes4pattes: posts small blind €0.01
34pluto: posts big blind €0.02
*** HOLE CARDS ***
Dealt to pipinoelbreve9 [3d 5c]
pucelay.29: folds 
pipinoelbreve9: folds 
soyeterno: folds 
GamerVidal: folds 
Tyrandes4pattes: folds 
Uncalled bet (€0.01) returned to 34pluto
34pluto collected €0.02 from pot
34pluto: doesn't show hand 
*** SUMMARY ***
Total pot €0.02 | Rake €0 
Seat 1: GamerVidal (button) folded before Flop (didn't bet)
Seat 2: Tyrandes4pattes (small blind) folded before Flop
Seat 3: 34pluto (big blind) collected (€0.02)
Seat 4: pucelay.29 folded before Flop (didn't bet)
Seat 5: pipinoelbreve9 folded before Flop (didn't bet)
Seat 6: soyeterno folded before Flop (didn't bet)



PokerStars Zoom Hand #257661219503:  Hold'em No Limit (€0.01/€0.02) - 2025/09/08 15:28:50 CET [2025/09/08 9:28:50 ET]
Table 'Arneb' 6-max Seat #1 is the button
Seat 1: manolo1953 (€0.37 in chips) 
Seat 2: crissstal (€1.64 in chips) 
Seat 3: 77samuel33 (€2 in chips) 
Seat 4: combinius1 (€2 in chips) 
Seat 5: pipinoelbreve9 (€2.18 in chips) 
Seat 6: MDKristian (€2.05 in chips) 
crissstal: posts small blind €0.01
77samuel33: posts big blind €0.02
*** HOLE CARDS ***
Dealt to pipinoelbreve9 [3s 2h]
combinius1: folds 
pipinoelbreve9: folds 
MDKristian: folds 
manolo1953: folds 
crissstal: calls €0.01
77samuel33: checks 
*** FLOP *** [5d 7s 7d]
crissstal: bets €0.02
77samuel33: raises €0.06 to €0.08
crissstal: calls €0.06
*** TURN *** [5d 7s 7d] [6h]
crissstal: checks 
77samuel33: bets €0.29
crissstal: folds 
Uncalled bet (€0.29) returned to 77samuel33
77samuel33 collected €0.19 from pot
77samuel33: doesn't show hand 
*** SUMMARY ***
Total pot €0.20 | Rake €0.01 
Board [5d 7s 7d 6h]
Seat 1: manolo1953 (button) folded before Flop (didn't bet)
Seat 2: crissstal (small blind) folded on the Turn
Seat 3: 77samuel33 (big blind) collected (€0.19)
Seat 4: combinius1 folded before Flop (didn't bet)
Seat 5: pipinoelbreve9 folded before Flop (didn't bet)
Seat 6: MDKristian folded before Flop (didn't bet)



PokerStars Zoom Hand #257661220735:  Hold'em No Limit (€0.01/€0.02) - 2025/09/08 15:28:59 CET [2025/09/08 9:28:59 ET]
Table 'Arneb' 6-max Seat #1 is the button
Seat 1: Zusiak (€2 in chips) 
Seat 2: Utusuchaz (€2.75 in chips) 
Seat 3: tapirMM9 (€2 in chips) 
Seat 4: pipinoelbreve9 (€2.18 in chips) 
Seat 5: soyeterno (€3.02 in chips) 
Seat 6: guizzado16 (€3.36 in chips) 
Utusuchaz: posts small blind €0.01
tapirMM9: posts big blind €0.02
*** HOLE CARDS ***
Dealt to pipinoelbreve9 [Ts Jh]
pipinoelbreve9: folds 
soyeterno: folds 
guizzado16: folds 
Zusiak: folds 
Utusuchaz: raises €0.04 to €0.06
tapirMM9: calls €0.04
*** FLOP *** [2s 8h 3d]
Utusuchaz: checks 
tapirMM9: checks 
*** TURN *** [2s 8h 3d] [4s]
Utusuchaz: bets €0.02
tapirMM9: calls €0.02
*** RIVER *** [2s 8h 3d 4s] [9c]
Utusuchaz: bets €0.17
tapirMM9: raises €0.17 to €0.34
Utusuchaz: calls €0.17
*** SHOW DOWN ***
tapirMM9: shows [9h Qs] (a pair of Nines)
Utusuchaz: shows [9s Qh] (a pair of Nines)
Utusuchaz collected €0.40 from pot
tapirMM9 collected €0.40 from pot
*** SUMMARY ***
Total pot €0.84 | Rake €0.04 
Board [2s 8h 3d 4s 9c]
Seat 1: Zusiak (button) folded before Flop (didn't bet)
Seat 2: Utusuchaz (small blind) showed [9s Qh] and won (€0.40) with a pair of Nines
Seat 3: tapirMM9 (big blind) showed [9h Qs] and won (€0.40) with a pair of Nines
Seat 4: pipinoelbreve9 folded before Flop (didn't bet)
Seat 5: soyeterno folded before Flop (didn't bet)
Seat 6: guizzado16 folded before Flop (didn't bet)



PokerStars Zoom Hand #257661220311:  Hold'em No Limit (€0.01/€0.02) - 2025/09/08 15:28:56 CET [2025/09/08 9:28:56 ET]
Table 'Arneb' 6-max Seat #1 is the button
Seat 1: MDKristian (€2.05 in chips) 
Seat 2: vclx (€2.02 in chips) 
Seat 3: soyeterno (€1.56 in chips) 
Seat 4: pipinoelbreve9 (€2.18 in chips) 
Seat 5: GamerVidal (€1.91 in chips) 
Seat 6: 77samuel33 (€2 in chips) 
vclx: posts small blind €0.01
soyeterno: posts big blind €0.02
*** HOLE CARDS ***
Dealt to pipinoelbreve9 [Jd 9s]
pipinoelbreve9: folds 
GamerVidal: folds 
77samuel33: folds 
MDKristian: raises €0.02 to €0.04
vclx: folds 
soyeterno: calls €0.02
*** FLOP *** [4c 7s 6h]
soyeterno: checks 
MDKristian: checks 
*** TURN *** [4c 7s 6h] [Ad]
soyeterno: checks 
MDKristian: bets €0.07
soyeterno: folds 
Uncalled bet (€0.07) returned to MDKristian
MDKristian collected €0.09 from pot
MDKristian: doesn't show hand 
*** SUMMARY ***
Total pot €0.09 | Rake €0 
Board [4c 7s 6h Ad]
Seat 1: MDKristian (button) collected (€0.09)
Seat 2: vclx (small blind) folded before Flop
Seat 3: soyeterno (big blind) folded on the Turn
Seat 4: pipinoelbreve9 folded before Flop (didn't bet)
Seat 5: GamerVidal folded before Flop (didn't bet)
Seat 6: 77samuel33 folded before Flop (didn't bet)



PokerStars Zoom Hand #257661221243:  Hold'em No Limit (€0.01/€0.02) - 2025/09/08 15:29:03 CET [2025/09/08 9:29:03 ET]
Table 'Arneb' 6-max Seat #1 is the button
Seat 1: MDKristian (€2.18 in chips) 
Seat 2: sanje35 (€1.12 in chips) 
Seat 3: pipinoelbreve9 (€2.18 in chips) 
Seat 4: MichaëLR7 (€2.11 in chips) 
Seat 5: yunowme (€2.09 in chips) 
Seat 6: Zusiak (€2 in chips) 
sanje35: posts small blind €0.01
pipinoelbreve9: posts big blind €0.02
*** HOLE CARDS ***
Dealt to pipinoelbreve9 [As Kh]
MichaëLR7: folds 
yunowme: folds 
Zusiak: folds 
MDKristian: raises €0.04 to €0.06
sanje35: folds 
pipinoelbreve9: raises €0.12 to €0.18
MDKristian: calls €0.12
*** FLOP *** [9d Ts 7d]
pipinoelbreve9: checks 
MDKristian: checks 
*** TURN *** [9d Ts 7d] [9s]
pipinoelbreve9: bets €0.16
MDKristian: folds 
Uncalled bet (€0.16) returned to pipinoelbreve9
pipinoelbreve9 collected €0.35 from pot
pipinoelbreve9: doesn't show hand 
*** SUMMARY ***
Total pot €0.37 | Rake €0.02 
Board [9d Ts 7d 9s]
Seat 1: MDKristian (button) folded on the Turn
Seat 2: sanje35 (small blind) folded before Flop
Seat 3: pipinoelbreve9 (big blind) collected (€0.35)
Seat 4: MichaëLR7 folded before Flop (didn't bet)
Seat 5: yunowme folded before Flop (didn't bet)
Seat 6: Zusiak folded before Flop (didn't bet)



PokerStars Zoom Hand #257661226559:  Hold'em No Limit (€0.01/€0.02) - 2025/09/08 15:29:42 CET [2025/09/08 9:29:42 ET]
Table 'Arneb' 6-max Seat #1 is the button
Seat 1: Andricap (€1.86 in chips) 
Seat 2: pipinoelbreve9 (€2.35 in chips) 
Seat 3: EiramSenpai (€1.98 in chips) 
Seat 4: tapirMM9 (€1.98 in chips) 
Seat 5: MDKristian (€2.09 in chips) 
Seat 6: Utusuchaz (€2.71 in chips) 
pipinoelbreve9: posts small blind €0.01
EiramSenpai: posts big blind €0.02
*** HOLE CARDS ***
Dealt to pipinoelbreve9 [5d Ts]
tapirMM9: folds 
MDKristian: raises €0.04 to €0.06
Utusuchaz: folds 
Andricap: folds 
pipinoelbreve9: folds 
EiramSenpai: folds 
Uncalled bet (€0.04) returned to MDKristian
MDKristian collected €0.05 from pot
MDKristian: doesn't show hand 
*** SUMMARY ***
Total pot €0.05 | Rake €0 
Seat 1: Andricap (button) folded before Flop (didn't bet)
Seat 2: pipinoelbreve9 (small blind) folded before Flop
Seat 3: EiramSenpai (big blind) folded before Flop
Seat 4: tapirMM9 folded before Flop (didn't bet)
Seat 5: MDKristian collected (€0.05)
Seat 6: Utusuchaz folded before Flop (didn't bet)



PokerStars Zoom Hand #257661227445:  Hold'em No Limit (€0.01/€0.02) - 2025/09/08 15:29:48 CET [2025/09/08 9:29:48 ET]
Table 'Arneb' 6-max Seat #1 is the button
Seat 1: pipinoelbreve9 (€2.34 in chips) 
Seat 2: combinius1 (€2.65 in chips) 
Seat 3: Benedicto45 (€1.98 in chips) 
Seat 4: Utusuchaz (€2.71 in chips) 
Seat 5: hotzera04 (€2 in chips) 
Seat 6: PReGarcia (€1.08 in chips) 
combinius1: posts small blind €0.01
Benedicto45: posts big blind €0.02
*** HOLE CARDS ***
Dealt to pipinoelbreve9 [8s 4h]
Utusuchaz: folds 
hotzera04: folds 
PReGarcia: folds 
pipinoelbreve9: folds 
combinius1: folds 
Uncalled bet (€0.01) returned to Benedicto45
Benedicto45 collected €0.02 from pot
Benedicto45: doesn't show hand 
*** SUMMARY ***
Total pot €0.02 | Rake €0 
Seat 1: pipinoelbreve9 (button) folded before Flop (didn't bet)
Seat 2: combinius1 (small blind) folded before Flop
Seat 3: Benedicto45 (big blind) collected (€0.02)
Seat 4: Utusuchaz folded before Flop (didn't bet)
Seat 5: hotzera04 folded before Flop (didn't bet)
Seat 6: PReGarcia folded before Flop (didn't bet)



PokerStars Zoom Hand #257661228826:  Hold'em No Limit (€0.01/€0.02) - 2025/09/08 15:29:58 CET [2025/09/08 9:29:58 ET]
Table 'Arneb' 6-max Seat #1 is the button
Seat 1: pipinoelbreve9 (€2.34 in chips) 
Seat 2: MDKristian (€2.05 in chips) 
Seat 3: hotzera04 (€2 in chips) 
Seat 4: vclx (€3.47 in chips) 
Seat 5: combinius1 (€2.64 in chips) 
Seat 6: Zusiak (€2 in chips) 
MDKristian: posts small blind €0.01
hotzera04: posts big blind €0.02
*** HOLE CARDS ***
Dealt to pipinoelbreve9 [3h 6s]
vclx: raises €0.04 to €0.06
combinius1: folds 
Zusiak: folds 
pipinoelbreve9: folds 
MDKristian: folds 
hotzera04: folds 
Uncalled bet (€0.04) returned to vclx
vclx collected €0.05 from pot
vclx: doesn't show hand 
*** SUMMARY ***
Total pot €0.05 | Rake €0 
Seat 1: pipinoelbreve9 (button) folded before Flop (didn't bet)
Seat 2: MDKristian (small blind) folded before Flop
Seat 3: hotzera04 (big blind) folded before Flop
Seat 4: vclx collected (€0.05)
Seat 5: combinius1 folded before Flop (didn't bet)
Seat 6: Zusiak folded before Flop (didn't bet)



PokerStars Zoom Hand #257661228010:  Hold'em No Limit (€0.01/€0.02) - 2025/09/08 15:29:52 CET [2025/09/08 9:29:52 ET]
Table 'Arneb' 6-max Seat #1 is the button
Seat 1: Tyrandes4pattes (€6.54 in chips) 
Seat 2: MDKristian (€2.05 in chips) 
Seat 3: Ctr Alt Surp (€2.82 in chips) 
Seat 4: Utusuchaz (€2.71 in chips) 
Seat 5: pipinoelbreve9 (€2.34 in chips) 
Seat 6: 77samuel33 (€2.11 in chips) 
MDKristian: posts small blind €0.01
Ctr Alt Surp: posts big blind €0.02
*** HOLE CARDS ***
Dealt to pipinoelbreve9 [Td 5c]
Utusuchaz: folds 
pipinoelbreve9: folds 
77samuel33: raises €0.04 to €0.06
Tyrandes4pattes: folds 
MDKristian: folds 
Ctr Alt Surp: calls €0.04
*** FLOP *** [3c 7d 7c]
Ctr Alt Surp: checks 
77samuel33: checks 
*** TURN *** [3c 7d 7c] [4d]
Ctr Alt Surp: checks 
77samuel33: bets €0.09
Ctr Alt Surp: folds 
Uncalled bet (€0.09) returned to 77samuel33
77samuel33 collected €0.12 from pot
77samuel33: doesn't show hand 
*** SUMMARY ***
Total pot €0.13 | Rake €0.01 
Board [3c 7d 7c 4d]
Seat 1: Tyrandes4pattes (button) folded before Flop (didn't bet)
Seat 2: MDKristian (small blind) folded before Flop
Seat 3: Ctr Alt Surp (big blind) folded on the Turn
Seat 4: Utusuchaz folded before Flop (didn't bet)
Seat 5: pipinoelbreve9 folded before Flop (didn't bet)
Seat 6: 77samuel33 collected (€0.12)



PokerStars Zoom Hand #257661229248:  Hold'em No Limit (€0.01/€0.02) - 2025/09/08 15:30:01 CET [2025/09/08 9:30:01 ET]
Table 'Arneb' 6-max Seat #1 is the button
Seat 1: pepetoni60 (€4.03 in chips) 
Seat 2: maitreyoda59 (€0.69 in chips) 
Seat 3: pipinoelbreve9 (€2.34 in chips) 
Seat 4: MDKristian (€2.12 in chips) 
Seat 5: Tyrandes4pattes (€6.54 in chips) 
Seat 6: tapirMM9 (€1.97 in chips) 
maitreyoda59: posts small blind €0.01
pipinoelbreve9: posts big blind €0.02
*** HOLE CARDS ***
Dealt to pipinoelbreve9 [8h As]
MDKristian: folds 
Tyrandes4pattes: folds 
tapirMM9: folds 
pepetoni60: folds 
maitreyoda59: raises €0.02 to €0.04
pipinoelbreve9: calls €0.02
*** FLOP *** [5d 7d 4s]
maitreyoda59: checks 
pipinoelbreve9: checks 
*** TURN *** [5d 7d 4s] [Jh]
maitreyoda59: bets €0.04
pipinoelbreve9: calls €0.04
*** RIVER *** [5d 7d 4s Jh] [9c]
maitreyoda59: bets €0.08
pipinoelbreve9: folds 
Uncalled bet (€0.08) returned to maitreyoda59
maitreyoda59 collected €0.15 from pot
maitreyoda59: doesn't show hand 
*** SUMMARY ***
Total pot €0.16 | Rake €0.01 
Board [5d 7d 4s Jh 9c]
Seat 1: pepetoni60 (button) folded before Flop (didn't bet)
Seat 2: maitreyoda59 (small blind) collected (€0.15)
Seat 3: pipinoelbreve9 (big blind) folded on the River
Seat 4: MDKristian folded before Flop (didn't bet)
Seat 5: Tyrandes4pattes folded before Flop (didn't bet)
Seat 6: tapirMM9 folded before Flop (didn't bet)



PokerStars Zoom Hand #257662874744:  Hold'em No Limit (€0.01/€0.02) - 2025/09/08 18:17:07 CET [2025/09/08 12:17:07 ET]
Table 'Arneb' 6-max Seat #1 is the button
Seat 1: Alexw022 (€1.56 in chips) 
Seat 2: vicen7010 (€1.06 in chips) 
Seat 3: pipinoelbreve9 (€2 in chips) 
Seat 4: candarias (€0.43 in chips) 
Seat 5: WeeDDiegO (€2.42 in chips) 
Seat 6: SMN242 (€5.78 in chips) 
vicen7010: posts small blind €0.01
pipinoelbreve9: posts big blind €0.02
*** HOLE CARDS ***
Dealt to pipinoelbreve9 [Jc 5c]
candarias: folds 
WeeDDiegO: folds 
SMN242: raises €0.03 to €0.05
Alexw022: folds 
vicen7010: folds 
pipinoelbreve9: calls €0.03
*** FLOP *** [Ac 6s Qd]
pipinoelbreve9: checks 
SMN242: bets €0.05
pipinoelbreve9: folds 
Uncalled bet (€0.05) returned to SMN242
SMN242 collected €0.10 from pot
SMN242: doesn't show hand 
*** SUMMARY ***
Total pot €0.11 | Rake €0.01 
Board [Ac 6s Qd]
Seat 1: Alexw022 (button) folded before Flop (didn't bet)
Seat 2: vicen7010 (small blind) folded before Flop
Seat 3: pipinoelbreve9 (big blind) folded on the Flop
Seat 4: candarias folded before Flop (didn't bet)
Seat 5: WeeDDiegO folded before Flop (didn't bet)
Seat 6: SMN242 collected (€0.10)



PokerStars Zoom Hand #257662880454:  Hold'em No Limit (€0.01/€0.02) - 2025/09/08 18:17:37 CET [2025/09/08 12:17:37 ET]
Table 'Arneb' 6-max Seat #1 is the button
Seat 1: Gginer2812 (€0.19 in chips) 
Seat 2: pipinoelbreve9 (€2 in chips) 
Seat 3: guizzado16 (€5.95 in chips) 
Seat 4: V1e4ra (€1.26 in chips) 
Seat 5: HGrenha (€3.30 in chips) 
Seat 6: xReshi (€2.27 in chips) 
pipinoelbreve9: posts small blind €0.01
guizzado16: posts big blind €0.02
*** HOLE CARDS ***
Dealt to pipinoelbreve9 [Ks 5h]
V1e4ra: folds 
HGrenha: raises €0.04 to €0.06
xReshi: folds 
Gginer2812: folds 
pipinoelbreve9: folds 
guizzado16: folds 
Uncalled bet (€0.04) returned to HGrenha
HGrenha collected €0.05 from pot
HGrenha: doesn't show hand 
*** SUMMARY ***
Total pot €0.05 | Rake €0 
Seat 1: Gginer2812 (button) folded before Flop (didn't bet)
Seat 2: pipinoelbreve9 (small blind) folded before Flop
Seat 3: guizzado16 (big blind) folded before Flop
Seat 4: V1e4ra folded before Flop (didn't bet)
Seat 5: HGrenha collected (€0.05)
Seat 6: xReshi folded before Flop (didn't bet)



PokerStars Zoom Hand #257662886306:  Hold'em No Limit (€0.01/€0.02) - 2025/09/08 18:18:07 CET [2025/09/08 12:18:07 ET]
Table 'Arneb' 6-max Seat #1 is the button
Seat 1: pipinoelbreve9 (€2 in chips) 
Seat 2: DavSnook (€3.98 in chips) 
Seat 3: Delvicius (€1.89 in chips) 
Seat 4: Alexw022 (€1.63 in chips) 
Seat 5: V1e4ra (€1.26 in chips) 
Seat 6: remiiiiiiii (€1.91 in chips) 
DavSnook: posts small blind €0.01
Delvicius: posts big blind €0.02
*** HOLE CARDS ***
Dealt to pipinoelbreve9 [Td 7s]
Alexw022: folds 
V1e4ra: folds 
remiiiiiiii: folds 
pipinoelbreve9: folds 
DavSnook: folds 
Uncalled bet (€0.01) returned to Delvicius
Delvicius collected €0.02 from pot
Delvicius: doesn't show hand 
*** SUMMARY ***
Total pot €0.02 | Rake €0 
Seat 1: pipinoelbreve9 (button) folded before Flop (didn't bet)
Seat 2: DavSnook (small blind) folded before Flop
Seat 3: Delvicius (big blind) collected (€0.02)
Seat 4: Alexw022 folded before Flop (didn't bet)
Seat 5: V1e4ra folded before Flop (didn't bet)
Seat 6: remiiiiiiii folded before Flop (didn't bet)



PokerStars Zoom Hand #257662886940:  Hold'em No Limit (€0.01/€0.02) - 2025/09/08 18:18:10 CET [2025/09/08 12:18:10 ET]
Table 'Arneb' 6-max Seat #1 is the button
Seat 1: Ruben1990869 (€2 in chips) 
Seat 2: xReshi (€2.27 in chips) 
Seat 3: Lucian Morel (€1.84 in chips) 
Seat 4: alexpqx (€1.54 in chips) 
Seat 5: grenha1972 (€4.60 in chips) 
Seat 6: pipinoelbreve9 (€2 in chips) 
xReshi: posts small blind €0.01
Lucian Morel: posts big blind €0.02
*** HOLE CARDS ***
Dealt to pipinoelbreve9 [2h Qs]
alexpqx: folds 
grenha1972: folds 
pipinoelbreve9: folds 
Ruben1990869: folds 
xReshi: folds 
Uncalled bet (€0.01) returned to Lucian Morel
Lucian Morel collected €0.02 from pot
Lucian Morel: doesn't show hand 
*** SUMMARY ***
Total pot €0.02 | Rake €0 
Seat 1: Ruben1990869 (button) folded before Flop (didn't bet)
Seat 2: xReshi (small blind) folded before Flop
Seat 3: Lucian Morel (big blind) collected (€0.02)
Seat 4: alexpqx folded before Flop (didn't bet)
Seat 5: grenha1972 folded before Flop (didn't bet)
Seat 6: pipinoelbreve9 folded before Flop (didn't bet)



PokerStars Zoom Hand #257662887544:  Hold'em No Limit (€0.01/€0.02) - 2025/09/08 18:18:13 CET [2025/09/08 12:18:13 ET]
Table 'Arneb' 6-max Seat #1 is the button
Seat 1: DavSnook (€7.65 in chips) 
Seat 2: HGrenha (€3.33 in chips) 
Seat 3: pipinoelbreve9 (€2 in chips) 
Seat 4: DarthRose (€2 in chips) 
Seat 5: Flavs12855 (€2.82 in chips) 
Seat 6: candarias (€0.41 in chips) 
HGrenha: posts small blind €0.01
pipinoelbreve9: posts big blind €0.02
*** HOLE CARDS ***
Dealt to pipinoelbreve9 [8c 2d]
DarthRose: folds 
Flavs12855: folds 
candarias: raises €0.04 to €0.06
DavSnook: folds 
HGrenha: folds 
pipinoelbreve9: folds 
Uncalled bet (€0.04) returned to candarias
candarias collected €0.05 from pot
candarias: doesn't show hand 
*** SUMMARY ***
Total pot €0.05 | Rake €0 
Seat 1: DavSnook (button) folded before Flop (didn't bet)
Seat 2: HGrenha (small blind) folded before Flop
Seat 3: pipinoelbreve9 (big blind) folded before Flop
Seat 4: DarthRose folded before Flop (didn't bet)
Seat 5: Flavs12855 folded before Flop (didn't bet)
Seat 6: candarias collected (€0.05)



PokerStars Zoom Hand #257662890220:  Hold'em No Limit (€0.01/€0.02) - 2025/09/08 18:18:27 CET [2025/09/08 12:18:27 ET]
Table 'Arneb' 6-max Seat #1 is the button
Seat 1: claret505 (€3 in chips) 
Seat 2: papakirrin (€1.83 in chips) 
Seat 3: iam_xCidx (€2.64 in chips) 
Seat 4: EdwarBWP (€1.51 in chips) 
Seat 5: pipinoelbreve9 (€2 in chips) 
Seat 6: alfonsoterrible (€2.86 in chips) 
papakirrin: posts small blind €0.01
iam_xCidx: posts big blind €0.02
*** HOLE CARDS ***
Dealt to pipinoelbreve9 [Tc Ac]
EdwarBWP: folds 
pipinoelbreve9: raises €0.04 to €0.06
alfonsoterrible: folds 
claret505: folds 
papakirrin: calls €0.05
iam_xCidx: folds 
*** FLOP *** [Th 9c 4d]
papakirrin: checks 
pipinoelbreve9: bets €0.07
papakirrin: calls €0.07
*** TURN *** [Th 9c 4d] [Qd]
papakirrin: checks 
pipinoelbreve9: checks 
*** RIVER *** [Th 9c 4d Qd] [2d]
papakirrin: bets €0.14
pipinoelbreve9: calls €0.14
*** SHOW DOWN ***
papakirrin: shows [2s Ts] (two pair, Tens and Deuces)
pipinoelbreve9: mucks hand 
papakirrin collected €0.53 from pot
*** SUMMARY ***
Total pot €0.56 | Rake €0.03 
Board [Th 9c 4d Qd 2d]
Seat 1: claret505 (button) folded before Flop (didn't bet)
Seat 2: papakirrin (small blind) showed [2s Ts] and won (€0.53) with two pair, Tens and Deuces
Seat 3: iam_xCidx (big blind) folded before Flop
Seat 4: EdwarBWP folded before Flop (didn't bet)
Seat 5: pipinoelbreve9 mucked [Tc Ac]
Seat 6: alfonsoterrible folded before Flop (didn't bet)



PokerStars Zoom Hand #257662895478:  Hold'em No Limit (€0.01/€0.02) - 2025/09/08 18:18:53 CET [2025/09/08 12:18:53 ET]
Table 'Arneb' 6-max Seat #1 is the button
Seat 1: Ruben1990869 (€2.02 in chips) 
Seat 2: candarias (€0.45 in chips) 
Seat 3: typh00n27 (€2.77 in chips) 
Seat 4: Diefa4466 (€2.37 in chips) 
Seat 5: Doblea315 (€3.96 in chips) 
Seat 6: pipinoelbreve9 (€2 in chips) 
candarias: posts small blind €0.01
typh00n27: posts big blind €0.02
*** HOLE CARDS ***
Dealt to pipinoelbreve9 [Jc 4s]
Diefa4466: folds 
Doblea315: folds 
pipinoelbreve9: folds 
Ruben1990869: folds 
candarias: calls €0.01
typh00n27: checks 
*** FLOP *** [Ts Ks 4d]
candarias: checks 
typh00n27: checks 
*** TURN *** [Ts Ks 4d] [8c]
candarias: checks 
typh00n27: checks 
*** RIVER *** [Ts Ks 4d 8c] [Kc]
candarias: checks 
typh00n27: bets €0.04
candarias: folds 
Uncalled bet (€0.04) returned to typh00n27
typh00n27 collected €0.04 from pot
typh00n27: doesn't show hand 
*** SUMMARY ***
Total pot €0.04 | Rake €0 
Board [Ts Ks 4d 8c Kc]
Seat 1: Ruben1990869 (button) folded before Flop (didn't bet)
Seat 2: candarias (small blind) folded on the River
Seat 3: typh00n27 (big blind) collected (€0.04)
Seat 4: Diefa4466 folded before Flop (didn't bet)
Seat 5: Doblea315 folded before Flop (didn't bet)
Seat 6: pipinoelbreve9 folded before Flop (didn't bet)



PokerStars Zoom Hand #257662896496:  Hold'em No Limit (€0.01/€0.02) - 2025/09/08 18:18:59 CET [2025/09/08 12:18:59 ET]
Table 'Arneb' 6-max Seat #1 is the button
Seat 1: pipinoelbreve9 (€2 in chips) 
Seat 2: CondeVnCount (€4.37 in chips) 
Seat 3: WeeDDiegO (€2.47 in chips) 
Seat 4: Xoseanro510 (€2.74 in chips) 
Seat 5: NICOLAS21000C (€2.53 in chips) 
Seat 6: alfonsoterrible (€2.84 in chips) 
CondeVnCount: posts small blind €0.01
WeeDDiegO: posts big blind €0.02
*** HOLE CARDS ***
Dealt to pipinoelbreve9 [Ac Qd]
Xoseanro510: folds 
NICOLAS21000C: folds 
alfonsoterrible: folds 
pipinoelbreve9: raises €0.04 to €0.06
CondeVnCount: folds 
WeeDDiegO: calls €0.04
*** FLOP *** [As 4c Ts]
WeeDDiegO: checks 
pipinoelbreve9: bets €0.06
WeeDDiegO: calls €0.06
*** TURN *** [As 4c Ts] [6s]
WeeDDiegO: checks 
pipinoelbreve9: bets €0.18
WeeDDiegO: folds 
Uncalled bet (€0.18) returned to pipinoelbreve9
pipinoelbreve9 collected €0.24 from pot
pipinoelbreve9: doesn't show hand 
*** SUMMARY ***
Total pot €0.25 | Rake €0.01 
Board [As 4c Ts 6s]
Seat 1: pipinoelbreve9 (button) collected (€0.24)
Seat 2: CondeVnCount (small blind) folded before Flop
Seat 3: WeeDDiegO (big blind) folded on the Turn
Seat 4: Xoseanro510 folded before Flop (didn't bet)
Seat 5: NICOLAS21000C folded before Flop (didn't bet)
Seat 6: alfonsoterrible folded before Flop (didn't bet)



PokerStars Zoom Hand #257662910749:  Hold'em No Limit (€0.01/€0.02) - 2025/09/08 18:20:12 CET [2025/09/08 12:20:12 ET]
Table 'Arneb' 6-max Seat #1 is the button
Seat 1: candarias (€0.73 in chips) 
Seat 2: pipinoelbreve9 (€2.12 in chips) 
Seat 3: sambimbim (€1.09 in chips) 
Seat 4: losi10 (€0.93 in chips) 
Seat 5: Pasbo311 (€2.47 in chips) 
Seat 6: typh00n27 (€2 in chips) 
pipinoelbreve9: posts small blind €0.01
sambimbim: posts big blind €0.02
*** HOLE CARDS ***
Dealt to pipinoelbreve9 [7c 7d]
losi10: folds 
Pasbo311: folds 
typh00n27: folds 
candarias: folds 
pipinoelbreve9: raises €0.04 to €0.06
sambimbim: folds 
Uncalled bet (€0.04) returned to pipinoelbreve9
pipinoelbreve9 collected €0.04 from pot
pipinoelbreve9: doesn't show hand 
*** SUMMARY ***
Total pot €0.04 | Rake €0 
Seat 1: candarias (button) folded before Flop (didn't bet)
Seat 2: pipinoelbreve9 (small blind) collected (€0.04)
Seat 3: sambimbim (big blind) folded before Flop
Seat 4: losi10 folded before Flop (didn't bet)
Seat 5: Pasbo311 folded before Flop (didn't bet)
Seat 6: typh00n27 folded before Flop (didn't bet)



PokerStars Zoom Hand #257662916155:  Hold'em No Limit (€0.01/€0.02) - 2025/09/08 18:20:40 CET [2025/09/08 12:20:40 ET]
Table 'Arneb' 6-max Seat #1 is the button
Seat 1: GamerVidal (€1.99 in chips) 
Seat 2: alexpqx (€1.48 in chips) 
Seat 3: candarias (€0.88 in chips) 
Seat 4: pipinoelbreve9 (€2.14 in chips) 
Seat 5: El portador III (€0.40 in chips) 
Seat 6: Delvicius (€1.84 in chips) 
alexpqx: posts small blind €0.01
candarias: posts big blind €0.02
*** HOLE CARDS ***
Dealt to pipinoelbreve9 [9d Jd]
pipinoelbreve9: folds 
El portador III: raises €0.38 to €0.40 and is all-in
Delvicius: folds 
GamerVidal: folds 
alexpqx: folds 
candarias: folds 
Uncalled bet (€0.38) returned to El portador III
El portador III collected €0.05 from pot
El portador III: doesn't show hand 
*** SUMMARY ***
Total pot €0.05 | Rake €0 
Seat 1: GamerVidal (button) folded before Flop (didn't bet)
Seat 2: alexpqx (small blind) folded before Flop
Seat 3: candarias (big blind) folded before Flop
Seat 4: pipinoelbreve9 folded before Flop (didn't bet)
Seat 5: El portador III collected (€0.05)
Seat 6: Delvicius folded before Flop (didn't bet)



PokerStars Zoom Hand #257662915208:  Hold'em No Limit (€0.01/€0.02) - 2025/09/08 18:20:35 CET [2025/09/08 12:20:35 ET]
Table 'Arneb' 6-max Seat #1 is the button
Seat 1: Gginer2812 (€0.13 in chips) 
Seat 2: cuenca10 (€3.12 in chips) 
Seat 3: Ibrahinpoker (€2.88 in chips) 
Seat 4: GamerVidal (€1.80 in chips) 
Seat 5: pipinoelbreve9 (€2.14 in chips) 
Seat 6: Doblea315 (€2.05 in chips) 
cuenca10: posts small blind €0.01
Ibrahinpoker: posts big blind €0.02
*** HOLE CARDS ***
Dealt to pipinoelbreve9 [3c 7h]
GamerVidal: folds 
pipinoelbreve9: folds 
Doblea315: folds 
Gginer2812: folds 
cuenca10: calls €0.01
Ibrahinpoker: checks 
*** FLOP *** [8s Qd 6d]
cuenca10: checks 
Ibrahinpoker: checks 
*** TURN *** [8s Qd 6d] [9h]
cuenca10: bets €0.06
Ibrahinpoker: calls €0.06
*** RIVER *** [8s Qd 6d 9h] [6h]
cuenca10: checks 
Ibrahinpoker: checks 
*** SHOW DOWN ***
cuenca10: shows [Jh Tc] (a straight, Eight to Queen)
Ibrahinpoker: mucks hand 
cuenca10 collected €0.15 from pot
*** SUMMARY ***
Total pot €0.16 | Rake €0.01 
Board [8s Qd 6d 9h 6h]
Seat 1: Gginer2812 (button) folded before Flop (didn't bet)
Seat 2: cuenca10 (small blind) showed [Jh Tc] and won (€0.15) with a straight, Eight to Queen
Seat 3: Ibrahinpoker (big blind) mucked [9s 7d]
Seat 4: GamerVidal folded before Flop (didn't bet)
Seat 5: pipinoelbreve9 folded before Flop (didn't bet)
Seat 6: Doblea315 folded before Flop (didn't bet)



PokerStars Zoom Hand #257662923118:  Hold'em No Limit (€0.01/€0.02) - 2025/09/08 18:21:15 CET [2025/09/08 12:21:15 ET]
Table 'Arneb' 6-max Seat #1 is the button
Seat 1: Diefa4466 (€2.21 in chips) 
Seat 2: pipinoelbreve9 (€2.12 in chips) 
Seat 3: GamerVidal (€2.02 in chips) 
Seat 4: WeeDDiegO (€2.27 in chips) 
Seat 5: remiiiiiiii (€1.91 in chips) 
Seat 6: embidoall (€1.16 in chips) 
pipinoelbreve9: posts small blind €0.01
GamerVidal: posts big blind €0.02
*** HOLE CARDS ***
Dealt to pipinoelbreve9 [Ah Jd]
WeeDDiegO: folds 
remiiiiiiii: folds 
embidoall: folds 
Diefa4466: folds 
pipinoelbreve9: raises €0.04 to €0.06
GamerVidal: folds 
Uncalled bet (€0.04) returned to pipinoelbreve9
pipinoelbreve9 collected €0.04 from pot
pipinoelbreve9: doesn't show hand 
*** SUMMARY ***
Total pot €0.04 | Rake €0 
Seat 1: Diefa4466 (button) folded before Flop (didn't bet)
Seat 2: pipinoelbreve9 (small blind) collected (€0.04)
Seat 3: GamerVidal (big blind) folded before Flop
Seat 4: WeeDDiegO folded before Flop (didn't bet)
Seat 5: remiiiiiiii folded before Flop (didn't bet)
Seat 6: embidoall folded before Flop (didn't bet)



PokerStars Zoom Hand #257662918537:  Hold'em No Limit (€0.01/€0.02) - 2025/09/08 18:20:52 CET [2025/09/08 12:20:52 ET]
Table 'Arneb' 6-max Seat #1 is the button
Seat 1: DavSnook (€3 in chips) 
Seat 2: VultosAlejandro (€2.06 in chips) 
Seat 3: pipinoelbreve9 (€2.14 in chips) 
Seat 4: alexpqx (€1.47 in chips) 
Seat 5: I dò (€2.22 in chips) 
Seat 6: Ruben1990869 (€2.14 in chips) 
VultosAlejandro: posts small blind €0.01
pipinoelbreve9: posts big blind €0.02
*** HOLE CARDS ***
Dealt to pipinoelbreve9 [5s Td]
VultosAlejandro is disconnected 
alexpqx: folds 
I dò: folds 
Ruben1990869: folds 
DavSnook: raises €0.05 to €0.07
VultosAlejandro has timed out while disconnected
VultosAlejandro: folds 
pipinoelbreve9: folds 
Uncalled bet (€0.05) returned to DavSnook
DavSnook collected €0.05 from pot
DavSnook: doesn't show hand 
*** SUMMARY ***
Total pot €0.05 | Rake €0 
Seat 1: DavSnook (button) collected (€0.05)
Seat 2: VultosAlejandro (small blind) folded before Flop
Seat 3: pipinoelbreve9 (big blind) folded before Flop
Seat 4: alexpqx folded before Flop (didn't bet)
Seat 5: I dò folded before Flop (didn't bet)
Seat 6: Ruben1990869 folded before Flop (didn't bet)



PokerStars Zoom Hand #257662922443:  Hold'em No Limit (€0.01/€0.02) - 2025/09/08 18:21:12 CET [2025/09/08 12:21:12 ET]
Table 'Arneb' 6-max Seat #1 is the button
Seat 1: pipinoelbreve9 (€2.12 in chips) 
Seat 2: embidoall (€1.17 in chips) 
Seat 3: Xoseanro510 (€2.50 in chips) 
Seat 4: V1e4ra (€1.31 in chips) 
Seat 5: Ibrahinpoker (€2.80 in chips) 
Seat 6: CondeVnCount (€5.48 in chips) 
embidoall: posts small blind €0.01
Xoseanro510: posts big blind €0.02
*** HOLE CARDS ***
Dealt to pipinoelbreve9 [2s 6s]
V1e4ra: folds 
Ibrahinpoker: folds 
CondeVnCount: raises €0.04 to €0.06
pipinoelbreve9: folds 
embidoall: folds 
Xoseanro510: folds 
Uncalled bet (€0.04) returned to CondeVnCount
CondeVnCount collected €0.05 from pot
CondeVnCount: doesn't show hand 
*** SUMMARY ***
Total pot €0.05 | Rake €0 
Seat 1: pipinoelbreve9 (button) folded before Flop (didn't bet)
Seat 2: embidoall (small blind) folded before Flop
Seat 3: Xoseanro510 (big blind) folded before Flop
Seat 4: V1e4ra folded before Flop (didn't bet)
Seat 5: Ibrahinpoker folded before Flop (didn't bet)
Seat 6: CondeVnCount collected (€0.05)



PokerStars Zoom Hand #257662917713:  Hold'em No Limit (€0.01/€0.02) - 2025/09/08 18:20:48 CET [2025/09/08 12:20:48 ET]
Table 'Arneb' 6-max Seat #1 is the button
Seat 1: ñlkjh33 (€1.99 in chips) 
Seat 2: d4rkr3b1c (€0.83 in chips) 
Seat 3: alfonsoterrible (€3.50 in chips) 
Seat 4: pipinoelbreve9 (€2.14 in chips) 
Seat 5: candarias (€0.36 in chips) 
Seat 6: DarthRose (€2.06 in chips) 
d4rkr3b1c: posts small blind €0.01
alfonsoterrible: posts big blind €0.02
*** HOLE CARDS ***
Dealt to pipinoelbreve9 [Ah 3d]
pipinoelbreve9: folds 
candarias: folds 
DarthRose: folds 
ñlkjh33: raises €0.02 to €0.04
d4rkr3b1c: folds 
alfonsoterrible: calls €0.02
*** FLOP *** [Qd 2s Kc]
alfonsoterrible: checks 
ñlkjh33: checks 
*** TURN *** [Qd 2s Kc] [5s]
alfonsoterrible: checks 
ñlkjh33: checks 
*** RIVER *** [Qd 2s Kc 5s] [Jc]
alfonsoterrible: checks 
ñlkjh33: bets €0.09
alfonsoterrible: folds 
Uncalled bet (€0.09) returned to ñlkjh33
ñlkjh33 collected €0.09 from pot
ñlkjh33: doesn't show hand 
*** SUMMARY ***
Total pot €0.09 | Rake €0 
Board [Qd 2s Kc 5s Jc]
Seat 1: ñlkjh33 (button) collected (€0.09)
Seat 2: d4rkr3b1c (small blind) folded before Flop
Seat 3: alfonsoterrible (big blind) folded on the River
Seat 4: pipinoelbreve9 folded before Flop (didn't bet)
Seat 5: candarias folded before Flop (didn't bet)
Seat 6: DarthRose folded before Flop (didn't bet)



PokerStars Zoom Hand #257662925133:  Hold'em No Limit (€0.01/€0.02) - 2025/09/08 18:21:26 CET [2025/09/08 12:21:26 ET]
Table 'Arneb' 6-max Seat #1 is the button
Seat 1: alexiscubill (€2.78 in chips) 
Seat 2: Andricap (€2.10 in chips) 
Seat 3: V1e4ra (€2.53 in chips) 
Seat 4: GamerVidal (€2 in chips) 
Seat 5: yosii11 (€2 in chips) 
Seat 6: pipinoelbreve9 (€2.14 in chips) 
Andricap: posts small blind €0.01
V1e4ra: posts big blind €0.02
*** HOLE CARDS ***
Dealt to pipinoelbreve9 [Qc 4c]
GamerVidal: folds 
yosii11: raises €0.04 to €0.06
pipinoelbreve9: folds 
alexiscubill: folds 
Andricap: folds 
V1e4ra: folds 
Uncalled bet (€0.04) returned to yosii11
yosii11 collected €0.05 from pot
yosii11: doesn't show hand 
*** SUMMARY ***
Total pot €0.05 | Rake €0 
Seat 1: alexiscubill (button) folded before Flop (didn't bet)
Seat 2: Andricap (small blind) folded before Flop
Seat 3: V1e4ra (big blind) folded before Flop
Seat 4: GamerVidal folded before Flop (didn't bet)
Seat 5: yosii11 collected (€0.05)
Seat 6: pipinoelbreve9 folded before Flop (didn't bet)



PokerStars Zoom Hand #257662929429:  Hold'em No Limit (€0.01/€0.02) - 2025/09/08 18:21:48 CET [2025/09/08 12:21:48 ET]
Table 'Arneb' 6-max Seat #1 is the button
Seat 1: papakirrin (€2.72 in chips) 
Seat 2: alfonsoterrible (€2.96 in chips) 
Seat 3: pipinoelbreve9 (€2.08 in chips) 
Seat 4: vivilivrevivi26 (€2.44 in chips) 
Seat 5: remiiiiiiii (€1.89 in chips) 
Seat 6: Andricap (€1.97 in chips) 
alfonsoterrible: posts small blind €0.01
pipinoelbreve9: posts big blind €0.02
*** HOLE CARDS ***
Dealt to pipinoelbreve9 [8h Tc]
vivilivrevivi26: folds 
remiiiiiiii: calls €0.02
Andricap: folds 
papakirrin: folds 
alfonsoterrible: folds 
pipinoelbreve9: checks 
*** FLOP *** [8d 4s 2s]
pipinoelbreve9: bets €0.05
remiiiiiiii: folds 
Uncalled bet (€0.05) returned to pipinoelbreve9
pipinoelbreve9 collected €0.05 from pot
pipinoelbreve9: doesn't show hand 
*** SUMMARY ***
Total pot €0.05 | Rake €0 
Board [8d 4s 2s]
Seat 1: papakirrin (button) folded before Flop (didn't bet)
Seat 2: alfonsoterrible (small blind) folded before Flop
Seat 3: pipinoelbreve9 (big blind) collected (€0.05)
Seat 4: vivilivrevivi26 folded before Flop (didn't bet)
Seat 5: remiiiiiiii folded on the Flop
Seat 6: Andricap folded before Flop (didn't bet)



PokerStars Zoom Hand #257662933985:  Hold'em No Limit (€0.01/€0.02) - 2025/09/08 18:22:11 CET [2025/09/08 12:22:11 ET]
Table 'Arneb' 6-max Seat #1 is the button
Seat 1: candarias (€0.72 in chips) 
Seat 2: pipinoelbreve9 (€2.11 in chips) 
Seat 3: easywithnuts84 (€2.19 in chips) 
Seat 4: GamerVidal (€1.99 in chips) 
Seat 5: vicen7010 (€2.79 in chips) 
Seat 6: bluffynuts (€1 in chips) 
pipinoelbreve9: posts small blind €0.01
easywithnuts84: posts big blind €0.02
*** HOLE CARDS ***
Dealt to pipinoelbreve9 [7c 4h]
GamerVidal: folds 
vicen7010: folds 
bluffynuts: folds 
candarias: calls €0.02
pipinoelbreve9: folds 
easywithnuts84: raises €0.07 to €0.09
candarias: folds 
Uncalled bet (€0.07) returned to easywithnuts84
easywithnuts84 collected €0.05 from pot
easywithnuts84: doesn't show hand 
*** SUMMARY ***
Total pot €0.05 | Rake €0 
Seat 1: candarias (button) folded before Flop
Seat 2: pipinoelbreve9 (small blind) folded before Flop
Seat 3: easywithnuts84 (big blind) collected (€0.05)
Seat 4: GamerVidal folded before Flop (didn't bet)
Seat 5: vicen7010 folded before Flop (didn't bet)
Seat 6: bluffynuts folded before Flop (didn't bet)



PokerStars Zoom Hand #257662926097:  Hold'em No Limit (€0.01/€0.02) - 2025/09/08 18:21:31 CET [2025/09/08 12:21:31 ET]
Table 'Arneb' 6-max Seat #1 is the button
Seat 1: Ruben1990869 (€2.36 in chips) 
Seat 2: Doblea315 (€2.14 in chips) 
Seat 3: 34pluto (€2.15 in chips) 
Seat 4: WeeDDiegO (€3.55 in chips) 
Seat 5: pipinoelbreve9 (€2.14 in chips) 
Seat 6: iam_xCidx (€2.33 in chips) 
Doblea315: posts small blind €0.01
34pluto: posts big blind €0.02
*** HOLE CARDS ***
Dealt to pipinoelbreve9 [6d 6s]
WeeDDiegO: folds 
pipinoelbreve9: raises €0.04 to €0.06
iam_xCidx: raises €0.18 to €0.24
Ruben1990869: folds 
Doblea315: calls €0.23
34pluto: folds 
pipinoelbreve9: folds 
*** FLOP *** [Qd Th 4d]
Doblea315: checks 
iam_xCidx: checks 
*** TURN *** [Qd Th 4d] [8d]
Doblea315: checks 
iam_xCidx: checks 
*** RIVER *** [Qd Th 4d 8d] [7c]
Doblea315: checks 
iam_xCidx: checks 
*** SHOW DOWN ***
Doblea315: shows [Jd Jc] (a pair of Jacks)
iam_xCidx: mucks hand 
Doblea315 collected €0.53 from pot
*** SUMMARY ***
Total pot €0.56 | Rake €0.03 
Board [Qd Th 4d 8d 7c]
Seat 1: Ruben1990869 (button) folded before Flop (didn't bet)
Seat 2: Doblea315 (small blind) showed [Jd Jc] and won (€0.53) with a pair of Jacks
Seat 3: 34pluto (big blind) folded before Flop
Seat 4: WeeDDiegO folded before Flop (didn't bet)
Seat 5: pipinoelbreve9 folded before Flop
Seat 6: iam_xCidx mucked [2c Ac]



PokerStars Zoom Hand #257662934694:  Hold'em No Limit (€0.01/€0.02) - 2025/09/08 18:22:15 CET [2025/09/08 12:22:15 ET]
Table 'Arneb' 6-max Seat #1 is the button
Seat 1: pipinoelbreve9 (€2.10 in chips) 
Seat 2: 34pluto (€2.13 in chips) 
Seat 3: rccmonteiro27 (€2 in chips) 
Seat 4: alfonsoterrible (€3.45 in chips) 
Seat 5: black_dad23 (€1.35 in chips) 
Seat 6: alexpqx (€1.53 in chips) 
34pluto: posts small blind €0.01
rccmonteiro27: posts big blind €0.02
*** HOLE CARDS ***
Dealt to pipinoelbreve9 [6c Jh]
alfonsoterrible: folds 
black_dad23: folds 
alexpqx is disconnected 
alexpqx has timed out while disconnected
alexpqx: folds 
pipinoelbreve9: folds 
34pluto: folds 
Uncalled bet (€0.01) returned to rccmonteiro27
rccmonteiro27 collected €0.02 from pot
rccmonteiro27: doesn't show hand 
*** SUMMARY ***
Total pot €0.02 | Rake €0 
Seat 1: pipinoelbreve9 (button) folded before Flop (didn't bet)
Seat 2: 34pluto (small blind) folded before Flop
Seat 3: rccmonteiro27 (big blind) collected (€0.02)
Seat 4: alfonsoterrible folded before Flop (didn't bet)
Seat 5: black_dad23 folded before Flop (didn't bet)
Seat 6: alexpqx folded before Flop (didn't bet)



PokerStars Zoom Hand #257662935497:  Hold'em No Limit (€0.01/€0.02) - 2025/09/08 18:22:20 CET [2025/09/08 12:22:20 ET]
Table 'Arneb' 6-max Seat #1 is the button
Seat 1: 33baba33 (€1.87 in chips) 
Seat 2: black_dad23 (€1.35 in chips) 
Seat 3: GamerVidal (€1.99 in chips) 
Seat 4: pipinoelbreve9 (€2.10 in chips) 
Seat 5: d4rkr3b1c (€0.78 in chips) 
Seat 6: Ruben1990869 (€2.08 in chips) 
black_dad23: posts small blind €0.01
GamerVidal: posts big blind €0.02
*** HOLE CARDS ***
Dealt to pipinoelbreve9 [Th Jh]
pipinoelbreve9: raises €0.04 to €0.06
d4rkr3b1c: folds 
Ruben1990869: folds 
33baba33: calls €0.06
black_dad23: folds 
GamerVidal: folds 
*** FLOP *** [Td 6h 4c]
pipinoelbreve9: bets €0.07
33baba33: calls €0.07
*** TURN *** [Td 6h 4c] [5s]
pipinoelbreve9: checks 
33baba33: checks 
*** RIVER *** [Td 6h 4c 5s] [9s]
pipinoelbreve9: bets €0.14
33baba33: calls €0.14
*** SHOW DOWN ***
pipinoelbreve9: shows [Th Jh] (a pair of Tens)
33baba33: mucks hand 
pipinoelbreve9 collected €0.54 from pot
*** SUMMARY ***
Total pot €0.57 | Rake €0.03 
Board [Td 6h 4c 5s 9s]
Seat 1: 33baba33 (button) mucked [7h 5h]
Seat 2: black_dad23 (small blind) folded before Flop
Seat 3: GamerVidal (big blind) folded before Flop
Seat 4: pipinoelbreve9 showed [Th Jh] and won (€0.54) with a pair of Tens
Seat 5: d4rkr3b1c folded before Flop (didn't bet)
Seat 6: Ruben1990869 folded before Flop (didn't bet)



PokerStars Zoom Hand #257662948883:  Hold'em No Limit (€0.01/€0.02) - 2025/09/08 18:23:28 CET [2025/09/08 12:23:28 ET]
Table 'Arneb' 6-max Seat #1 is the button
Seat 1: alexpqx (€2.97 in chips) 
Seat 2: bailaor_avg (€0.47 in chips) 
Seat 3: iam_xCidx (€2.09 in chips) 
Seat 4: pipinoelbreve9 (€2.37 in chips) 
Seat 5: I dò (€2.02 in chips) 
Seat 6: BestiaESP12 (€2 in chips) 
bailaor_avg: posts small blind €0.01
iam_xCidx: posts big blind €0.02
*** HOLE CARDS ***
Dealt to pipinoelbreve9 [7h 5c]
pipinoelbreve9: folds 
I dò: folds 
BestiaESP12: folds 
alexpqx: folds 
bailaor_avg: raises €0.04 to €0.06
iam_xCidx: folds 
Uncalled bet (€0.04) returned to bailaor_avg
bailaor_avg collected €0.04 from pot
bailaor_avg: doesn't show hand 
*** SUMMARY ***
Total pot €0.04 | Rake €0 
Seat 1: alexpqx (button) folded before Flop (didn't bet)
Seat 2: bailaor_avg (small blind) collected (€0.04)
Seat 3: iam_xCidx (big blind) folded before Flop
Seat 4: pipinoelbreve9 folded before Flop (didn't bet)
Seat 5: I dò folded before Flop (didn't bet)
Seat 6: BestiaESP12 folded before Flop (didn't bet)



PokerStars Zoom Hand #257662949927:  Hold'em No Limit (€0.01/€0.02) - 2025/09/08 18:23:33 CET [2025/09/08 12:23:33 ET]
Table 'Arneb' 6-max Seat #1 is the button
Seat 1: urkel77 (€2 in chips) 
Seat 2: xhadd (€7.82 in chips) 
Seat 3: pipinoelbreve9 (€2.37 in chips) 
Seat 4: 34pluto (€1.90 in chips) 
Seat 5: BestiaESP12 (€2 in chips) 
Seat 6: Xoseanro510 (€3.72 in chips) 
xhadd: posts small blind €0.01
pipinoelbreve9: posts big blind €0.02
*** HOLE CARDS ***
Dealt to pipinoelbreve9 [Kc 5h]
34pluto has timed out while disconnected
34pluto: folds 
BestiaESP12: raises €0.03 to €0.05
Xoseanro510: folds 
urkel77: folds 
xhadd: folds 
pipinoelbreve9: folds 
Uncalled bet (€0.03) returned to BestiaESP12
BestiaESP12 collected €0.05 from pot
BestiaESP12: doesn't show hand 
*** SUMMARY ***
Total pot €0.05 | Rake €0 
Seat 1: urkel77 (button) folded before Flop (didn't bet)
Seat 2: xhadd (small blind) folded before Flop
Seat 3: pipinoelbreve9 (big blind) folded before Flop
Seat 4: 34pluto folded before Flop (didn't bet)
Seat 5: BestiaESP12 collected (€0.05)
Seat 6: Xoseanro510 folded before Flop (didn't bet)



PokerStars Zoom Hand #257662952537:  Hold'em No Limit (€0.01/€0.02) - 2025/09/08 18:23:46 CET [2025/09/08 12:23:46 ET]
Table 'Arneb' 6-max Seat #1 is the button
Seat 1: bailaor_avg (€0.49 in chips) 
Seat 2: Doblea315 (€2.41 in chips) 
Seat 3: claret505 (€2.70 in chips) 
Seat 4: DavSnook (€4.87 in chips) 
Seat 5: pipinoelbreve9 (€2.35 in chips) 
Seat 6: embidoall (€1.97 in chips) 
Doblea315: posts small blind €0.01
claret505: posts big blind €0.02
*** HOLE CARDS ***
Dealt to pipinoelbreve9 [9d 6c]
DavSnook: folds 
pipinoelbreve9: folds 
embidoall: folds 
bailaor_avg: folds 
Doblea315: folds 
Uncalled bet (€0.01) returned to claret505
claret505 collected €0.02 from pot
claret505: doesn't show hand 
*** SUMMARY ***
Total pot €0.02 | Rake €0 
Seat 1: bailaor_avg (button) folded before Flop (didn't bet)
Seat 2: Doblea315 (small blind) folded before Flop
Seat 3: claret505 (big blind) collected (€0.02)
Seat 4: DavSnook folded before Flop (didn't bet)
Seat 5: pipinoelbreve9 folded before Flop (didn't bet)
Seat 6: embidoall folded before Flop (didn't bet)



PokerStars Zoom Hand #257662953461:  Hold'em No Limit (€0.01/€0.02) - 2025/09/08 18:23:51 CET [2025/09/08 12:23:51 ET]
Table 'Arneb' 6-max Seat #1 is the button
Seat 1: iam_xCidx (€2.06 in chips) 
Seat 2: pipinoelbreve9 (€2.35 in chips) 
Seat 3: CondeVnCount (€2.66 in chips) 
Seat 4: vicen7010 (€2.30 in chips) 
Seat 5: El portador III (€0.70 in chips) 
Seat 6: Flavs12855 (€3.45 in chips) 
pipinoelbreve9: posts small blind €0.01
CondeVnCount: posts big blind €0.02
*** HOLE CARDS ***
Dealt to pipinoelbreve9 [4d 7s]
vicen7010: folds 
El portador III: folds 
Flavs12855: raises €0.03 to €0.05
iam_xCidx: folds 
pipinoelbreve9: folds 
CondeVnCount: folds 
Uncalled bet (€0.03) returned to Flavs12855
Flavs12855 collected €0.05 from pot
Flavs12855: doesn't show hand 
*** SUMMARY ***
Total pot €0.05 | Rake €0 
Seat 1: iam_xCidx (button) folded before Flop (didn't bet)
Seat 2: pipinoelbreve9 (small blind) folded before Flop
Seat 3: CondeVnCount (big blind) folded before Flop
Seat 4: vicen7010 folded before Flop (didn't bet)
Seat 5: El portador III folded before Flop (didn't bet)
Seat 6: Flavs12855 collected (€0.05)



PokerStars Zoom Hand #257662954338:  Hold'em No Limit (€0.01/€0.02) - 2025/09/08 18:23:55 CET [2025/09/08 12:23:55 ET]
Table 'Arneb' 6-max Seat #1 is the button
Seat 1: vicen7010 (€2.30 in chips) 
Seat 2: El portador III (€0.70 in chips) 
Seat 3: embidoall (€1.96 in chips) 
Seat 4: bailaor_avg (€0.49 in chips) 
Seat 5: candarias (€0.83 in chips) 
Seat 6: pipinoelbreve9 (€2.34 in chips) 
El portador III: posts small blind €0.01
embidoall: posts big blind €0.02
*** HOLE CARDS ***
Dealt to pipinoelbreve9 [8h 5d]
bailaor_avg: raises €0.05 to €0.07
candarias: folds 
pipinoelbreve9: folds 
vicen7010: folds 
El portador III: folds 
embidoall: calls €0.05
*** FLOP *** [9c 8d 6c]
embidoall: checks 
bailaor_avg: bets €0.14
embidoall: folds 
Uncalled bet (€0.14) returned to bailaor_avg
bailaor_avg collected €0.14 from pot
bailaor_avg: doesn't show hand 
*** SUMMARY ***
Total pot €0.15 | Rake €0.01 
Board [9c 8d 6c]
Seat 1: vicen7010 (button) folded before Flop (didn't bet)
Seat 2: El portador III (small blind) folded before Flop
Seat 3: embidoall (big blind) folded on the Flop
Seat 4: bailaor_avg collected (€0.14)
Seat 5: candarias folded before Flop (didn't bet)
Seat 6: pipinoelbreve9 folded before Flop (didn't bet)



PokerStars Zoom Hand #257662947909:  Hold'em No Limit (€0.01/€0.02) - 2025/09/08 18:23:22 CET [2025/09/08 12:23:22 ET]
Table 'Arneb' 6-max Seat #1 is the button
Seat 1: BestiaESP12 (€2 in chips) 
Seat 2: yunblvck (€3.54 in chips) 
Seat 3: Ibrahinpoker (€2.83 in chips) 
Seat 4: GRIFFIN168 (€2.50 in chips) 
Seat 5: vivilivrevivi26 (€2.32 in chips) 
Seat 6: pipinoelbreve9 (€2.37 in chips) 
yunblvck: posts small blind €0.01
Ibrahinpoker: posts big blind €0.02
*** HOLE CARDS ***
Dealt to pipinoelbreve9 [2c Qs]
GRIFFIN168: folds 
vivilivrevivi26: calls €0.02
pipinoelbreve9: folds 
BestiaESP12: folds 
yunblvck: raises €0.08 to €0.10
Ibrahinpoker: calls €0.08
vivilivrevivi26: calls €0.08
*** FLOP *** [6d Td 4d]
yunblvck: bets €0.22
Ibrahinpoker: folds 
vivilivrevivi26: calls €0.22
*** TURN *** [6d Td 4d] [Ts]
yunblvck: bets €0.22
vivilivrevivi26: calls €0.22
*** RIVER *** [6d Td 4d Ts] [Js]
yunblvck: checks 
vivilivrevivi26: checks 
*** SHOW DOWN ***
yunblvck: shows [9d 7d] (a flush, Ten high)
vivilivrevivi26: mucks hand 
yunblvck collected €1.12 from pot
*** SUMMARY ***
Total pot €1.18 | Rake €0.06 
Board [6d Td 4d Ts Js]
Seat 1: BestiaESP12 (button) folded before Flop (didn't bet)
Seat 2: yunblvck (small blind) showed [9d 7d] and won (€1.12) with a flush, Ten high
Seat 3: Ibrahinpoker (big blind) folded on the Flop
Seat 4: GRIFFIN168 folded before Flop (didn't bet)
Seat 5: vivilivrevivi26 mucked [Ad Ah]
Seat 6: pipinoelbreve9 folded before Flop (didn't bet)



PokerStars Zoom Hand #257662955016:  Hold'em No Limit (€0.01/€0.02) - 2025/09/08 18:23:59 CET [2025/09/08 12:23:59 ET]
Table 'Arneb' 6-max Seat #1 is the button
Seat 1: pipinoelbreve9 (€2.34 in chips) 
Seat 2: typh00n27 (€2.31 in chips) 
Seat 3: urkel77 (€2.34 in chips) 
Seat 4: 33baba33 (€1.65 in chips) 
Seat 5: alexpqx (€1.44 in chips) 
Seat 6: hobbyt1969 (€2.86 in chips) 
typh00n27: posts small blind €0.01
urkel77: posts big blind €0.02
*** HOLE CARDS ***
Dealt to pipinoelbreve9 [As Th]
33baba33: folds 
alexpqx: raises €0.05 to €0.07
hobbyt1969: folds 
pipinoelbreve9: raises €0.05 to €0.12
typh00n27: folds 
urkel77: folds 
alexpqx: calls €0.05
*** FLOP *** [7c 7s 6s]
alexpqx: checks 
pipinoelbreve9: checks 
*** TURN *** [7c 7s 6s] [8d]
alexpqx: bets €0.18
pipinoelbreve9: calls €0.18
*** RIVER *** [7c 7s 6s 8d] [Js]
alexpqx: checks 
pipinoelbreve9: checks 
*** SHOW DOWN ***
alexpqx: shows [Ts Tc] (two pair, Tens and Sevens)
pipinoelbreve9: mucks hand 
alexpqx collected €0.60 from pot
*** SUMMARY ***
Total pot €0.63 | Rake €0.03 
Board [7c 7s 6s 8d Js]
Seat 1: pipinoelbreve9 (button) mucked [As Th]
Seat 2: typh00n27 (small blind) folded before Flop
Seat 3: urkel77 (big blind) folded before Flop
Seat 4: 33baba33 folded before Flop (didn't bet)
Seat 5: alexpqx showed [Ts Tc] and won (€0.60) with two pair, Tens and Sevens
Seat 6: hobbyt1969 folded before Flop (didn't bet)



PokerStars Zoom Hand #257662968936:  Hold'em No Limit (€0.01/€0.02) - 2025/09/08 18:25:09 CET [2025/09/08 12:25:09 ET]
Table 'Arneb' 6-max Seat #1 is the button
Seat 1: alexpqx (€1.74 in chips) 
Seat 2: Xoseanro510 (€2 in chips) 
Seat 3: ñlkjh33 (€1.33 in chips) 
Seat 4: El portador III (€0.69 in chips) 
Seat 5: pipinoelbreve9 (€2.04 in chips) 
Seat 6: vicen7010 (€2.28 in chips) 
Xoseanro510: posts small blind €0.01
ñlkjh33: posts big blind €0.02
*** HOLE CARDS ***
Dealt to pipinoelbreve9 [Jd As]
El portador III: folds 
pipinoelbreve9: raises €0.04 to €0.06
vicen7010: folds 
alexpqx: raises €0.15 to €0.21
Xoseanro510: folds 
ñlkjh33: folds 
pipinoelbreve9: calls €0.15
*** FLOP *** [4s 5s 8h]
pipinoelbreve9: checks 
alexpqx: bets €0.30
pipinoelbreve9: folds 
Uncalled bet (€0.30) returned to alexpqx
alexpqx collected €0.43 from pot
alexpqx: doesn't show hand 
*** SUMMARY ***
Total pot €0.45 | Rake €0.02 
Board [4s 5s 8h]
Seat 1: alexpqx (button) collected (€0.43)
Seat 2: Xoseanro510 (small blind) folded before Flop
Seat 3: ñlkjh33 (big blind) folded before Flop
Seat 4: El portador III folded before Flop (didn't bet)
Seat 5: pipinoelbreve9 folded on the Flop
Seat 6: vicen7010 folded before Flop (didn't bet)



PokerStars Zoom Hand #257662975987:  Hold'em No Limit (€0.01/€0.02) - 2025/09/08 18:25:45 CET [2025/09/08 12:25:45 ET]
Table 'Arneb' 6-max Seat #1 is the button
Seat 1: ñlkjh33 (€1.30 in chips) 
Seat 2: hsilva1621 (€2.35 in chips) 
Seat 3: Doblea315 (€2.48 in chips) 
Seat 4: pipinoelbreve9 (€2 in chips) 
Seat 5: bluffynuts (€0.93 in chips) 
Seat 6: Ruben1990869 (€2 in chips) 
hsilva1621: posts small blind €0.01
Doblea315: posts big blind €0.02
*** HOLE CARDS ***
Dealt to pipinoelbreve9 [Ah Qc]
pipinoelbreve9: raises €0.04 to €0.06
bluffynuts: folds 
Ruben1990869: folds 
ñlkjh33: folds 
hsilva1621: calls €0.05
Doblea315: folds 
*** FLOP *** [Qs Th Qh]
hsilva1621: checks 
pipinoelbreve9: bets €0.05
hsilva1621: folds 
Uncalled bet (€0.05) returned to pipinoelbreve9
pipinoelbreve9 collected €0.13 from pot
pipinoelbreve9: doesn't show hand 
*** SUMMARY ***
Total pot €0.14 | Rake €0.01 
Board [Qs Th Qh]
Seat 1: ñlkjh33 (button) folded before Flop (didn't bet)
Seat 2: hsilva1621 (small blind) folded on the Flop
Seat 3: Doblea315 (big blind) folded before Flop
Seat 4: pipinoelbreve9 collected (€0.13)
Seat 5: bluffynuts folded before Flop (didn't bet)
Seat 6: Ruben1990869 folded before Flop (didn't bet)



PokerStars Zoom Hand #257662980456:  Hold'em No Limit (€0.01/€0.02) - 2025/09/08 18:26:08 CET [2025/09/08 12:26:08 ET]
Table 'Arneb' 6-max Seat #1 is the button
Seat 1: pipinoelbreve9 (€2.07 in chips) 
Seat 2: JAQKKK (€2.12 in chips) 
Seat 3: CondeVnCount (€2.54 in chips) 
Seat 4: black_dad23 (€1.42 in chips) 
Seat 5: hsilva1621 (€2.29 in chips) 
Seat 6: alexpqx (€3.27 in chips) 
JAQKKK: posts small blind €0.01
CondeVnCount: posts big blind €0.02
*** HOLE CARDS ***
Dealt to pipinoelbreve9 [8d 8c]
black_dad23: raises €0.02 to €0.04
hsilva1621: calls €0.04
alexpqx: folds 
pipinoelbreve9: raises €0.06 to €0.10
JAQKKK: folds 
CondeVnCount: folds 
black_dad23: calls €0.06
hsilva1621: calls €0.06
*** FLOP *** [6h 9s 6c]
black_dad23: checks 
hsilva1621: checks 
pipinoelbreve9: bets €0.16
black_dad23: folds 
hsilva1621: folds 
Uncalled bet (€0.16) returned to pipinoelbreve9
pipinoelbreve9 collected €0.31 from pot
pipinoelbreve9: doesn't show hand 
*** SUMMARY ***
Total pot €0.33 | Rake €0.02 
Board [6h 9s 6c]
Seat 1: pipinoelbreve9 (button) collected (€0.31)
Seat 2: JAQKKK (small blind) folded before Flop
Seat 3: CondeVnCount (big blind) folded before Flop
Seat 4: black_dad23 folded on the Flop
Seat 5: hsilva1621 folded on the Flop
Seat 6: alexpqx folded before Flop (didn't bet)



PokerStars Zoom Hand #257662988138:  Hold'em No Limit (€0.01/€0.02) - 2025/09/08 18:26:47 CET [2025/09/08 12:26:47 ET]
Table 'Arneb' 6-max Seat #1 is the button
Seat 1: JENOFONTE73 (€2.53 in chips) 
Seat 2: V1e4ra (€2.44 in chips) 
Seat 3: pipinoelbreve9 (€2.28 in chips) 
Seat 4: 33baba33 (€1.75 in chips) 
Seat 5: candarias (€0.66 in chips) 
Seat 6: Delvicius (€0.98 in chips) 
V1e4ra: posts small blind €0.01
pipinoelbreve9: posts big blind €0.02
*** HOLE CARDS ***
Dealt to pipinoelbreve9 [2h 8c]
33baba33: raises €0.03 to €0.05
candarias: folds 
Delvicius: folds 
JENOFONTE73: folds 
V1e4ra: folds 
pipinoelbreve9: folds 
Uncalled bet (€0.03) returned to 33baba33
33baba33 collected €0.05 from pot
33baba33: doesn't show hand 
*** SUMMARY ***
Total pot €0.05 | Rake €0 
Seat 1: JENOFONTE73 (button) folded before Flop (didn't bet)
Seat 2: V1e4ra (small blind) folded before Flop
Seat 3: pipinoelbreve9 (big blind) folded before Flop
Seat 4: 33baba33 collected (€0.05)
Seat 5: candarias folded before Flop (didn't bet)
Seat 6: Delvicius folded before Flop (didn't bet)



PokerStars Zoom Hand #257662989159:  Hold'em No Limit (€0.01/€0.02) - 2025/09/08 18:26:52 CET [2025/09/08 12:26:52 ET]
Table 'Arneb' 6-max Seat #1 is the button
Seat 1: CondeVnCount (€2.59 in chips) 
Seat 2: pipinoelbreve9 (€2.26 in chips) 
Seat 3: V1e4ra (€1.43 in chips) 
Seat 4: JENOFONTE73 (€2.53 in chips) 
Seat 5: mabioba (€2 in chips) 
Seat 6: urkel77 (€2.60 in chips) 
pipinoelbreve9: posts small blind €0.01
V1e4ra: posts big blind €0.02
*** HOLE CARDS ***
Dealt to pipinoelbreve9 [Ac 8s]
JENOFONTE73: folds 
mabioba: raises €0.03 to €0.05
urkel77: folds 
CondeVnCount: folds 
pipinoelbreve9: folds 
V1e4ra: folds 
Uncalled bet (€0.03) returned to mabioba
mabioba collected €0.05 from pot
mabioba: doesn't show hand 
*** SUMMARY ***
Total pot €0.05 | Rake €0 
Seat 1: CondeVnCount (button) folded before Flop (didn't bet)
Seat 2: pipinoelbreve9 (small blind) folded before Flop
Seat 3: V1e4ra (big blind) folded before Flop
Seat 4: JENOFONTE73 folded before Flop (didn't bet)
Seat 5: mabioba collected (€0.05)
Seat 6: urkel77 folded before Flop (didn't bet)



PokerStars Zoom Hand #257662991788:  Hold'em No Limit (€0.01/€0.02) - 2025/09/08 18:27:06 CET [2025/09/08 12:27:06 ET]
Table 'Arneb' 6-max Seat #1 is the button
Seat 1: Ruben1990869 (€2 in chips) 
Seat 2: alexpqx (€4.14 in chips) 
Seat 3: Gginer2812 (€1.02 in chips) 
Seat 4: V1e4ra (€2.86 in chips) 
Seat 5: TonyGonzalezz (€1.93 in chips) 
Seat 6: pipinoelbreve9 (€2.25 in chips) 
alexpqx: posts small blind €0.01
Gginer2812: posts big blind €0.02
*** HOLE CARDS ***
Dealt to pipinoelbreve9 [4d Js]
V1e4ra: folds 
TonyGonzalezz: folds 
pipinoelbreve9: folds 
Ruben1990869: folds 
alexpqx: folds 
Uncalled bet (€0.01) returned to Gginer2812
Gginer2812 collected €0.02 from pot
Gginer2812: doesn't show hand 
*** SUMMARY ***
Total pot €0.02 | Rake €0 
Seat 1: Ruben1990869 (button) folded before Flop (didn't bet)
Seat 2: alexpqx (small blind) folded before Flop
Seat 3: Gginer2812 (big blind) collected (€0.02)
Seat 4: V1e4ra folded before Flop (didn't bet)
Seat 5: TonyGonzalezz folded before Flop (didn't bet)
Seat 6: pipinoelbreve9 folded before Flop (didn't bet)



PokerStars Zoom Hand #257662994034:  Hold'em No Limit (€0.01/€0.02) - 2025/09/08 18:27:17 CET [2025/09/08 12:27:17 ET]
Table 'Arneb' 6-max Seat #1 is the button
Seat 1: Flavs12855 (€2.76 in chips) 
Seat 2: Diefa4466 (€2.04 in chips) 
Seat 3: abmarc99 (€1.56 in chips) 
Seat 4: El portador III (€0.61 in chips) 
Seat 5: pipinoelbreve9 (€2.25 in chips) 
Seat 6: JENOFONTE73 (€2.51 in chips) 
Diefa4466: posts small blind €0.01
abmarc99: posts big blind €0.02
*** HOLE CARDS ***
Dealt to pipinoelbreve9 [8s 6h]
El portador III: calls €0.02
pipinoelbreve9: folds 
JENOFONTE73: raises €0.05 to €0.07
Flavs12855: calls €0.07
Diefa4466: folds 
abmarc99: folds 
El portador III: folds 
*** FLOP *** [4s 4c Qs]
JENOFONTE73: bets €0.09
Flavs12855: folds 
Uncalled bet (€0.09) returned to JENOFONTE73
JENOFONTE73 collected €0.18 from pot
JENOFONTE73: doesn't show hand 
*** SUMMARY ***
Total pot €0.19 | Rake €0.01 
Board [4s 4c Qs]
Seat 1: Flavs12855 (button) folded on the Flop
Seat 2: Diefa4466 (small blind) folded before Flop
Seat 3: abmarc99 (big blind) folded before Flop
Seat 4: El portador III folded before Flop
Seat 5: pipinoelbreve9 folded before Flop (didn't bet)
Seat 6: JENOFONTE73 collected (€0.18)



PokerStars Zoom Hand #257662994756:  Hold'em No Limit (€0.01/€0.02) - 2025/09/08 18:27:21 CET [2025/09/08 12:27:21 ET]
Table 'Arneb' 6-max Seat #1 is the button
Seat 1: Doblea315 (€3.59 in chips) 
Seat 2: DavSnook (€6.28 in chips) 
Seat 3: pipinoelbreve9 (€2.25 in chips) 
Seat 4: bluffynuts (€0.97 in chips) 
Seat 5: rccmonteiro27 (€2.70 in chips) 
Seat 6: typh00n27 (€2.40 in chips) 
DavSnook: posts small blind €0.01
pipinoelbreve9: posts big blind €0.02
*** HOLE CARDS ***
Dealt to pipinoelbreve9 [6d 7h]
bluffynuts: calls €0.02
rccmonteiro27: folds 
typh00n27: raises €0.04 to €0.06
Doblea315: folds 
DavSnook: raises €0.16 to €0.22
pipinoelbreve9: folds 
bluffynuts: folds 
typh00n27: folds 
Uncalled bet (€0.16) returned to DavSnook
DavSnook collected €0.16 from pot
DavSnook: doesn't show hand 
*** SUMMARY ***
Total pot €0.16 | Rake €0 
Seat 1: Doblea315 (button) folded before Flop (didn't bet)
Seat 2: DavSnook (small blind) collected (€0.16)
Seat 3: pipinoelbreve9 (big blind) folded before Flop
Seat 4: bluffynuts folded before Flop
Seat 5: rccmonteiro27 folded before Flop (didn't bet)
Seat 6: typh00n27 folded before Flop



PokerStars Zoom Hand #257662997296:  Hold'em No Limit (€0.01/€0.02) - 2025/09/08 18:27:35 CET [2025/09/08 12:27:35 ET]
Table 'Arneb' 6-max Seat #1 is the button
Seat 1: pipinoelbreve9 (€2.23 in chips) 
Seat 2: GamerVidal (€2.06 in chips) 
Seat 3: DavSnook (€8.68 in chips) 
Seat 4: xReshi (€2.49 in chips) 
Seat 5: typh00n27 (€2.57 in chips) 
Seat 6: alexpqx (€2.03 in chips) 
GamerVidal: posts small blind €0.01
DavSnook: posts big blind €0.02
*** HOLE CARDS ***
Dealt to pipinoelbreve9 [Qc 7d]
xReshi: folds 
typh00n27: folds 
alexpqx: folds 
pipinoelbreve9: folds 
GamerVidal: folds 
Uncalled bet (€0.01) returned to DavSnook
DavSnook collected €0.02 from pot
DavSnook: doesn't show hand 
*** SUMMARY ***
Total pot €0.02 | Rake €0 
Seat 1: pipinoelbreve9 (button) folded before Flop (didn't bet)
Seat 2: GamerVidal (small blind) folded before Flop
Seat 3: DavSnook (big blind) collected (€0.02)
Seat 4: xReshi folded before Flop (didn't bet)
Seat 5: typh00n27 folded before Flop (didn't bet)
Seat 6: alexpqx folded before Flop (didn't bet)



PokerStars Zoom Hand #257662998962:  Hold'em No Limit (€0.01/€0.02) - 2025/09/08 18:27:43 CET [2025/09/08 12:27:43 ET]
Table 'Arneb' 6-max Seat #1 is the button
Seat 1: pompavana (€1.92 in chips) 
Seat 2: pipinoelbreve9 (€2.23 in chips) 
Seat 3: El portador III (€0.59 in chips) 
Seat 4: XxSuperLopezxX (€2.08 in chips) 
Seat 5: GRIFFIN168 (€2.51 in chips) 
Seat 6: guizzado16 (€5.96 in chips) 
pipinoelbreve9: posts small blind €0.01
El portador III: posts big blind €0.02
*** HOLE CARDS ***
Dealt to pipinoelbreve9 [8c Kc]
XxSuperLopezxX: folds 
GRIFFIN168: raises €0.02 to €0.04
guizzado16: folds 
pompavana: folds 
pipinoelbreve9: folds 
El portador III: folds 
Uncalled bet (€0.02) returned to GRIFFIN168
GRIFFIN168 collected €0.05 from pot
GRIFFIN168: doesn't show hand 
*** SUMMARY ***
Total pot €0.05 | Rake €0 
Seat 1: pompavana (button) folded before Flop (didn't bet)
Seat 2: pipinoelbreve9 (small blind) folded before Flop
Seat 3: El portador III (big blind) folded before Flop
Seat 4: XxSuperLopezxX folded before Flop (didn't bet)
Seat 5: GRIFFIN168 collected (€0.05)
Seat 6: guizzado16 folded before Flop (didn't bet)



PokerStars Zoom Hand #257662997985:  Hold'em No Limit (€0.01/€0.02) - 2025/09/08 18:27:38 CET [2025/09/08 12:27:38 ET]
Table 'Arneb' 6-max Seat #1 is the button
Seat 1: ZixZ596 (€0.83 in chips) 
Seat 2: xReshi (€2.49 in chips) 
Seat 3: Ruben1990869 (€2.03 in chips) 
Seat 4: pipinoelbreve9 (€2.23 in chips) 
Seat 5: vivilivrevivi26 (€1.74 in chips) 
Seat 6: 33baba33 (€1.76 in chips) 
xReshi: posts small blind €0.01
Ruben1990869: posts big blind €0.02
*** HOLE CARDS ***
Dealt to pipinoelbreve9 [9d Tc]
pipinoelbreve9: folds 
vivilivrevivi26: calls €0.02
33baba33: calls €0.02
ZixZ596: calls €0.02
xReshi: folds 
Ruben1990869: checks 
*** FLOP *** [Qc Kh 4h]
Ruben1990869: checks 
vivilivrevivi26: checks 
33baba33: checks 
ZixZ596: bets €0.02
Ruben1990869: folds 
vivilivrevivi26: calls €0.02
33baba33: folds 
*** TURN *** [Qc Kh 4h] [9s]
vivilivrevivi26: checks 
ZixZ596: bets €0.02
vivilivrevivi26: calls €0.02
*** RIVER *** [Qc Kh 4h 9s] [5s]
vivilivrevivi26: checks 
ZixZ596: checks 
*** SHOW DOWN ***
vivilivrevivi26: shows [Qh Ts] (a pair of Queens)
ZixZ596: shows [Ah Ks] (a pair of Kings)
ZixZ596 collected €0.16 from pot
*** SUMMARY ***
Total pot €0.17 | Rake €0.01 
Board [Qc Kh 4h 9s 5s]
Seat 1: ZixZ596 (button) showed [Ah Ks] and won (€0.16) with a pair of Kings
Seat 2: xReshi (small blind) folded before Flop
Seat 3: Ruben1990869 (big blind) folded on the Flop
Seat 4: pipinoelbreve9 folded before Flop (didn't bet)
Seat 5: vivilivrevivi26 showed [Qh Ts] and lost with a pair of Queens
Seat 6: 33baba33 folded on the Flop



PokerStars Zoom Hand #257662993317:  Hold'em No Limit (€0.01/€0.02) - 2025/09/08 18:27:14 CET [2025/09/08 12:27:14 ET]
Table 'Arneb' 6-max Seat #1 is the button
Seat 1: black_dad23 (€1.26 in chips) 
Seat 2: xReshi (€2 in chips) 
Seat 3: Ferchyman77 (€2 in chips) 
Seat 4: pipinoelbreve9 (€2.25 in chips) 
Seat 5: CondeVnCount (€2.56 in chips) 
Seat 6: alexpqx (€4.13 in chips) 
xReshi: posts small blind €0.01
Ferchyman77: posts big blind €0.02
*** HOLE CARDS ***
Dealt to pipinoelbreve9 [2h 5c]
pipinoelbreve9: folds 
CondeVnCount: folds 
alexpqx: raises €0.05 to €0.07
black_dad23: calls €0.07
xReshi: folds 
Ferchyman77: folds 
*** FLOP *** [6h Td 3d]
alexpqx: checks 
black_dad23: bets €0.08
alexpqx: calls €0.08
*** TURN *** [6h Td 3d] [3c]
alexpqx: checks 
black_dad23: bets €0.18
alexpqx: calls €0.18
*** RIVER *** [6h Td 3d 3c] [Js]
alexpqx: checks 
black_dad23: bets €0.39
alexpqx: folds 
Uncalled bet (€0.39) returned to black_dad23
black_dad23 collected €0.66 from pot
black_dad23: doesn't show hand 
*** SUMMARY ***
Total pot €0.69 | Rake €0.03 
Board [6h Td 3d 3c Js]
Seat 1: black_dad23 (button) collected (€0.66)
Seat 2: xReshi (small blind) folded before Flop
Seat 3: Ferchyman77 (big blind) folded before Flop
Seat 4: pipinoelbreve9 folded before Flop (didn't bet)
Seat 5: CondeVnCount folded before Flop (didn't bet)
Seat 6: alexpqx folded on the River



PokerStars Zoom Hand #257663003617:  Hold'em No Limit (€0.01/€0.02) - 2025/09/08 18:28:07 CET [2025/09/08 12:28:07 ET]
Table 'Arneb' 6-max Seat #1 is the button
Seat 1: SmOuL123 (€0.57 in chips) 
Seat 2: bluffynuts (€2.43 in chips) 
Seat 3: pipinoelbreve9 (€2.22 in chips) 
Seat 4: TonyGonzalezz (€1.93 in chips) 
Seat 5: JAQKKK (€2.03 in chips) 
Seat 6: aaronroxi (€2 in chips) 
bluffynuts: posts small blind €0.01
pipinoelbreve9: posts big blind €0.02
*** HOLE CARDS ***
Dealt to pipinoelbreve9 [Td Kd]
TonyGonzalezz: raises €0.02 to €0.04
JAQKKK: raises €0.06 to €0.10
aaronroxi: folds 
SmOuL123: folds 
bluffynuts: folds 
pipinoelbreve9: calls €0.08
TonyGonzalezz: raises €0.10 to €0.20
JAQKKK: raises €1.83 to €2.03 and is all-in
pipinoelbreve9: folds 
TonyGonzalezz: calls €1.73 and is all-in
Uncalled bet (€0.10) returned to JAQKKK
*** FLOP *** [4d 9h Th]
*** TURN *** [4d 9h Th] [9d]
*** RIVER *** [4d 9h Th 9d] [6d]
*** SHOW DOWN ***
TonyGonzalezz: shows [Ks Kh] (two pair, Kings and Nines)
JAQKKK: shows [Qs Qc] (two pair, Queens and Nines)
TonyGonzalezz collected €3.77 from pot
*** SUMMARY ***
Total pot €3.97 | Rake €0.20 
Board [4d 9h Th 9d 6d]
Seat 1: SmOuL123 (button) folded before Flop (didn't bet)
Seat 2: bluffynuts (small blind) folded before Flop
Seat 3: pipinoelbreve9 (big blind) folded before Flop
Seat 4: TonyGonzalezz showed [Ks Kh] and won (€3.77) with two pair, Kings and Nines
Seat 5: JAQKKK showed [Qs Qc] and lost with two pair, Queens and Nines
Seat 6: aaronroxi folded before Flop (didn't bet)



PokerStars Zoom Hand #257663014413:  Hold'em No Limit (€0.01/€0.02) - 2025/09/08 18:29:03 CET [2025/09/08 12:29:03 ET]
Table 'Arneb' 6-max Seat #1 is the button
Seat 1: cuenca10 (€3.20 in chips) 
Seat 2: typh00n27 (€2.60 in chips) 
Seat 3: kilian88920 (€1.91 in chips) 
Seat 4: vivilivrevivi26 (€1.56 in chips) 
Seat 5: black_dad23 (€1.65 in chips) 
Seat 6: pipinoelbreve9 (€2.12 in chips) 
typh00n27: posts small blind €0.01
kilian88920: posts big blind €0.02
*** HOLE CARDS ***
Dealt to pipinoelbreve9 [9d 5c]
vivilivrevivi26: folds 
black_dad23: raises €0.02 to €0.04
pipinoelbreve9: folds 
cuenca10: folds 
typh00n27: raises €0.10 to €0.14
kilian88920: folds 
black_dad23: folds 
Uncalled bet (€0.10) returned to typh00n27
typh00n27 collected €0.10 from pot
typh00n27: doesn't show hand 
*** SUMMARY ***
Total pot €0.10 | Rake €0 
Seat 1: cuenca10 (button) folded before Flop (didn't bet)
Seat 2: typh00n27 (small blind) collected (€0.10)
Seat 3: kilian88920 (big blind) folded before Flop
Seat 4: vivilivrevivi26 folded before Flop (didn't bet)
Seat 5: black_dad23 folded before Flop
Seat 6: pipinoelbreve9 folded before Flop (didn't bet)



PokerStars Zoom Hand #257663015393:  Hold'em No Limit (€0.01/€0.02) - 2025/09/08 18:29:08 CET [2025/09/08 12:29:08 ET]
Table 'Arneb' 6-max Seat #1 is the button
Seat 1: pipinoelbreve9 (€2.12 in chips) 
Seat 2: artiz300 (€2.01 in chips) 
Seat 3: Doblea315 (€4 in chips) 
Seat 4: johnmitchon (€2.83 in chips) 
Seat 5: vivilivrevivi26 (€1.56 in chips) 
Seat 6: SMN242 (€6.69 in chips) 
artiz300: posts small blind €0.01
Doblea315: posts big blind €0.02
*** HOLE CARDS ***
Dealt to pipinoelbreve9 [9s Td]
johnmitchon: raises €0.04 to €0.06
vivilivrevivi26: folds 
SMN242: folds 
pipinoelbreve9: calls €0.06
artiz300: calls €0.05
Doblea315: folds 
*** FLOP *** [2h 9c 4s]
artiz300: checks 
johnmitchon: checks 
pipinoelbreve9: bets €0.10
artiz300: calls €0.10
johnmitchon: folds 
*** TURN *** [2h 9c 4s] [Js]
artiz300: checks 
pipinoelbreve9: checks 
*** RIVER *** [2h 9c 4s Js] [Kh]
artiz300: checks 
pipinoelbreve9: checks 
*** SHOW DOWN ***
artiz300: shows [3s 3h] (a pair of Threes)
pipinoelbreve9: shows [9s Td] (a pair of Nines)
pipinoelbreve9 collected €0.38 from pot
*** SUMMARY ***
Total pot €0.40 | Rake €0.02 
Board [2h 9c 4s Js Kh]
Seat 1: pipinoelbreve9 (button) showed [9s Td] and won (€0.38) with a pair of Nines
Seat 2: artiz300 (small blind) showed [3s 3h] and lost with a pair of Threes
Seat 3: Doblea315 (big blind) folded before Flop
Seat 4: johnmitchon folded on the Flop
Seat 5: vivilivrevivi26 folded before Flop (didn't bet)
Seat 6: SMN242 folded before Flop (didn't bet)



PokerStars Zoom Hand #257663024444:  Hold'em No Limit (€0.01/€0.02) - 2025/09/08 18:29:53 CET [2025/09/08 12:29:53 ET]
Table 'Arneb' 6-max Seat #1 is the button
Seat 1: artiz300 (€2 in chips) 
Seat 2: pipinoelbreve9 (€2.34 in chips) 
Seat 3: V1e4ra (€1.38 in chips) 
Seat 4: CondeVnCount (€4.27 in chips) 
Seat 5: Ruben1990869 (€2 in chips) 
Seat 6: XxSuperLopezxX (€2.07 in chips) 
pipinoelbreve9: posts small blind €0.01
V1e4ra: posts big blind €0.02
*** HOLE CARDS ***
Dealt to pipinoelbreve9 [Ad 2h]
CondeVnCount: folds 
Ruben1990869: folds 
XxSuperLopezxX: folds 
artiz300: raises €0.02 to €0.04
pipinoelbreve9: folds 
V1e4ra: folds 
Uncalled bet (€0.02) returned to artiz300
artiz300 collected €0.05 from pot
artiz300: doesn't show hand 
*** SUMMARY ***
Total pot €0.05 | Rake €0 
Seat 1: artiz300 (button) collected (€0.05)
Seat 2: pipinoelbreve9 (small blind) folded before Flop
Seat 3: V1e4ra (big blind) folded before Flop
Seat 4: CondeVnCount folded before Flop (didn't bet)
Seat 5: Ruben1990869 folded before Flop (didn't bet)
Seat 6: XxSuperLopezxX folded before Flop (didn't bet)



PokerStars Zoom Hand #257663028447:  Hold'em No Limit (€0.01/€0.02) - 2025/09/08 18:30:11 CET [2025/09/08 12:30:11 ET]
Table 'Arneb' 6-max Seat #1 is the button
Seat 1: kombei63 (€0.79 in chips) 
Seat 2: JENOFONTE73 (€2.77 in chips) 
Seat 3: guizzado16 (€7.05 in chips) 
Seat 4: Delvicius (€0.98 in chips) 
Seat 5: Ferchyman77 (€2 in chips) 
Seat 6: pipinoelbreve9 (€2.33 in chips) 
JENOFONTE73: posts small blind €0.01
guizzado16: posts big blind €0.02
*** HOLE CARDS ***
Dealt to pipinoelbreve9 [9c 8h]
Delvicius: folds 
Ferchyman77: folds 
pipinoelbreve9: folds 
kombei63: folds 
JENOFONTE73: folds 
Uncalled bet (€0.01) returned to guizzado16
guizzado16 collected €0.02 from pot
guizzado16: doesn't show hand 
*** SUMMARY ***
Total pot €0.02 | Rake €0 
Seat 1: kombei63 (button) folded before Flop (didn't bet)
Seat 2: JENOFONTE73 (small blind) folded before Flop
Seat 3: guizzado16 (big blind) collected (€0.02)
Seat 4: Delvicius folded before Flop (didn't bet)
Seat 5: Ferchyman77 folded before Flop (didn't bet)
Seat 6: pipinoelbreve9 folded before Flop (didn't bet)



PokerStars Zoom Hand #257663031106:  Hold'em No Limit (€0.01/€0.02) - 2025/09/08 18:30:25 CET [2025/09/08 12:30:25 ET]
Table 'Arneb' 6-max Seat #1 is the button
Seat 1: ZixZ596 (€1.28 in chips) 
Seat 2: CondeVnCount (€7.41 in chips) 
Seat 3: pipinoelbreve9 (€2.33 in chips) 
Seat 4: kilian88920 (€1.73 in chips) 
Seat 5: V1e4ra (€1.57 in chips) 
Seat 6: candarias (€1 in chips) 
CondeVnCount: posts small blind €0.01
pipinoelbreve9: posts big blind €0.02
*** HOLE CARDS ***
Dealt to pipinoelbreve9 [5h Js]
kilian88920: folds 
V1e4ra: raises €0.05 to €0.07
candarias: folds 
ZixZ596: folds 
CondeVnCount: folds 
pipinoelbreve9: folds 
Uncalled bet (€0.05) returned to V1e4ra
V1e4ra collected €0.05 from pot
V1e4ra: doesn't show hand 
*** SUMMARY ***
Total pot €0.05 | Rake €0 
Seat 1: ZixZ596 (button) folded before Flop (didn't bet)
Seat 2: CondeVnCount (small blind) folded before Flop
Seat 3: pipinoelbreve9 (big blind) folded before Flop
Seat 4: kilian88920 folded before Flop (didn't bet)
Seat 5: V1e4ra collected (€0.05)
Seat 6: candarias folded before Flop (didn't bet)



PokerStars Zoom Hand #257663027651:  Hold'em No Limit (€0.01/€0.02) - 2025/09/08 18:30:07 CET [2025/09/08 12:30:07 ET]
Table 'Arneb' 6-max Seat #1 is the button
Seat 1: candarias (€1.31 in chips) 
Seat 2: yunblvck (€4.23 in chips) 
Seat 3: Ruben1990869 (€2 in chips) 
Seat 4: kombei63 (€1.75 in chips) 
Seat 5: pipinoelbreve9 (€2.33 in chips) 
Seat 6: V1e4ra (€1.86 in chips) 
yunblvck: posts small blind €0.01
Ruben1990869: posts big blind €0.02
*** HOLE CARDS ***
Dealt to pipinoelbreve9 [4c Ts]
kombei63: folds 
pipinoelbreve9: folds 
V1e4ra: folds 
candarias: folds 
yunblvck: calls €0.01
Ruben1990869: checks 
*** FLOP *** [7d Ks As]
yunblvck: checks 
Ruben1990869: checks 
*** TURN *** [7d Ks As] [Jh]
yunblvck: bets €0.02
Ruben1990869: raises €0.08 to €0.10
yunblvck: calls €0.08
*** RIVER *** [7d Ks As Jh] [8c]
yunblvck: checks 
Ruben1990869: bets €0.12
yunblvck: folds 
Uncalled bet (€0.12) returned to Ruben1990869
Ruben1990869 collected €0.23 from pot
Ruben1990869: doesn't show hand 
*** SUMMARY ***
Total pot €0.24 | Rake €0.01 
Board [7d Ks As Jh 8c]
Seat 1: candarias (button) folded before Flop (didn't bet)
Seat 2: yunblvck (small blind) folded on the River
Seat 3: Ruben1990869 (big blind) collected (€0.23)
Seat 4: kombei63 folded before Flop (didn't bet)
Seat 5: pipinoelbreve9 folded before Flop (didn't bet)
Seat 6: V1e4ra folded before Flop (didn't bet)



PokerStars Zoom Hand #257663033229:  Hold'em No Limit (€0.01/€0.02) - 2025/09/08 18:30:35 CET [2025/09/08 12:30:35 ET]
Table 'Arneb' 6-max Seat #1 is the button
Seat 1: xhadd (€2.93 in chips) 
Seat 2: pipinoelbreve9 (€2.31 in chips) 
Seat 3: Flavs12855 (€1.77 in chips) 
Seat 4: CondeVnCount (€2.59 in chips) 
Seat 5: candarias (€1 in chips) 
Seat 6: papakirrin (€2.85 in chips) 
pipinoelbreve9: posts small blind €0.01
Flavs12855: posts big blind €0.02
*** HOLE CARDS ***
Dealt to pipinoelbreve9 [9h Th]
CondeVnCount: folds 
candarias: calls €0.02
papakirrin: folds 
xhadd: folds 
pipinoelbreve9: raises €0.08 to €0.10
Flavs12855: folds 
candarias: folds 
Uncalled bet (€0.08) returned to pipinoelbreve9
pipinoelbreve9 collected €0.06 from pot
pipinoelbreve9: doesn't show hand 
*** SUMMARY ***
Total pot €0.06 | Rake €0 
Seat 1: xhadd (button) folded before Flop (didn't bet)
Seat 2: pipinoelbreve9 (small blind) collected (€0.06)
Seat 3: Flavs12855 (big blind) folded before Flop
Seat 4: CondeVnCount folded before Flop (didn't bet)
Seat 5: candarias folded before Flop
Seat 6: papakirrin folded before Flop (didn't bet)



PokerStars Zoom Hand #257663036483:  Hold'em No Limit (€0.01/€0.02) - 2025/09/08 18:30:51 CET [2025/09/08 12:30:51 ET]
Table 'Arneb' 6-max Seat #1 is the button
Seat 1: pipinoelbreve9 (€2.35 in chips) 
Seat 2: Flavs12855 (€1.75 in chips) 
Seat 3: DavSnook (€8.69 in chips) 
Seat 4: candarias (€0.98 in chips) 
Seat 5: kombei63 (€1.73 in chips) 
Seat 6: Doblea315 (€3.35 in chips) 
Flavs12855: posts small blind €0.01
DavSnook: posts big blind €0.02
*** HOLE CARDS ***
Dealt to pipinoelbreve9 [2h 5d]
candarias: folds 
kombei63: folds 
Doblea315: folds 
pipinoelbreve9: folds 
Flavs12855: folds 
Uncalled bet (€0.01) returned to DavSnook
DavSnook collected €0.02 from pot
DavSnook: doesn't show hand 
*** SUMMARY ***
Total pot €0.02 | Rake €0 
Seat 1: pipinoelbreve9 (button) folded before Flop (didn't bet)
Seat 2: Flavs12855 (small blind) folded before Flop
Seat 3: DavSnook (big blind) collected (€0.02)
Seat 4: candarias folded before Flop (didn't bet)
Seat 5: kombei63 folded before Flop (didn't bet)
Seat 6: Doblea315 folded before Flop (didn't bet)



PokerStars Zoom Hand #257663029183:  Hold'em No Limit (€0.01/€0.02) - 2025/09/08 18:30:15 CET [2025/09/08 12:30:15 ET]
Table 'Arneb' 6-max Seat #1 is the button
Seat 1: pompavana (€2.01 in chips) 
Seat 2: embidoall (€3.50 in chips) 
Seat 3: SMN242 (€7.19 in chips) 
Seat 4: caroleli10 (€3.69 in chips) 
Seat 5: pipinoelbreve9 (€2.33 in chips) 
Seat 6: Ruben1990869 (€2.28 in chips) 
embidoall: posts small blind €0.01
SMN242: posts big blind €0.02
*** HOLE CARDS ***
Dealt to pipinoelbreve9 [9s Js]
caroleli10: folds 
pipinoelbreve9: folds 
Ruben1990869: folds 
pompavana: raises €0.02 to €0.04
embidoall: folds 
SMN242: calls €0.02
*** FLOP *** [6h 8s Tc]
SMN242: checks 
pompavana: bets €0.05
SMN242: calls €0.05
*** TURN *** [6h 8s Tc] [Jd]
SMN242: checks 
pompavana: checks 
*** RIVER *** [6h 8s Tc Jd] [2d]
SMN242: checks 
pompavana: checks 
*** SHOW DOWN ***
SMN242: shows [6c Qd] (a pair of Sixes)
pompavana: mucks hand 
SMN242 collected €0.18 from pot
*** SUMMARY ***
Total pot €0.19 | Rake €0.01 
Board [6h 8s Tc Jd 2d]
Seat 1: pompavana (button) mucked [As 2s]
Seat 2: embidoall (small blind) folded before Flop
Seat 3: SMN242 (big blind) showed [6c Qd] and won (€0.18) with a pair of Sixes
Seat 4: caroleli10 folded before Flop (didn't bet)
Seat 5: pipinoelbreve9 folded before Flop (didn't bet)
Seat 6: Ruben1990869 folded before Flop (didn't bet)



PokerStars Zoom Hand #257663038524:  Hold'em No Limit (€0.01/€0.02) - 2025/09/08 18:31:01 CET [2025/09/08 12:31:01 ET]
Table 'Arneb' 6-max Seat #1 is the button
Seat 1: pipinoelbreve9 (€2.35 in chips) 
Seat 2: candarias (€1.27 in chips) 
Seat 3: abmarc99 (€1.39 in chips) 
Seat 4: belpaulo (€1.88 in chips) 
Seat 5: alexpqx (€1.70 in chips) 
Seat 6: WeeDDiegO (€3.22 in chips) 
candarias: posts small blind €0.01
abmarc99: posts big blind €0.02
*** HOLE CARDS ***
Dealt to pipinoelbreve9 [Qh 4s]
belpaulo: folds 
alexpqx: raises €0.05 to €0.07
WeeDDiegO: folds 
pipinoelbreve9: folds 
candarias: folds 
abmarc99: folds 
Uncalled bet (€0.05) returned to alexpqx
alexpqx collected €0.05 from pot
alexpqx: doesn't show hand 
*** SUMMARY ***
Total pot €0.05 | Rake €0 
Seat 1: pipinoelbreve9 (button) folded before Flop (didn't bet)
Seat 2: candarias (small blind) folded before Flop
Seat 3: abmarc99 (big blind) folded before Flop
Seat 4: belpaulo folded before Flop (didn't bet)
Seat 5: alexpqx collected (€0.05)
Seat 6: WeeDDiegO folded before Flop (didn't bet)



PokerStars Zoom Hand #257663040927:  Hold'em No Limit (€0.01/€0.02) - 2025/09/08 18:31:13 CET [2025/09/08 12:31:13 ET]
Table 'Arneb' 6-max Seat #1 is the button
Seat 1: black_dad23 (€0.59 in chips) 
Seat 2: Doblea315 (€3.92 in chips) 
Seat 3: pipinoelbreve9 (€2.35 in chips) 
Seat 4: DavSnook (€4.96 in chips) 
Seat 5: grenha1972 (€1.96 in chips) 
Seat 6: artiz300 (€2.03 in chips) 
Doblea315: posts small blind €0.01
pipinoelbreve9: posts big blind €0.02
*** HOLE CARDS ***
Dealt to pipinoelbreve9 [Jd Kd]
DavSnook: folds 
grenha1972: folds 
artiz300: folds 
black_dad23: folds 
Doblea315: raises €0.04 to €0.06
pipinoelbreve9: raises €0.12 to €0.18
Doblea315: folds 
Uncalled bet (€0.12) returned to pipinoelbreve9
pipinoelbreve9 collected €0.12 from pot
pipinoelbreve9: doesn't show hand 
*** SUMMARY ***
Total pot €0.12 | Rake €0 
Seat 1: black_dad23 (button) folded before Flop (didn't bet)
Seat 2: Doblea315 (small blind) folded before Flop
Seat 3: pipinoelbreve9 (big blind) collected (€0.12)
Seat 4: DavSnook folded before Flop (didn't bet)
Seat 5: grenha1972 folded before Flop (didn't bet)
Seat 6: artiz300 folded before Flop (didn't bet)



PokerStars Zoom Hand #257663037334:  Hold'em No Limit (€0.01/€0.02) - 2025/09/08 18:30:55 CET [2025/09/08 12:30:55 ET]
Table 'Arneb' 6-max Seat #1 is the button
Seat 1: typh00n27 (€2.14 in chips) 
Seat 2: Delvicius (€0.17 in chips) 
Seat 3: sirena58 (€2.15 in chips) 
Seat 4: Ferchyman77 (€2 in chips) 
Seat 5: CondeVnCount (€7.38 in chips) 
Seat 6: pipinoelbreve9 (€2.35 in chips) 
Delvicius: posts small blind €0.01
sirena58: posts big blind €0.02
*** HOLE CARDS ***
Dealt to pipinoelbreve9 [Qd 3d]
Ferchyman77: folds 
CondeVnCount: folds 
pipinoelbreve9: folds 
typh00n27: raises €0.04 to €0.06
Delvicius: folds 
sirena58: calls €0.04
*** FLOP *** [Ac Kh 4c]
sirena58: checks 
typh00n27: bets €0.06
sirena58: calls €0.06
*** TURN *** [Ac Kh 4c] [Ah]
sirena58: checks 
typh00n27: bets €0.12
sirena58: calls €0.12
*** RIVER *** [Ac Kh 4c Ah] [8h]
sirena58: checks 
typh00n27: bets €0.24
sirena58: folds 
Uncalled bet (€0.24) returned to typh00n27
typh00n27 collected €0.47 from pot
typh00n27: doesn't show hand 
*** SUMMARY ***
Total pot €0.49 | Rake €0.02 
Board [Ac Kh 4c Ah 8h]
Seat 1: typh00n27 (button) collected (€0.47)
Seat 2: Delvicius (small blind) folded before Flop
Seat 3: sirena58 (big blind) folded on the River
Seat 4: Ferchyman77 folded before Flop (didn't bet)
Seat 5: CondeVnCount folded before Flop (didn't bet)
Seat 6: pipinoelbreve9 folded before Flop (didn't bet)



PokerStars Zoom Hand #257663045313:  Hold'em No Limit (€0.01/€0.02) - 2025/09/08 18:31:34 CET [2025/09/08 12:31:34 ET]
Table 'Arneb' 6-max Seat #1 is the button
Seat 1: CondeVnCount (€2.97 in chips) 
Seat 2: abmarc99 (€1.37 in chips) 
Seat 3: belpaulo (€1.84 in chips) 
Seat 4: alexpqx (€2 in chips) 
Seat 5: pipinoelbreve9 (€2.41 in chips) 
Seat 6: BestiaESP12 (€2.20 in chips) 
abmarc99: posts small blind €0.01
belpaulo: posts big blind €0.02
*** HOLE CARDS ***
Dealt to pipinoelbreve9 [7d 2s]
alexpqx: folds 
pipinoelbreve9: folds 
BestiaESP12: folds 
CondeVnCount: folds 
abmarc99: folds 
Uncalled bet (€0.01) returned to belpaulo
belpaulo collected €0.02 from pot
belpaulo: doesn't show hand 
*** SUMMARY ***
Total pot €0.02 | Rake €0 
Seat 1: CondeVnCount (button) folded before Flop (didn't bet)
Seat 2: abmarc99 (small blind) folded before Flop
Seat 3: belpaulo (big blind) collected (€0.02)
Seat 4: alexpqx folded before Flop (didn't bet)
Seat 5: pipinoelbreve9 folded before Flop (didn't bet)
Seat 6: BestiaESP12 folded before Flop (didn't bet)



PokerStars Zoom Hand #257663039908:  Hold'em No Limit (€0.01/€0.02) - 2025/09/08 18:31:08 CET [2025/09/08 12:31:08 ET]
Table 'Arneb' 6-max Seat #1 is the button
Seat 1: ñlkjh33 (€1.80 in chips) 
Seat 2: kombei63 (€1.50 in chips) 
Seat 3: hobbyt1969 (€0.94 in chips) 
Seat 4: pipinoelbreve9 (€2.35 in chips) 
Seat 5: Masticore1 (€2.24 in chips) 
Seat 6: WeeDDiegO (€3.22 in chips) 
kombei63: posts small blind €0.01
hobbyt1969: posts big blind €0.02
*** HOLE CARDS ***
Dealt to pipinoelbreve9 [Ts 4s]
pipinoelbreve9: folds 
Masticore1: folds 
WeeDDiegO: raises €0.02 to €0.04
ñlkjh33: folds 
kombei63: folds 
hobbyt1969: raises €0.06 to €0.10
WeeDDiegO: raises €0.14 to €0.24
hobbyt1969: raises €0.70 to €0.94 and is all-in
WeeDDiegO: folds 
Uncalled bet (€0.70) returned to hobbyt1969
hobbyt1969 collected €0.49 from pot
hobbyt1969: doesn't show hand 
*** SUMMARY ***
Total pot €0.49 | Rake €0 
Seat 1: ñlkjh33 (button) folded before Flop (didn't bet)
Seat 2: kombei63 (small blind) folded before Flop
Seat 3: hobbyt1969 (big blind) collected (€0.49)
Seat 4: pipinoelbreve9 folded before Flop (didn't bet)
Seat 5: Masticore1 folded before Flop (didn't bet)
Seat 6: WeeDDiegO folded before Flop



PokerStars Zoom Hand #257663030374:  Hold'em No Limit (€0.01/€0.02) - 2025/09/08 18:30:21 CET [2025/09/08 12:30:21 ET]
Table 'Arneb' 6-max Seat #1 is the button
Seat 1: V1e4ra (€1.57 in chips) 
Seat 2: XxSuperLopezxX (€2.08 in chips) 
Seat 3: capucine572 (€1 in chips) 
Seat 4: pipinoelbreve9 (€2.33 in chips) 
Seat 5: BestiaESP12 (€2.20 in chips) 
Seat 6: black_dad23 (€1.62 in chips) 
XxSuperLopezxX: posts small blind €0.01
capucine572: posts big blind €0.02
*** HOLE CARDS ***
Dealt to pipinoelbreve9 [6d Td]
pipinoelbreve9: folds 
BestiaESP12: folds 
black_dad23: raises €0.02 to €0.04
V1e4ra: folds 
XxSuperLopezxX: folds 
capucine572: calls €0.02
*** FLOP *** [Qc Jd Ah]
capucine572: checks 
black_dad23: bets €0.05
capucine572: calls €0.05
*** TURN *** [Qc Jd Ah] [3s]
capucine572: checks 
black_dad23: bets €0.14
capucine572: folds 
Uncalled bet (€0.14) returned to black_dad23
black_dad23 collected €0.18 from pot
black_dad23: doesn't show hand 
*** SUMMARY ***
Total pot €0.19 | Rake €0.01 
Board [Qc Jd Ah 3s]
Seat 1: V1e4ra (button) folded before Flop (didn't bet)
Seat 2: XxSuperLopezxX (small blind) folded before Flop
Seat 3: capucine572 (big blind) folded on the Turn
Seat 4: pipinoelbreve9 folded before Flop (didn't bet)
Seat 5: BestiaESP12 folded before Flop (didn't bet)
Seat 6: black_dad23 collected (€0.18)



PokerStars Zoom Hand #257663046045:  Hold'em No Limit (€0.01/€0.02) - 2025/09/08 18:31:38 CET [2025/09/08 12:31:38 ET]
Table 'Arneb' 6-max Seat #1 is the button
Seat 1: candarias (€1.26 in chips) 
Seat 2: sirena58 (€2 in chips) 
Seat 3: JENOFONTE73 (€2.71 in chips) 
Seat 4: hsilva1621 (€2.47 in chips) 
Seat 5: pipinoelbreve9 (€2.41 in chips) 
Seat 6: XxSuperLopezxX (€2.09 in chips) 
sirena58: posts small blind €0.01
JENOFONTE73: posts big blind €0.02
*** HOLE CARDS ***
Dealt to pipinoelbreve9 [Jh Qh]
hsilva1621: raises €0.04 to €0.06
pipinoelbreve9: calls €0.06
XxSuperLopezxX: raises €0.18 to €0.24
candarias: folds 
sirena58: folds 
JENOFONTE73: folds 
hsilva1621: calls €0.18
pipinoelbreve9: calls €0.18
*** FLOP *** [5s Jd Kd]
hsilva1621: checks 
pipinoelbreve9: checks 
XxSuperLopezxX: bets €0.21
hsilva1621: folds 
pipinoelbreve9: calls €0.21
*** TURN *** [5s Jd Kd] [8c]
pipinoelbreve9: checks 
XxSuperLopezxX: checks 
*** RIVER *** [5s Jd Kd 8c] [2c]
pipinoelbreve9: bets €0.56
XxSuperLopezxX: raises €1.08 to €1.64 and is all-in
pipinoelbreve9: calls €1.08
*** SHOW DOWN ***
XxSuperLopezxX: shows [Qc Ad] (high card Ace)
pipinoelbreve9: shows [Jh Qh] (a pair of Jacks)
pipinoelbreve9 collected €4.23 from pot
*** SUMMARY ***
Total pot €4.45 | Rake €0.22 
Board [5s Jd Kd 8c 2c]
Seat 1: candarias (button) folded before Flop (didn't bet)
Seat 2: sirena58 (small blind) folded before Flop
Seat 3: JENOFONTE73 (big blind) folded before Flop
Seat 4: hsilva1621 folded on the Flop
Seat 5: pipinoelbreve9 showed [Jh Qh] and won (€4.23) with a pair of Jacks
Seat 6: XxSuperLopezxX showed [Qc Ad] and lost with high card Ace



PokerStars Zoom Hand #257663062373:  Hold'em No Limit (€0.01/€0.02) - 2025/09/08 18:32:57 CET [2025/09/08 12:32:57 ET]
Table 'Arneb' 6-max Seat #1 is the button
Seat 1: DavSnook (€6.65 in chips) 
Seat 2: pipinoelbreve9 (€4.55 in chips) 
Seat 3: caroleli10 (€2.12 in chips) 
Seat 4: iam_xCidx (€3.55 in chips) 
Seat 5: kombei63 (€1.44 in chips) 
Seat 6: Ruben1990869 (€2.81 in chips) 
pipinoelbreve9: posts small blind €0.01
caroleli10: posts big blind €0.02
*** HOLE CARDS ***
Dealt to pipinoelbreve9 [3d Kc]
iam_xCidx: raises €0.03 to €0.05
kombei63: folds 
Ruben1990869: folds 
DavSnook: folds 
pipinoelbreve9: folds 
caroleli10: folds 
Uncalled bet (€0.03) returned to iam_xCidx
iam_xCidx collected €0.05 from pot
iam_xCidx: doesn't show hand 
*** SUMMARY ***
Total pot €0.05 | Rake €0 
Seat 1: DavSnook (button) folded before Flop (didn't bet)
Seat 2: pipinoelbreve9 (small blind) folded before Flop
Seat 3: caroleli10 (big blind) folded before Flop
Seat 4: iam_xCidx collected (€0.05)
Seat 5: kombei63 folded before Flop (didn't bet)
Seat 6: Ruben1990869 folded before Flop (didn't bet)



PokerStars Zoom Hand #257663065443:  Hold'em No Limit (€0.01/€0.02) - 2025/09/08 18:33:12 CET [2025/09/08 12:33:12 ET]
Table 'Arneb' 6-max Seat #1 is the button
Seat 1: xReshi (€2.29 in chips) 
Seat 2: Ruben1990869 (€2.08 in chips) 
Seat 3: pipinoelbreve9 (€4.54 in chips) 
Seat 4: papakirrin (€1.41 in chips) 
Seat 5: iam_xCidx (€3.58 in chips) 
Seat 6: BestiaESP12 (€2.75 in chips) 
Ruben1990869: posts small blind €0.01
pipinoelbreve9: posts big blind €0.02
*** HOLE CARDS ***
Dealt to pipinoelbreve9 [5d Ad]
papakirrin: folds 
iam_xCidx: folds 
BestiaESP12 has timed out
BestiaESP12: folds 
xReshi: folds 
Ruben1990869: folds 
Uncalled bet (€0.01) returned to pipinoelbreve9
pipinoelbreve9 collected €0.02 from pot
pipinoelbreve9: doesn't show hand 
*** SUMMARY ***
Total pot €0.02 | Rake €0 
Seat 1: xReshi (button) folded before Flop (didn't bet)
Seat 2: Ruben1990869 (small blind) folded before Flop
Seat 3: pipinoelbreve9 (big blind) collected (€0.02)
Seat 4: papakirrin folded before Flop (didn't bet)
Seat 5: iam_xCidx folded before Flop (didn't bet)
Seat 6: BestiaESP12 folded before Flop (didn't bet)



PokerStars Zoom Hand #257663069124:  Hold'em No Limit (€0.01/€0.02) - 2025/09/08 18:33:30 CET [2025/09/08 12:33:30 ET]
Table 'Arneb' 6-max Seat #1 is the button
Seat 1: Doblea315 (€3.77 in chips) 
Seat 2: permament (€2.06 in chips) 
Seat 3: kilian88920 (€1.49 in chips) 
Seat 4: candarias (€0.77 in chips) 
Seat 5: Masticore1 (€2.21 in chips) 
Seat 6: pipinoelbreve9 (€4.55 in chips) 
permament: posts small blind €0.01
kilian88920: posts big blind €0.02
*** HOLE CARDS ***
Dealt to pipinoelbreve9 [6c Ks]
candarias: folds 
Masticore1: folds 
pipinoelbreve9: folds 
Doblea315: folds 
permament: folds 
Uncalled bet (€0.01) returned to kilian88920
kilian88920 collected €0.02 from pot
kilian88920: doesn't show hand 
*** SUMMARY ***
Total pot €0.02 | Rake €0 
Seat 1: Doblea315 (button) folded before Flop (didn't bet)
Seat 2: permament (small blind) folded before Flop
Seat 3: kilian88920 (big blind) collected (€0.02)
Seat 4: candarias folded before Flop (didn't bet)
Seat 5: Masticore1 folded before Flop (didn't bet)
Seat 6: pipinoelbreve9 folded before Flop (didn't bet)



PokerStars Zoom Hand #257663071141:  Hold'em No Limit (€0.01/€0.02) - 2025/09/08 18:33:40 CET [2025/09/08 12:33:40 ET]
Table 'Arneb' 6-max Seat #1 is the button
Seat 1: pipinoelbreve9 (€4.54 in chips) 
Seat 2: DavSnook (€3.02 in chips) 
Seat 3: candarias (€0.77 in chips) 
Seat 4: JAQKKK (€2.19 in chips) 
Seat 5: Ferchyman77 (€2.05 in chips) 
Seat 6: Diefa4466 (€4.32 in chips) 
DavSnook: posts small blind €0.01
candarias: posts big blind €0.02
*** HOLE CARDS ***
Dealt to pipinoelbreve9 [8s 3s]
JAQKKK: folds 
Ferchyman77: folds 
Diefa4466: folds 
pipinoelbreve9: folds 
DavSnook: folds 
Uncalled bet (€0.01) returned to candarias
candarias collected €0.02 from pot
candarias: doesn't show hand 
*** SUMMARY ***
Total pot €0.02 | Rake €0 
Seat 1: pipinoelbreve9 (button) folded before Flop (didn't bet)
Seat 2: DavSnook (small blind) folded before Flop
Seat 3: candarias (big blind) collected (€0.02)
Seat 4: JAQKKK folded before Flop (didn't bet)
Seat 5: Ferchyman77 folded before Flop (didn't bet)
Seat 6: Diefa4466 folded before Flop (didn't bet)



PokerStars Zoom Hand #257663064392:  Hold'em No Limit (€0.01/€0.02) - 2025/09/08 18:33:07 CET [2025/09/08 12:33:07 ET]
Table 'Arneb' 6-max Seat #1 is the button
Seat 1: candarias (€1.24 in chips) 
Seat 2: Doblea315 (€2 in chips) 
Seat 3: Flavs12855 (€2.04 in chips) 
Seat 4: typh00n27 (€2.87 in chips) 
Seat 5: kombei63 (€1.63 in chips) 
Seat 6: pipinoelbreve9 (€4.54 in chips) 
Doblea315: posts small blind €0.01
Flavs12855: posts big blind €0.02
*** HOLE CARDS ***
Dealt to pipinoelbreve9 [2c Jc]
typh00n27: folds 
kombei63: folds 
pipinoelbreve9: folds 
candarias: raises €0.04 to €0.06
Doblea315: folds 
Flavs12855: raises €0.04 to €0.10
candarias: calls €0.04
*** FLOP *** [4h Kd Ks]
Flavs12855: bets €0.11
candarias: calls €0.11
*** TURN *** [4h Kd Ks] [Ah]
Flavs12855: bets €0.10
candarias: raises €0.10 to €0.20
Flavs12855: calls €0.10
*** RIVER *** [4h Kd Ks Ah] [6d]
Flavs12855: checks 
candarias: checks 
*** SHOW DOWN ***
Flavs12855: shows [Th Ts] (two pair, Kings and Tens)
candarias: mucks hand 
Flavs12855 collected €0.79 from pot
*** SUMMARY ***
Total pot €0.83 | Rake €0.04 
Board [4h Kd Ks Ah 6d]
Seat 1: candarias (button) mucked [5d 5h]
Seat 2: Doblea315 (small blind) folded before Flop
Seat 3: Flavs12855 (big blind) showed [Th Ts] and won (€0.79) with two pair, Kings and Tens
Seat 4: typh00n27 folded before Flop (didn't bet)
Seat 5: kombei63 folded before Flop (didn't bet)
Seat 6: pipinoelbreve9 folded before Flop (didn't bet)



PokerStars Zoom Hand #257663063541:  Hold'em No Limit (€0.01/€0.02) - 2025/09/08 18:33:03 CET [2025/09/08 12:33:03 ET]
Table 'Arneb' 6-max Seat #1 is the button
Seat 1: bluffynuts (€2.19 in chips) 
Seat 2: cuenca10 (€3.45 in chips) 
Seat 3: abmarc99 (€1.81 in chips) 
Seat 4: pipinoelbreve9 (€4.54 in chips) 
Seat 5: candarias (€1.04 in chips) 
Seat 6: Alexw022 (€1.61 in chips) 
cuenca10: posts small blind €0.01
abmarc99: posts big blind €0.02
*** HOLE CARDS ***
Dealt to pipinoelbreve9 [2h Qs]
pipinoelbreve9: folds 
candarias: folds 
Alexw022: calls €0.02
bluffynuts: folds 
cuenca10: calls €0.01
abmarc99: checks 
*** FLOP *** [Jc 8s 3h]
cuenca10: checks 
abmarc99: checks 
Alexw022: checks 
*** TURN *** [Jc 8s 3h] [5c]
cuenca10: checks 
abmarc99: checks 
Alexw022: checks 
*** RIVER *** [Jc 8s 3h 5c] [6c]
cuenca10: checks 
abmarc99: checks 
Alexw022: bets €0.02
cuenca10: folds 
abmarc99: folds 
Uncalled bet (€0.02) returned to Alexw022
Alexw022 collected €0.06 from pot
Alexw022: doesn't show hand 
*** SUMMARY ***
Total pot €0.06 | Rake €0 
Board [Jc 8s 3h 5c 6c]
Seat 1: bluffynuts (button) folded before Flop (didn't bet)
Seat 2: cuenca10 (small blind) folded on the River
Seat 3: abmarc99 (big blind) folded on the River
Seat 4: pipinoelbreve9 folded before Flop (didn't bet)
Seat 5: candarias folded before Flop (didn't bet)
Seat 6: Alexw022 collected (€0.06)



PokerStars Zoom Hand #257663072204:  Hold'em No Limit (€0.01/€0.02) - 2025/09/08 18:33:45 CET [2025/09/08 12:33:45 ET]
Table 'Arneb' 6-max Seat #1 is the button
Seat 1: Diefa4466 (€4.32 in chips) 
Seat 2: grenha1972 (€1.88 in chips) 
Seat 3: xReshi (€2.31 in chips) 
Seat 4: pipinoelbreve9 (€4.54 in chips) 
Seat 5: pompavana (€2.05 in chips) 
Seat 6: yunblvck (€3.92 in chips) 
grenha1972: posts small blind €0.01
xReshi: posts big blind €0.02
*** HOLE CARDS ***
Dealt to pipinoelbreve9 [Kd Tc]
pipinoelbreve9: raises €0.04 to €0.06
pompavana: folds 
yunblvck: calls €0.06
Diefa4466: folds 
grenha1972: folds 
xReshi: folds 
*** FLOP *** [Ah 2c Qc]
pipinoelbreve9: bets €0.10
yunblvck: folds 
Uncalled bet (€0.10) returned to pipinoelbreve9
pipinoelbreve9 collected €0.14 from pot
pipinoelbreve9: doesn't show hand 
*** SUMMARY ***
Total pot €0.15 | Rake €0.01 
Board [Ah 2c Qc]
Seat 1: Diefa4466 (button) folded before Flop (didn't bet)
Seat 2: grenha1972 (small blind) folded before Flop
Seat 3: xReshi (big blind) folded before Flop
Seat 4: pipinoelbreve9 collected (€0.14)
Seat 5: pompavana folded before Flop (didn't bet)
Seat 6: yunblvck folded on the Flop



PokerStars Zoom Hand #257663070058:  Hold'em No Limit (€0.01/€0.02) - 2025/09/08 18:33:35 CET [2025/09/08 12:33:35 ET]
Table 'Arneb' 6-max Seat #1 is the button
Seat 1: jean2525 (€2.31 in chips) 
Seat 2: pipinoelbreve9 (€4.55 in chips) 
Seat 3: V1e4ra (€2.08 in chips) 
Seat 4: XxSuperLopezxX (€2.13 in chips) 
Seat 5: typh00n27 (€2.03 in chips) 
Seat 6: alexpqx (€2.50 in chips) 
pipinoelbreve9: posts small blind €0.01
V1e4ra: posts big blind €0.02
*** HOLE CARDS ***
Dealt to pipinoelbreve9 [2d 4d]
XxSuperLopezxX: folds 
typh00n27: folds 
alexpqx: raises €0.05 to €0.07
jean2525: calls €0.07
pipinoelbreve9: folds 
V1e4ra: folds 
*** FLOP *** [4c 9s 7s]
alexpqx: checks 
jean2525: checks 
*** TURN *** [4c 9s 7s] [8s]
alexpqx: checks 
jean2525: bets €0.16
alexpqx: folds 
Uncalled bet (€0.16) returned to jean2525
jean2525 collected €0.16 from pot
jean2525: doesn't show hand 
*** SUMMARY ***
Total pot €0.17 | Rake €0.01 
Board [4c 9s 7s 8s]
Seat 1: jean2525 (button) collected (€0.16)
Seat 2: pipinoelbreve9 (small blind) folded before Flop
Seat 3: V1e4ra (big blind) folded before Flop
Seat 4: XxSuperLopezxX folded before Flop (didn't bet)
Seat 5: typh00n27 folded before Flop (didn't bet)
Seat 6: alexpqx folded on the Turn



PokerStars Zoom Hand #257663077871:  Hold'em No Limit (€0.01/€0.02) - 2025/09/08 18:34:13 CET [2025/09/08 12:34:13 ET]
Table 'Arneb' 6-max Seat #1 is the button
Seat 1: grenha1972 (€1.84 in chips) 
Seat 2: yunblvck (€3.86 in chips) 
Seat 3: pipinoelbreve9 (€4.62 in chips) 
Seat 4: V1e4ra (€1.09 in chips) 
Seat 5: jean2525 (€2.07 in chips) 
Seat 6: JAQKKK (€2.15 in chips) 
yunblvck: posts small blind €0.01
pipinoelbreve9: posts big blind €0.02
*** HOLE CARDS ***
Dealt to pipinoelbreve9 [6s 7c]
V1e4ra: folds 
jean2525: calls €0.02
JAQKKK: folds 
grenha1972: folds 
yunblvck: calls €0.01
pipinoelbreve9: checks 
*** FLOP *** [3h Ad Kh]
yunblvck: checks 
pipinoelbreve9: checks 
jean2525: bets €0.06
yunblvck: calls €0.06
pipinoelbreve9: folds 
*** TURN *** [3h Ad Kh] [Tc]
yunblvck: checks 
jean2525: bets €0.17
yunblvck: folds 
Uncalled bet (€0.17) returned to jean2525
jean2525 collected €0.17 from pot
jean2525: doesn't show hand 
*** SUMMARY ***
Total pot €0.18 | Rake €0.01 
Board [3h Ad Kh Tc]
Seat 1: grenha1972 (button) folded before Flop (didn't bet)
Seat 2: yunblvck (small blind) folded on the Turn
Seat 3: pipinoelbreve9 (big blind) folded on the Flop
Seat 4: V1e4ra folded before Flop (didn't bet)
Seat 5: jean2525 collected (€0.17)
Seat 6: JAQKKK folded before Flop (didn't bet)



PokerStars Zoom Hand #257663081988:  Hold'em No Limit (€0.01/€0.02) - 2025/09/08 18:34:34 CET [2025/09/08 12:34:34 ET]
Table 'Arneb' 6-max Seat #1 is the button
Seat 1: guizzado16 (€6.86 in chips) 
Seat 2: jean2525 (€2.38 in chips) 
Seat 3: V1e4ra (€2.08 in chips) 
Seat 4: BestiaESP12 (€2.35 in chips) 
Seat 5: JAQKKK (€2.16 in chips) 
Seat 6: pipinoelbreve9 (€4.60 in chips) 
jean2525: posts small blind €0.01
V1e4ra: posts big blind €0.02
*** HOLE CARDS ***
Dealt to pipinoelbreve9 [Kc 4c]
BestiaESP12: folds 
JAQKKK: folds 
pipinoelbreve9: folds 
guizzado16: folds 
jean2525: folds 
Uncalled bet (€0.01) returned to V1e4ra
V1e4ra collected €0.02 from pot
V1e4ra: doesn't show hand 
*** SUMMARY ***
Total pot €0.02 | Rake €0 
Seat 1: guizzado16 (button) folded before Flop (didn't bet)
Seat 2: jean2525 (small blind) folded before Flop
Seat 3: V1e4ra (big blind) collected (€0.02)
Seat 4: BestiaESP12 folded before Flop (didn't bet)
Seat 5: JAQKKK folded before Flop (didn't bet)
Seat 6: pipinoelbreve9 folded before Flop (didn't bet)



PokerStars Zoom Hand #257663082900:  Hold'em No Limit (€0.01/€0.02) - 2025/09/08 18:34:38 CET [2025/09/08 12:34:38 ET]
Table 'Arneb' 6-max Seat #1 is the button
Seat 1: Doblea315 (€3.74 in chips) 
Seat 2: Lucian Morel (€1.93 in chips) 
Seat 3: Racinguis248 (€2.06 in chips) 
Seat 4: pipinoelbreve9 (€4.60 in chips) 
Seat 5: embidoall (€3.55 in chips) 
Seat 6: kombei63 (€1.57 in chips) 
Lucian Morel: posts small blind €0.01
Racinguis248: posts big blind €0.02
*** HOLE CARDS ***
Dealt to pipinoelbreve9 [8s Qd]
pipinoelbreve9: folds 
embidoall: raises €0.02 to €0.04
kombei63: folds 
Doblea315: folds 
Lucian Morel: folds 
Racinguis248: folds 
Uncalled bet (€0.02) returned to embidoall
embidoall collected €0.05 from pot
embidoall: doesn't show hand 
*** SUMMARY ***
Total pot €0.05 | Rake €0 
Seat 1: Doblea315 (button) folded before Flop (didn't bet)
Seat 2: Lucian Morel (small blind) folded before Flop
Seat 3: Racinguis248 (big blind) folded before Flop
Seat 4: pipinoelbreve9 folded before Flop (didn't bet)
Seat 5: embidoall collected (€0.05)
Seat 6: kombei63 folded before Flop (didn't bet)



PokerStars Zoom Hand #257663083576:  Hold'em No Limit (€0.01/€0.02) - 2025/09/08 18:34:42 CET [2025/09/08 12:34:42 ET]
Table 'Arneb' 6-max Seat #1 is the button
Seat 1: Ruben1990869 (€2 in chips) 
Seat 2: pipinoelbreve9 (€4.60 in chips) 
Seat 3: JENOFONTE73 (€2.63 in chips) 
Seat 4: black_dad23 (€0.38 in chips) 
Seat 5: jean2525 (€2.37 in chips) 
Seat 6: rccmonteiro27 (€3.33 in chips) 
pipinoelbreve9: posts small blind €0.01
JENOFONTE73: posts big blind €0.02
*** HOLE CARDS ***
Dealt to pipinoelbreve9 [Ts 4h]
black_dad23: folds 
jean2525: folds 
rccmonteiro27: raises €0.04 to €0.06
Ruben1990869: folds 
pipinoelbreve9: folds 
JENOFONTE73: folds 
Uncalled bet (€0.04) returned to rccmonteiro27
rccmonteiro27 collected €0.05 from pot
rccmonteiro27: doesn't show hand 
*** SUMMARY ***
Total pot €0.05 | Rake €0 
Seat 1: Ruben1990869 (button) folded before Flop (didn't bet)
Seat 2: pipinoelbreve9 (small blind) folded before Flop
Seat 3: JENOFONTE73 (big blind) folded before Flop
Seat 4: black_dad23 folded before Flop (didn't bet)
Seat 5: jean2525 folded before Flop (didn't bet)
Seat 6: rccmonteiro27 collected (€0.05)



PokerStars Zoom Hand #257663084505:  Hold'em No Limit (€0.01/€0.02) - 2025/09/08 18:34:46 CET [2025/09/08 12:34:46 ET]
Table 'Arneb' 6-max Seat #1 is the button
Seat 1: pipinoelbreve9 (€4.59 in chips) 
Seat 2: typh00n27 (€2.45 in chips) 
Seat 3: jean2525 (€2.37 in chips) 
Seat 4: Ferchyman77 (€2.08 in chips) 
Seat 5: guizzado16 (€6.86 in chips) 
Seat 6: DavSnook (€3.21 in chips) 
typh00n27: posts small blind €0.01
jean2525: posts big blind €0.02
*** HOLE CARDS ***
Dealt to pipinoelbreve9 [Ad 2h]
Ferchyman77: folds 
guizzado16: folds 
DavSnook: folds 
pipinoelbreve9: raises €0.04 to €0.06
typh00n27: folds 
jean2525: calls €0.04
*** FLOP *** [6c Kd 3s]
jean2525: checks 
pipinoelbreve9: bets €0.04
jean2525: raises €0.20 to €0.24
pipinoelbreve9: folds 
Uncalled bet (€0.20) returned to jean2525
jean2525 collected €0.20 from pot
jean2525: doesn't show hand 
*** SUMMARY ***
Total pot €0.21 | Rake €0.01 
Board [6c Kd 3s]
Seat 1: pipinoelbreve9 (button) folded on the Flop
Seat 2: typh00n27 (small blind) folded before Flop
Seat 3: jean2525 (big blind) collected (€0.20)
Seat 4: Ferchyman77 folded before Flop (didn't bet)
Seat 5: guizzado16 folded before Flop (didn't bet)
Seat 6: DavSnook folded before Flop (didn't bet)



