PokerStars Zoom Hand #257688882857:  Hold'em No Limit (€0.01/€0.02) - 2025/09/10 17:45:57 CET [2025/09/10 11:45:57 ET]
Table 'Arneb' 6-max Seat #1 is the button
Seat 1: Abrelatas787 (€3.18 in chips) 
Seat 2: soyeterno (€1.80 in chips) 
Seat 3: pipinoelbreve9 (€2 in chips) 
Seat 4: easywithnuts84 (€2 in chips) 
Seat 5: alcalde19 (€1.22 in chips) 
Seat 6: So4ar (€2.95 in chips) 
soyeterno: posts small blind €0.01
pipinoelbreve9: posts big blind €0.02
*** HOLE CARDS ***
Dealt to pipinoelbreve9 [Qs As]
easywithnuts84 has timed out
easywithnuts84: folds 
alcalde19: folds 
So4ar: folds 
Abrelatas787: raises €0.04 to €0.06
soyeterno: folds 
pipinoelbreve9: raises €0.12 to €0.18
Abrelatas787: folds 
Uncalled bet (€0.12) returned to pipinoelbreve9
pipinoelbreve9 collected €0.13 from pot
pipinoelbreve9: doesn't show hand 
*** SUMMARY ***
Total pot €0.13 | Rake €0 
Seat 1: Abrelatas787 (button) folded before Flop
Seat 2: soyeterno (small blind) folded before Flop
Seat 3: pipinoelbreve9 (big blind) collected (€0.13)
Seat 4: easywithnuts84 folded before Flop (didn't bet)
Seat 5: alcalde19 folded before Flop (didn't bet)
Seat 6: So4ar folded before Flop (didn't bet)



PokerStars Zoom Hand #257688889420:  Hold'em No Limit (€0.01/€0.02) - 2025/09/10 17:46:33 CET [2025/09/10 11:46:33 ET]
Table 'Arneb' 6-max Seat #1 is the button
Seat 1: jeannono24 (€2 in chips) 
Seat 2: orosa (€2 in chips) 
Seat 3: DavSnook (€2.17 in chips) 
Seat 4: MDKristian (€2.19 in chips) 
Seat 5: pipinoelbreve9 (€2.06 in chips) 
Seat 6: pastor2611 (€1.93 in chips) 
orosa: posts small blind €0.01
DavSnook: posts big blind €0.02
*** HOLE CARDS ***
Dealt to pipinoelbreve9 [4c 7s]
MDKristian: folds 
pipinoelbreve9: folds 
pastor2611: raises €0.04 to €0.06
jeannono24: folds 
orosa: folds 
DavSnook: calls €0.04
*** FLOP *** [8d Qs 9s]
DavSnook: checks 
pastor2611: bets €0.06
DavSnook: raises €0.12 to €0.18
pastor2611: calls €0.12
*** TURN *** [8d Qs 9s] [9d]
DavSnook: bets €0.24
pastor2611: calls €0.24
*** RIVER *** [8d Qs 9s 9d] [7c]
DavSnook: bets €0.46
pastor2611: calls €0.46
*** SHOW DOWN ***
DavSnook: shows [Th Jc] (a straight, Eight to Queen)
pastor2611: mucks hand 
DavSnook collected €1.80 from pot
*** SUMMARY ***
Total pot €1.89 | Rake €0.09 
Board [8d Qs 9s 9d 7c]
Seat 1: jeannono24 (button) folded before Flop (didn't bet)
Seat 2: orosa (small blind) folded before Flop
Seat 3: DavSnook (big blind) showed [Th Jc] and won (€1.80) with a straight, Eight to Queen
Seat 4: MDKristian folded before Flop (didn't bet)
Seat 5: pipinoelbreve9 folded before Flop (didn't bet)
Seat 6: pastor2611 mucked [Tc Qc]



PokerStars Zoom Hand #257688890341:  Hold'em No Limit (€0.01/€0.02) - 2025/09/10 17:46:39 CET [2025/09/10 11:46:39 ET]
Table 'Arneb' 6-max Seat #1 is the button
Seat 1: pipinoelbreve9 (€2.06 in chips) 
Seat 2: DavSnook (€2.56 in chips) 
Seat 3: Hotspot9119 (€3.50 in chips) 
Seat 4: malmeto45 (€2.03 in chips) 
Seat 5: smrj1976 (€3.47 in chips) 
Seat 6: euse383 (€4.05 in chips) 
DavSnook: posts small blind €0.01
Hotspot9119: posts big blind €0.02
*** HOLE CARDS ***
Dealt to pipinoelbreve9 [7d As]
malmeto45: folds 
smrj1976: folds 
euse383: folds 
pipinoelbreve9: raises €0.04 to €0.06
DavSnook: folds 
Hotspot9119: raises €0.18 to €0.24
pipinoelbreve9: folds 
Uncalled bet (€0.18) returned to Hotspot9119
Hotspot9119 collected €0.13 from pot
Hotspot9119: doesn't show hand 
*** SUMMARY ***
Total pot €0.13 | Rake €0 
Seat 1: pipinoelbreve9 (button) folded before Flop
Seat 2: DavSnook (small blind) folded before Flop
Seat 3: Hotspot9119 (big blind) collected (€0.13)
Seat 4: malmeto45 folded before Flop (didn't bet)
Seat 5: smrj1976 folded before Flop (didn't bet)
Seat 6: euse383 folded before Flop (didn't bet)



PokerStars Zoom Hand #257688888464:  Hold'em No Limit (€0.01/€0.02) - 2025/09/10 17:46:28 CET [2025/09/10 11:46:28 ET]
Table 'Arneb' 6-max Seat #1 is the button
Seat 1: blout-blout (€1.75 in chips) 
Seat 2: pipinoelbreve9 (€2.07 in chips) 
Seat 3: Ruben1990869 (€2.37 in chips) 
Seat 4: raptureman1 (€2 in chips) 
Seat 5: Natesprr (€0.18 in chips) 
Seat 6: Siddharta33 (€1.07 in chips) 
pipinoelbreve9: posts small blind €0.01
Ruben1990869: posts big blind €0.02
*** HOLE CARDS ***
Dealt to pipinoelbreve9 [5h 2h]
raptureman1: folds 
Natesprr: folds 
Siddharta33: folds 
blout-blout: calls €0.02
pipinoelbreve9: folds 
Ruben1990869: raises €0.08 to €0.10
blout-blout: calls €0.08
*** FLOP *** [4d 3d 4c]
Ruben1990869: checks 
blout-blout: checks 
*** TURN *** [4d 3d 4c] [Kc]
Ruben1990869: checks 
blout-blout: checks 
*** RIVER *** [4d 3d 4c Kc] [6h]
Ruben1990869: bets €0.15
blout-blout: folds 
Uncalled bet (€0.15) returned to Ruben1990869
Ruben1990869 collected €0.20 from pot
Ruben1990869: doesn't show hand 
*** SUMMARY ***
Total pot €0.21 | Rake €0.01 
Board [4d 3d 4c Kc 6h]
Seat 1: blout-blout (button) folded on the River
Seat 2: pipinoelbreve9 (small blind) folded before Flop
Seat 3: Ruben1990869 (big blind) collected (€0.20)
Seat 4: raptureman1 folded before Flop (didn't bet)
Seat 5: Natesprr folded before Flop (didn't bet)
Seat 6: Siddharta33 folded before Flop (didn't bet)



PokerStars Zoom Hand #257688896272:  Hold'em No Limit (€0.01/€0.02) - 2025/09/10 17:47:10 CET [2025/09/10 11:47:10 ET]
Table 'Arneb' 6-max Seat #1 is the button
Seat 1: CORDEVIGO (€2.97 in chips) 
Seat 2: claret505 (€1.39 in chips) 
Seat 3: Doblea315 (€2.33 in chips) 
Seat 4: jeannono24 (€2.10 in chips) 
Seat 5: Crubiov_1978 (€1.90 in chips) 
Seat 6: pipinoelbreve9 (€2 in chips) 
claret505: posts small blind €0.01
Doblea315: posts big blind €0.02
*** HOLE CARDS ***
Dealt to pipinoelbreve9 [Th 9s]
jeannono24: folds 
Crubiov_1978: folds 
pipinoelbreve9: folds 
CORDEVIGO: folds 
claret505: folds 
Uncalled bet (€0.01) returned to Doblea315
Doblea315 collected €0.02 from pot
Doblea315: doesn't show hand 
*** SUMMARY ***
Total pot €0.02 | Rake €0 
Seat 1: CORDEVIGO (button) folded before Flop (didn't bet)
Seat 2: claret505 (small blind) folded before Flop
Seat 3: Doblea315 (big blind) collected (€0.02)
Seat 4: jeannono24 folded before Flop (didn't bet)
Seat 5: Crubiov_1978 folded before Flop (didn't bet)
Seat 6: pipinoelbreve9 folded before Flop (didn't bet)



PokerStars Zoom Hand #257688898069:  Hold'em No Limit (€0.01/€0.02) - 2025/09/10 17:47:21 CET [2025/09/10 11:47:21 ET]
Table 'Arneb' 6-max Seat #1 is the button
Seat 1: spiritwarrior29 (€2.56 in chips) 
Seat 2: pipinoelbreve9 (€2 in chips) 
Seat 3: alvlugom (€2.10 in chips) 
Seat 4: euse383 (€4.65 in chips) 
Seat 5: soyeterno (€3.53 in chips) 
Seat 6: Crubiov_1978 (€1.90 in chips) 
pipinoelbreve9: posts small blind €0.01
alvlugom: posts big blind €0.02
*** HOLE CARDS ***
Dealt to pipinoelbreve9 [Kc Qd]
euse383: raises €0.02 to €0.04
soyeterno: folds 
Crubiov_1978: calls €0.04
spiritwarrior29: folds 
pipinoelbreve9: calls €0.03
alvlugom: folds 
*** FLOP *** [3d Tc 3h]
pipinoelbreve9: checks 
euse383: checks 
Crubiov_1978: bets €0.02
pipinoelbreve9: calls €0.02
euse383: calls €0.02
*** TURN *** [3d Tc 3h] [Qc]
pipinoelbreve9: checks 
euse383: checks 
Crubiov_1978: checks 
*** RIVER *** [3d Tc 3h Qc] [4d]
pipinoelbreve9: bets €0.10
euse383: folds 
Crubiov_1978: folds 
Uncalled bet (€0.10) returned to pipinoelbreve9
pipinoelbreve9 collected €0.19 from pot
pipinoelbreve9: doesn't show hand 
*** SUMMARY ***
Total pot €0.20 | Rake €0.01 
Board [3d Tc 3h Qc 4d]
Seat 1: spiritwarrior29 (button) folded before Flop (didn't bet)
Seat 2: pipinoelbreve9 (small blind) collected (€0.19)
Seat 3: alvlugom (big blind) folded before Flop
Seat 4: euse383 folded on the River
Seat 5: soyeterno folded before Flop (didn't bet)
Seat 6: Crubiov_1978 folded on the River



PokerStars Zoom Hand #257688905627:  Hold'em No Limit (€0.01/€0.02) - 2025/09/10 17:48:01 CET [2025/09/10 11:48:01 ET]
Table 'Arneb' 6-max Seat #1 is the button
Seat 1: orosa (€2.39 in chips) 
Seat 2: DavSnook (€4.30 in chips) 
Seat 3: pipinoelbreve9 (€2.13 in chips) 
Seat 4: Ruben1990869 (€2.04 in chips) 
Seat 5: Siddharta33 (€1.05 in chips) 
Seat 6: danitorpedo (€1.09 in chips) 
DavSnook: posts small blind €0.01
pipinoelbreve9: posts big blind €0.02
*** HOLE CARDS ***
Dealt to pipinoelbreve9 [9c 3d]
Ruben1990869: folds 
Siddharta33: folds 
danitorpedo: folds 
orosa: raises €0.04 to €0.06
DavSnook: folds 
pipinoelbreve9: folds 
Uncalled bet (€0.04) returned to orosa
orosa collected €0.05 from pot
orosa: doesn't show hand 
*** SUMMARY ***
Total pot €0.05 | Rake €0 
Seat 1: orosa (button) collected (€0.05)
Seat 2: DavSnook (small blind) folded before Flop
Seat 3: pipinoelbreve9 (big blind) folded before Flop
Seat 4: Ruben1990869 folded before Flop (didn't bet)
Seat 5: Siddharta33 folded before Flop (didn't bet)
Seat 6: danitorpedo folded before Flop (didn't bet)



PokerStars Zoom Hand #257688908528:  Hold'em No Limit (€0.01/€0.02) - 2025/09/10 17:48:17 CET [2025/09/10 11:48:17 ET]
Table 'Arneb' 6-max Seat #1 is the button
Seat 1: spiritwarrior29 (€2.10 in chips) 
Seat 2: Doblea315 (€2.40 in chips) 
Seat 3: Siddharta33 (€1.05 in chips) 
Seat 4: orosa (€2.42 in chips) 
Seat 5: pucelazo (€2.15 in chips) 
Seat 6: pipinoelbreve9 (€2.11 in chips) 
Doblea315: posts small blind €0.01
Siddharta33: posts big blind €0.02
*** HOLE CARDS ***
Dealt to pipinoelbreve9 [3h Ad]
orosa: raises €0.04 to €0.06
pucelazo: folds 
pipinoelbreve9: folds 
spiritwarrior29: folds 
Doblea315: folds 
Siddharta33: folds 
Uncalled bet (€0.04) returned to orosa
orosa collected €0.05 from pot
orosa: doesn't show hand 
*** SUMMARY ***
Total pot €0.05 | Rake €0 
Seat 1: spiritwarrior29 (button) folded before Flop (didn't bet)
Seat 2: Doblea315 (small blind) folded before Flop
Seat 3: Siddharta33 (big blind) folded before Flop
Seat 4: orosa collected (€0.05)
Seat 5: pucelazo folded before Flop (didn't bet)
Seat 6: pipinoelbreve9 folded before Flop (didn't bet)



PokerStars Zoom Hand #257688911024:  Hold'em No Limit (€0.01/€0.02) - 2025/09/10 17:48:31 CET [2025/09/10 11:48:31 ET]
Table 'Arneb' 6-max Seat #1 is the button
Seat 1: Siddharta33 (€1.04 in chips) 
Seat 2: Sportacus911 (€1.98 in chips) 
Seat 3: spiritwarrior29 (€2.57 in chips) 
Seat 4: pipinoelbreve9 (€2.11 in chips) 
Seat 5: eclipseto (€3.37 in chips) 
Seat 6: jumv (€2.46 in chips) 
Sportacus911: posts small blind €0.01
spiritwarrior29: posts big blind €0.02
*** HOLE CARDS ***
Dealt to pipinoelbreve9 [Td 3c]
pipinoelbreve9: folds 
eclipseto: folds 
jumv: folds 
Siddharta33: folds 
Sportacus911: folds 
Uncalled bet (€0.01) returned to spiritwarrior29
spiritwarrior29 collected €0.02 from pot
spiritwarrior29: doesn't show hand 
*** SUMMARY ***
Total pot €0.02 | Rake €0 
Seat 1: Siddharta33 (button) folded before Flop (didn't bet)
Seat 2: Sportacus911 (small blind) folded before Flop
Seat 3: spiritwarrior29 (big blind) collected (€0.02)
Seat 4: pipinoelbreve9 folded before Flop (didn't bet)
Seat 5: eclipseto folded before Flop (didn't bet)
Seat 6: jumv folded before Flop (didn't bet)



PokerStars Zoom Hand #257688911740:  Hold'em No Limit (€0.01/€0.02) - 2025/09/10 17:48:35 CET [2025/09/10 11:48:35 ET]
Table 'Arneb' 6-max Seat #1 is the button
Seat 1: jumv (€2.46 in chips) 
Seat 2: pipinoelbreve9 (€2.11 in chips) 
Seat 3: Andricap (€2 in chips) 
Seat 4: jeannono24 (€2 in chips) 
Seat 5: grao1 (€1.87 in chips) 
Seat 6: pucelay.29 (€1.05 in chips) 
pipinoelbreve9: posts small blind €0.01
Andricap: posts big blind €0.02
*** HOLE CARDS ***
Dealt to pipinoelbreve9 [6h Tc]
jeannono24: folds 
grao1: raises €0.02 to €0.04
pucelay.29: folds 
jumv: folds 
pipinoelbreve9: folds 
Andricap: folds 
Uncalled bet (€0.02) returned to grao1
grao1 collected €0.05 from pot
grao1: doesn't show hand 
*** SUMMARY ***
Total pot €0.05 | Rake €0 
Seat 1: jumv (button) folded before Flop (didn't bet)
Seat 2: pipinoelbreve9 (small blind) folded before Flop
Seat 3: Andricap (big blind) folded before Flop
Seat 4: jeannono24 folded before Flop (didn't bet)
Seat 5: grao1 collected (€0.05)
Seat 6: pucelay.29 folded before Flop (didn't bet)



PokerStars Zoom Hand #257688909893:  Hold'em No Limit (€0.01/€0.02) - 2025/09/10 17:48:25 CET [2025/09/10 11:48:25 ET]
Table 'Arneb' 6-max Seat #1 is the button
Seat 1: Siddharta33 (€1.80 in chips) 
Seat 2: claret505 (€1.49 in chips) 
Seat 3: pucelazo (€2.53 in chips) 
Seat 4: SMN242 (€2.83 in chips) 
Seat 5: pipinoelbreve9 (€2.11 in chips) 
Seat 6: XxVallesxX (€2.38 in chips) 
claret505: posts small blind €0.01
pucelazo: posts big blind €0.02
*** HOLE CARDS ***
Dealt to pipinoelbreve9 [4h Jh]
SMN242: folds 
pipinoelbreve9: folds 
XxVallesxX: folds 
Siddharta33: calls €0.02
claret505: folds 
pucelazo: checks 
*** FLOP *** [5s Jd 3s]
pucelazo: checks 
Siddharta33: bets €0.04
pucelazo: folds 
Uncalled bet (€0.04) returned to Siddharta33
Siddharta33 collected €0.05 from pot
Siddharta33: doesn't show hand 
*** SUMMARY ***
Total pot €0.05 | Rake €0 
Board [5s Jd 3s]
Seat 1: Siddharta33 (button) collected (€0.05)
Seat 2: claret505 (small blind) folded before Flop
Seat 3: pucelazo (big blind) folded on the Flop
Seat 4: SMN242 folded before Flop (didn't bet)
Seat 5: pipinoelbreve9 folded before Flop (didn't bet)
Seat 6: XxVallesxX folded before Flop (didn't bet)



PokerStars Zoom Hand #257688907326:  Hold'em No Limit (€0.01/€0.02) - 2025/09/10 17:48:11 CET [2025/09/10 11:48:11 ET]
Table 'Arneb' 6-max Seat #1 is the button
Seat 1: pastor2611 (€0.86 in chips) 
Seat 2: SMN242 (€2.84 in chips) 
Seat 3: MDKristian (€2 in chips) 
Seat 4: pipinoelbreve9 (€2.11 in chips) 
Seat 5: jeannono24 (€2.10 in chips) 
Seat 6: Roixo1 (€2.80 in chips) 
SMN242: posts small blind €0.01
MDKristian: posts big blind €0.02
*** HOLE CARDS ***
Dealt to pipinoelbreve9 [4s 8d]
pipinoelbreve9: folds 
jeannono24: folds 
Roixo1: folds 
pastor2611: raises €0.04 to €0.06
SMN242: folds 
MDKristian: calls €0.04
*** FLOP *** [5c 9h 7c]
MDKristian: checks 
pastor2611: bets €0.06
MDKristian: calls €0.06
*** TURN *** [5c 9h 7c] [Kd]
MDKristian: checks 
pastor2611: bets €0.14
MDKristian: calls €0.14
*** RIVER *** [5c 9h 7c Kd] [Jc]
MDKristian: checks 
pastor2611: checks 
*** SHOW DOWN ***
MDKristian: shows [Jd 9d] (two pair, Jacks and Nines)
pastor2611: mucks hand 
MDKristian collected €0.50 from pot
*** SUMMARY ***
Total pot €0.53 | Rake €0.03 
Board [5c 9h 7c Kd Jc]
Seat 1: pastor2611 (button) mucked [6c 7h]
Seat 2: SMN242 (small blind) folded before Flop
Seat 3: MDKristian (big blind) showed [Jd 9d] and won (€0.50) with two pair, Jacks and Nines
Seat 4: pipinoelbreve9 folded before Flop (didn't bet)
Seat 5: jeannono24 folded before Flop (didn't bet)
Seat 6: Roixo1 folded before Flop (didn't bet)



PokerStars Zoom Hand #257688914494:  Hold'em No Limit (€0.01/€0.02) - 2025/09/10 17:48:50 CET [2025/09/10 11:48:50 ET]
Table 'Arneb' 6-max Seat #1 is the button
Seat 1: orosa (€2.42 in chips) 
Seat 2: pucelay.29 (€1.05 in chips) 
Seat 3: pipinoelbreve9 (€2.10 in chips) 
Seat 4: QUIQUE JONES (€0.87 in chips) 
Seat 5: SRsergio31 (€1.73 in chips) 
Seat 6: Alejandr_666 (€2.32 in chips) 
pucelay.29: posts small blind €0.01
pipinoelbreve9: posts big blind €0.02
*** HOLE CARDS ***
Dealt to pipinoelbreve9 [Jc 6c]
QUIQUE JONES: folds 
SRsergio31: raises €0.04 to €0.06
Alejandr_666: folds 
orosa: folds 
pucelay.29: folds 
pipinoelbreve9: calls €0.04
*** FLOP *** [3s 7d 8c]
pipinoelbreve9: checks 
SRsergio31: checks 
*** TURN *** [3s 7d 8c] [Jh]
pipinoelbreve9: bets €0.06
SRsergio31: raises €0.06 to €0.12
pipinoelbreve9: calls €0.06
*** RIVER *** [3s 7d 8c Jh] [4s]
pipinoelbreve9: checks 
SRsergio31: checks 
*** SHOW DOWN ***
pipinoelbreve9: shows [Jc 6c] (a pair of Jacks)
SRsergio31: mucks hand 
pipinoelbreve9 collected €0.35 from pot
*** SUMMARY ***
Total pot €0.37 | Rake €0.02 
Board [3s 7d 8c Jh 4s]
Seat 1: orosa (button) folded before Flop (didn't bet)
Seat 2: pucelay.29 (small blind) folded before Flop
Seat 3: pipinoelbreve9 (big blind) showed [Jc 6c] and won (€0.35) with a pair of Jacks
Seat 4: QUIQUE JONES folded before Flop (didn't bet)
Seat 5: SRsergio31 mucked [7h Ah]
Seat 6: Alejandr_666 folded before Flop (didn't bet)



PokerStars Zoom Hand #257688908044:  Hold'em No Limit (€0.01/€0.02) - 2025/09/10 17:48:15 CET [2025/09/10 11:48:15 ET]
Table 'Arneb' 6-max Seat #1 is the button
Seat 1: pipinoelbreve9 (€2.11 in chips) 
Seat 2: alvlugom (€2.05 in chips) 
Seat 3: ssjimmyss88 (€2.19 in chips) 
Seat 4: jeannono24 (€2.10 in chips) 
Seat 5: wendyd27 (€2.31 in chips) 
Seat 6: orosa (€2 in chips) 
alvlugom: posts small blind €0.01
ssjimmyss88: posts big blind €0.02
*** HOLE CARDS ***
Dealt to pipinoelbreve9 [7s 2s]
jeannono24: folds 
wendyd27: calls €0.02
orosa: folds 
pipinoelbreve9: folds 
alvlugom: raises €0.03 to €0.05
ssjimmyss88: calls €0.03
wendyd27: calls €0.03
*** FLOP *** [Jh 9d 9c]
alvlugom: checks 
ssjimmyss88: checks 
wendyd27: checks 
*** TURN *** [Jh 9d 9c] [9h]
alvlugom: checks 
ssjimmyss88: bets €0.02
wendyd27: calls €0.02
alvlugom: folds 
*** RIVER *** [Jh 9d 9c 9h] [Qh]
ssjimmyss88: bets €0.09
wendyd27: calls €0.09
*** SHOW DOWN ***
ssjimmyss88: shows [9s 5s] (four of a kind, Nines)
wendyd27: mucks hand 
ssjimmyss88 collected €0.35 from pot
*** SUMMARY ***
Total pot €0.37 | Rake €0.02 
Board [Jh 9d 9c 9h Qh]
Seat 1: pipinoelbreve9 (button) folded before Flop (didn't bet)
Seat 2: alvlugom (small blind) folded on the Turn
Seat 3: ssjimmyss88 (big blind) showed [9s 5s] and won (€0.35) with four of a kind, Nines
Seat 4: jeannono24 folded before Flop (didn't bet)
Seat 5: wendyd27 mucked [Td Kh]
Seat 6: orosa folded before Flop (didn't bet)



PokerStars Zoom Hand #257688921475:  Hold'em No Limit (€0.01/€0.02) - 2025/09/10 17:49:27 CET [2025/09/10 11:49:27 ET]
Table 'Arneb' 6-max Seat #1 is the button
Seat 1: pipinoelbreve9 (€2.27 in chips) 
Seat 2: Ruben1990869 (€2.07 in chips) 
Seat 3: soyeterno (€3.29 in chips) 
Seat 4: Dood Francisco (€2.44 in chips) 
Seat 5: Doblea315 (€2.14 in chips) 
Seat 6: Siddharta33 (€1.01 in chips) 
Ruben1990869: posts small blind €0.01
soyeterno: posts big blind €0.02
*** HOLE CARDS ***
Dealt to pipinoelbreve9 [Qd Qs]
Dood Francisco: folds 
Doblea315: folds 
Siddharta33: folds 
pipinoelbreve9: raises €0.04 to €0.06
Ruben1990869: folds 
soyeterno: folds 
Uncalled bet (€0.04) returned to pipinoelbreve9
pipinoelbreve9 collected €0.05 from pot
pipinoelbreve9: doesn't show hand 
*** SUMMARY ***
Total pot €0.05 | Rake €0 
Seat 1: pipinoelbreve9 (button) collected (€0.05)
Seat 2: Ruben1990869 (small blind) folded before Flop
Seat 3: soyeterno (big blind) folded before Flop
Seat 4: Dood Francisco folded before Flop (didn't bet)
Seat 5: Doblea315 folded before Flop (didn't bet)
Seat 6: Siddharta33 folded before Flop (didn't bet)



PokerStars Zoom Hand #257688924011:  Hold'em No Limit (€0.01/€0.02) - 2025/09/10 17:49:41 CET [2025/09/10 11:49:41 ET]
Table 'Arneb' 6-max Seat #1 is the button
Seat 1: Andricap (€1.97 in chips) 
Seat 2: alvlugom (€1.62 in chips) 
Seat 3: Sportacus911 (€2.01 in chips) 
Seat 4: easywithnuts84 (€1.99 in chips) 
Seat 5: marcel13013 (€0.88 in chips) 
Seat 6: pipinoelbreve9 (€2.30 in chips) 
alvlugom: posts small blind €0.01
Sportacus911: posts big blind €0.02
*** HOLE CARDS ***
Dealt to pipinoelbreve9 [9h 4c]
easywithnuts84: folds 
marcel13013: calls €0.02
pipinoelbreve9: folds 
Andricap: raises €0.08 to €0.10
alvlugom: folds 
Sportacus911: folds 
marcel13013: calls €0.08
*** FLOP *** [6s 6c 9d]
marcel13013: checks 
Andricap: bets €0.11
marcel13013: folds 
Uncalled bet (€0.11) returned to Andricap
Andricap collected €0.22 from pot
Andricap: doesn't show hand 
*** SUMMARY ***
Total pot €0.23 | Rake €0.01 
Board [6s 6c 9d]
Seat 1: Andricap (button) collected (€0.22)
Seat 2: alvlugom (small blind) folded before Flop
Seat 3: Sportacus911 (big blind) folded before Flop
Seat 4: easywithnuts84 folded before Flop (didn't bet)
Seat 5: marcel13013 folded on the Flop
Seat 6: pipinoelbreve9 folded before Flop (didn't bet)



PokerStars Zoom Hand #257688925293:  Hold'em No Limit (€0.01/€0.02) - 2025/09/10 17:49:48 CET [2025/09/10 11:49:48 ET]
Table 'Arneb' 6-max Seat #1 is the button
Seat 1: XxVallesxX (€2.38 in chips) 
Seat 2: Sportacus911 (€1.92 in chips) 
Seat 3: Crubiov_1978 (€1.37 in chips) 
Seat 4: orosa (€2 in chips) 
Seat 5: pipinoelbreve9 (€2.30 in chips) 
Seat 6: soyeterno (€3.27 in chips) 
Sportacus911: posts small blind €0.01
Crubiov_1978: posts big blind €0.02
*** HOLE CARDS ***
Dealt to pipinoelbreve9 [Ah 3h]
orosa: folds 
pipinoelbreve9: raises €0.04 to €0.06
soyeterno: calls €0.06
XxVallesxX: raises €0.12 to €0.18
Sportacus911: folds 
Crubiov_1978: folds 
pipinoelbreve9: calls €0.12
soyeterno: calls €0.12
*** FLOP *** [8c Kh 9h]
pipinoelbreve9: checks 
soyeterno: checks 
XxVallesxX: checks 
*** TURN *** [8c Kh 9h] [6d]
pipinoelbreve9: bets €0.27
soyeterno: calls €0.27
XxVallesxX: folds 
*** RIVER *** [8c Kh 9h 6d] [7s]
pipinoelbreve9: checks 
soyeterno: checks 
*** SHOW DOWN ***
pipinoelbreve9: shows [Ah 3h] (high card Ace)
soyeterno: shows [Qd Kd] (a pair of Kings)
soyeterno collected €1.05 from pot
*** SUMMARY ***
Total pot €1.11 | Rake €0.06 
Board [8c Kh 9h 6d 7s]
Seat 1: XxVallesxX (button) folded on the Turn
Seat 2: Sportacus911 (small blind) folded before Flop
Seat 3: Crubiov_1978 (big blind) folded before Flop
Seat 4: orosa folded before Flop (didn't bet)
Seat 5: pipinoelbreve9 showed [Ah 3h] and lost with high card Ace
Seat 6: soyeterno showed [Qd Kd] and won (€1.05) with a pair of Kings



PokerStars Zoom Hand #257688934291:  Hold'em No Limit (€0.01/€0.02) - 2025/09/10 17:50:37 CET [2025/09/10 11:50:37 ET]
Table 'Arneb' 6-max Seat #1 is the button
Seat 1: wolff97x (€3.80 in chips) 
Seat 2: Doblea315 (€2.30 in chips) 
Seat 3: ssjimmyss88 (€2.41 in chips) 
Seat 4: PARAG00MBA (€2 in chips) 
Seat 5: MDKristian (€2 in chips) 
Seat 6: pipinoelbreve9 (€2 in chips) 
Doblea315: posts small blind €0.01
ssjimmyss88: posts big blind €0.02
*** HOLE CARDS ***
Dealt to pipinoelbreve9 [7s 8h]
PARAG00MBA: folds 
MDKristian: folds 
pipinoelbreve9: folds 
wolff97x: raises €0.02 to €0.04
Doblea315: folds 
ssjimmyss88: folds 
Uncalled bet (€0.02) returned to wolff97x
wolff97x collected €0.05 from pot
wolff97x: doesn't show hand 
*** SUMMARY ***
Total pot €0.05 | Rake €0 
Seat 1: wolff97x (button) collected (€0.05)
Seat 2: Doblea315 (small blind) folded before Flop
Seat 3: ssjimmyss88 (big blind) folded before Flop
Seat 4: PARAG00MBA folded before Flop (didn't bet)
Seat 5: MDKristian folded before Flop (didn't bet)
Seat 6: pipinoelbreve9 folded before Flop (didn't bet)



PokerStars Zoom Hand #257688936138:  Hold'em No Limit (€0.01/€0.02) - 2025/09/10 17:50:47 CET [2025/09/10 11:50:47 ET]
Table 'Arneb' 6-max Seat #1 is the button
Seat 1: jeannono24 (€2.15 in chips) 
Seat 2: pucelazo (€2.57 in chips) 
Seat 3: Andricap (€2.07 in chips) 
Seat 4: pipinoelbreve9 (€2 in chips) 
Seat 5: mgkpitel (€2 in chips) 
Seat 6: ssjimmyss88 (€2.39 in chips) 
pucelazo: posts small blind €0.01
Andricap: posts big blind €0.02
*** HOLE CARDS ***
Dealt to pipinoelbreve9 [Qs Ts]
pipinoelbreve9: raises €0.04 to €0.06
mgkpitel: folds 
ssjimmyss88: folds 
jeannono24: folds 
pucelazo: folds 
Andricap: folds 
Uncalled bet (€0.04) returned to pipinoelbreve9
pipinoelbreve9 collected €0.05 from pot
pipinoelbreve9: doesn't show hand 
*** SUMMARY ***
Total pot €0.05 | Rake €0 
Seat 1: jeannono24 (button) folded before Flop (didn't bet)
Seat 2: pucelazo (small blind) folded before Flop
Seat 3: Andricap (big blind) folded before Flop
Seat 4: pipinoelbreve9 collected (€0.05)
Seat 5: mgkpitel folded before Flop (didn't bet)
Seat 6: ssjimmyss88 folded before Flop (didn't bet)



PokerStars Zoom Hand #257688935109:  Hold'em No Limit (€0.01/€0.02) - 2025/09/10 17:50:42 CET [2025/09/10 11:50:42 ET]
Table 'Arneb' 6-max Seat #1 is the button
Seat 1: pastor2611 (€0.88 in chips) 
Seat 2: allmike78 (€2.50 in chips) 
Seat 3: orosa (€2.35 in chips) 
Seat 4: MDKristian (€2 in chips) 
Seat 5: pipinoelbreve9 (€2 in chips) 
Seat 6: Çalo420 (€3.31 in chips) 
allmike78: posts small blind €0.01
orosa: posts big blind €0.02
*** HOLE CARDS ***
Dealt to pipinoelbreve9 [9c 7h]
MDKristian: folds 
pipinoelbreve9: folds 
Çalo420: calls €0.02
pastor2611: calls €0.02
allmike78: folds 
orosa: checks 
*** FLOP *** [8d 6c 3s]
orosa: checks 
Çalo420: checks 
pastor2611: bets €0.07
orosa: folds 
Çalo420: folds 
Uncalled bet (€0.07) returned to pastor2611
pastor2611 collected €0.07 from pot
pastor2611: doesn't show hand 
*** SUMMARY ***
Total pot €0.07 | Rake €0 
Board [8d 6c 3s]
Seat 1: pastor2611 (button) collected (€0.07)
Seat 2: allmike78 (small blind) folded before Flop
Seat 3: orosa (big blind) folded on the Flop
Seat 4: MDKristian folded before Flop (didn't bet)
Seat 5: pipinoelbreve9 folded before Flop (didn't bet)
Seat 6: Çalo420 folded on the Flop



PokerStars Zoom Hand #257688939735:  Hold'em No Limit (€0.01/€0.02) - 2025/09/10 17:51:07 CET [2025/09/10 11:51:07 ET]
Table 'Arneb' 6-max Seat #1 is the button
Seat 1: ssjimmyss88 (€2.38 in chips) 
Seat 2: smrj1976 (€1.45 in chips) 
Seat 3: pipinoelbreve9 (€2.03 in chips) 
Seat 4: Çalo420 (€3.29 in chips) 
Seat 5: eclipseto (€3.06 in chips) 
Seat 6: DavSnook (€2.81 in chips) 
smrj1976: posts small blind €0.01
pipinoelbreve9: posts big blind €0.02
*** HOLE CARDS ***
Dealt to pipinoelbreve9 [8h Kd]
Çalo420: folds 
eclipseto: raises €0.04 to €0.06
DavSnook: folds 
ssjimmyss88: folds 
smrj1976: folds 
pipinoelbreve9: calls €0.04
*** FLOP *** [8d 2h 2s]
pipinoelbreve9: checks 
eclipseto: checks 
*** TURN *** [8d 2h 2s] [6d]
pipinoelbreve9: bets €0.06
eclipseto: folds 
Uncalled bet (€0.06) returned to pipinoelbreve9
pipinoelbreve9 collected €0.12 from pot
pipinoelbreve9: doesn't show hand 
*** SUMMARY ***
Total pot €0.13 | Rake €0.01 
Board [8d 2h 2s 6d]
Seat 1: ssjimmyss88 (button) folded before Flop (didn't bet)
Seat 2: smrj1976 (small blind) folded before Flop
Seat 3: pipinoelbreve9 (big blind) collected (€0.12)
Seat 4: Çalo420 folded before Flop (didn't bet)
Seat 5: eclipseto folded on the Turn
Seat 6: DavSnook folded before Flop (didn't bet)



PokerStars Zoom Hand #257688943675:  Hold'em No Limit (€0.01/€0.02) - 2025/09/10 17:51:28 CET [2025/09/10 11:51:28 ET]
Table 'Arneb' 6-max Seat #1 is the button
Seat 1: alcalde19 (€3.80 in chips) 
Seat 2: pipinoelbreve9 (€2.09 in chips) 
Seat 3: jeannono24 (€2 in chips) 
Seat 4: DavSnook (€1.28 in chips) 
Seat 5: basurdia (€2.08 in chips) 
Seat 6: Doblea315 (€2.08 in chips) 
pipinoelbreve9: posts small blind €0.01
jeannono24: posts big blind €0.02
*** HOLE CARDS ***
Dealt to pipinoelbreve9 [3h 8h]
DavSnook: folds 
basurdia: folds 
Doblea315: folds 
alcalde19: folds 
pipinoelbreve9: folds 
Uncalled bet (€0.01) returned to jeannono24
jeannono24 collected €0.02 from pot
jeannono24: doesn't show hand 
*** SUMMARY ***
Total pot €0.02 | Rake €0 
Seat 1: alcalde19 (button) folded before Flop (didn't bet)
Seat 2: pipinoelbreve9 (small blind) folded before Flop
Seat 3: jeannono24 (big blind) collected (€0.02)
Seat 4: DavSnook folded before Flop (didn't bet)
Seat 5: basurdia folded before Flop (didn't bet)
Seat 6: Doblea315 folded before Flop (didn't bet)



PokerStars Zoom Hand #257688944285:  Hold'em No Limit (€0.01/€0.02) - 2025/09/10 17:51:31 CET [2025/09/10 11:51:31 ET]
Table 'Arneb' 6-max Seat #1 is the button
Seat 1: pipinoelbreve9 (€2.08 in chips) 
Seat 2: grao1 (€1.67 in chips) 
Seat 3: Hotspot9119 (€3.73 in chips) 
Seat 4: Siddharta33 (€1.11 in chips) 
Seat 5: Popins0011 (€2.50 in chips) 
Seat 6: Masticore1 (€1.97 in chips) 
grao1: posts small blind €0.01
Hotspot9119: posts big blind €0.02
*** HOLE CARDS ***
Dealt to pipinoelbreve9 [4d 9s]
Siddharta33: folds 
Popins0011: folds 
Masticore1: folds 
pipinoelbreve9: folds 
grao1: raises €0.02 to €0.04
Hotspot9119: calls €0.02
*** FLOP *** [3h 3d 5c]
grao1: checks 
Hotspot9119: bets €0.04
grao1: calls €0.04
*** TURN *** [3h 3d 5c] [Ad]
grao1: bets €0.08
Hotspot9119: folds 
Uncalled bet (€0.08) returned to grao1
grao1 collected €0.15 from pot
grao1: doesn't show hand 
*** SUMMARY ***
Total pot €0.16 | Rake €0.01 
Board [3h 3d 5c Ad]
Seat 1: pipinoelbreve9 (button) folded before Flop (didn't bet)
Seat 2: grao1 (small blind) collected (€0.15)
Seat 3: Hotspot9119 (big blind) folded on the Turn
Seat 4: Siddharta33 folded before Flop (didn't bet)
Seat 5: Popins0011 folded before Flop (didn't bet)
Seat 6: Masticore1 folded before Flop (didn't bet)



PokerStars Zoom Hand #257688947473:  Hold'em No Limit (€0.01/€0.02) - 2025/09/10 17:51:48 CET [2025/09/10 11:51:48 ET]
Table 'Arneb' 6-max Seat #1 is the button
Seat 1: orosa (€2.35 in chips) 
Seat 2: Doblea315 (€2.27 in chips) 
Seat 3: pipinoelbreve9 (€2.08 in chips) 
Seat 4: mgkpitel (€2.02 in chips) 
Seat 5: claret505 (€1.75 in chips) 
Seat 6: raptureman1 (€2.01 in chips) 
Doblea315: posts small blind €0.01
pipinoelbreve9: posts big blind €0.02
*** HOLE CARDS ***
Dealt to pipinoelbreve9 [Tc Ad]
mgkpitel: folds 
claret505: folds 
raptureman1: folds 
orosa: raises €0.04 to €0.06
Doblea315: folds 
pipinoelbreve9: raises €0.12 to €0.18
orosa: folds 
Uncalled bet (€0.12) returned to pipinoelbreve9
pipinoelbreve9 collected €0.13 from pot
pipinoelbreve9: doesn't show hand 
*** SUMMARY ***
Total pot €0.13 | Rake €0 
Seat 1: orosa (button) folded before Flop
Seat 2: Doblea315 (small blind) folded before Flop
Seat 3: pipinoelbreve9 (big blind) collected (€0.13)
Seat 4: mgkpitel folded before Flop (didn't bet)
Seat 5: claret505 folded before Flop (didn't bet)
Seat 6: raptureman1 folded before Flop (didn't bet)



PokerStars Zoom Hand #257688945258:  Hold'em No Limit (€0.01/€0.02) - 2025/09/10 17:51:36 CET [2025/09/10 11:51:36 ET]
Table 'Arneb' 6-max Seat #1 is the button
Seat 1: ssjimmyss88 (€0.36 in chips) 
Seat 2: CORDEVIGO (€5.57 in chips) 
Seat 3: orosa (€2 in chips) 
Seat 4: pipinoelbreve9 (€2.08 in chips) 
Seat 5: So4ar (€3.31 in chips) 
Seat 6: MDKristian (€2 in chips) 
CORDEVIGO: posts small blind €0.01
orosa: posts big blind €0.02
*** HOLE CARDS ***
Dealt to pipinoelbreve9 [5d 3d]
pipinoelbreve9: folds 
So4ar: folds 
MDKristian: folds 
ssjimmyss88: folds 
CORDEVIGO: folds 
Uncalled bet (€0.01) returned to orosa
orosa collected €0.02 from pot
orosa: doesn't show hand 
*** SUMMARY ***
Total pot €0.02 | Rake €0 
Seat 1: ssjimmyss88 (button) folded before Flop (didn't bet)
Seat 2: CORDEVIGO (small blind) folded before Flop
Seat 3: orosa (big blind) collected (€0.02)
Seat 4: pipinoelbreve9 folded before Flop (didn't bet)
Seat 5: So4ar folded before Flop (didn't bet)
Seat 6: MDKristian folded before Flop (didn't bet)



PokerStars Zoom Hand #257688946654:  Hold'em No Limit (€0.01/€0.02) - 2025/09/10 17:51:44 CET [2025/09/10 11:51:44 ET]
Table 'Arneb' 6-max Seat #1 is the button
Seat 1: wolff97x (€3.76 in chips) 
Seat 2: MDKristian (€2 in chips) 
Seat 3: Elons_Mucks (€2.12 in chips) 
Seat 4: pipinoelbreve9 (€2.08 in chips) 
Seat 5: OfTheBlonde (€2 in chips) 
Seat 6: Ruben1990869 (€2.02 in chips) 
MDKristian: posts small blind €0.01
Elons_Mucks: posts big blind €0.02
*** HOLE CARDS ***
Dealt to pipinoelbreve9 [9c 7h]
pipinoelbreve9: folds 
OfTheBlonde: folds 
Ruben1990869: folds 
wolff97x: folds 
MDKristian: raises €0.04 to €0.06
Elons_Mucks: calls €0.04
*** FLOP *** [5c 8h 3c]
MDKristian: checks 
Elons_Mucks: bets €0.04
MDKristian: calls €0.04
*** TURN *** [5c 8h 3c] [7d]
MDKristian: checks 
Elons_Mucks: bets €0.10
MDKristian: folds 
Uncalled bet (€0.10) returned to Elons_Mucks
Elons_Mucks collected €0.19 from pot
Elons_Mucks: doesn't show hand 
*** SUMMARY ***
Total pot €0.20 | Rake €0.01 
Board [5c 8h 3c 7d]
Seat 1: wolff97x (button) folded before Flop (didn't bet)
Seat 2: MDKristian (small blind) folded on the Turn
Seat 3: Elons_Mucks (big blind) collected (€0.19)
Seat 4: pipinoelbreve9 folded before Flop (didn't bet)
Seat 5: OfTheBlonde folded before Flop (didn't bet)
Seat 6: Ruben1990869 folded before Flop (didn't bet)



PokerStars Zoom Hand #257688951155:  Hold'em No Limit (€0.01/€0.02) - 2025/09/10 17:52:08 CET [2025/09/10 11:52:08 ET]
Table 'Arneb' 6-max Seat #1 is the button
Seat 1: OfTheBlonde (€2.03 in chips) 
Seat 2: pipinoelbreve9 (€2.15 in chips) 
Seat 3: Doblea315 (€2.26 in chips) 
Seat 4: MDKristian (€2.08 in chips) 
Seat 5: jeannono24 (€2.08 in chips) 
Seat 6: pucelazo (€2 in chips) 
pipinoelbreve9: posts small blind €0.01
Doblea315: posts big blind €0.02
*** HOLE CARDS ***
Dealt to pipinoelbreve9 [Qs 9h]
MDKristian: folds 
jeannono24: folds 
pucelazo: raises €0.04 to €0.06
OfTheBlonde: folds 
pipinoelbreve9: folds 
Doblea315: folds 
Uncalled bet (€0.04) returned to pucelazo
pucelazo collected €0.05 from pot
pucelazo: doesn't show hand 
*** SUMMARY ***
Total pot €0.05 | Rake €0 
Seat 1: OfTheBlonde (button) folded before Flop (didn't bet)
Seat 2: pipinoelbreve9 (small blind) folded before Flop
Seat 3: Doblea315 (big blind) folded before Flop
Seat 4: MDKristian folded before Flop (didn't bet)
Seat 5: jeannono24 folded before Flop (didn't bet)
Seat 6: pucelazo collected (€0.05)



PokerStars Zoom Hand #257688953529:  Hold'em No Limit (€0.01/€0.02) - 2025/09/10 17:52:22 CET [2025/09/10 11:52:22 ET]
Table 'Arneb' 6-max Seat #1 is the button
Seat 1: Sportacus911 (€2.04 in chips) 
Seat 2: orosa (€2.22 in chips) 
Seat 3: alcalde19 (€1.45 in chips) 
Seat 4: marcel13013 (€1.71 in chips) 
Seat 5: easywithnuts84 (€2.47 in chips) 
Seat 6: pipinoelbreve9 (€2.14 in chips) 
orosa: posts small blind €0.01
alcalde19: posts big blind €0.02
*** HOLE CARDS ***
Dealt to pipinoelbreve9 [Kh 4h]
marcel13013: folds 
easywithnuts84: folds 
pipinoelbreve9: raises €0.04 to €0.06
Sportacus911: folds 
orosa: folds 
alcalde19: calls €0.04
*** FLOP *** [Ad Tc Ks]
alcalde19: checks 
pipinoelbreve9: bets €0.10
alcalde19: calls €0.10
*** TURN *** [Ad Tc Ks] [Qd]
alcalde19: checks 
pipinoelbreve9: bets €0.31
alcalde19: raises €0.31 to €0.62
pipinoelbreve9: folds 
Uncalled bet (€0.31) returned to alcalde19
alcalde19 collected €0.90 from pot
alcalde19: doesn't show hand 
*** SUMMARY ***
Total pot €0.95 | Rake €0.05 
Board [Ad Tc Ks Qd]
Seat 1: Sportacus911 (button) folded before Flop (didn't bet)
Seat 2: orosa (small blind) folded before Flop
Seat 3: alcalde19 (big blind) collected (€0.90)
Seat 4: marcel13013 folded before Flop (didn't bet)
Seat 5: easywithnuts84 folded before Flop (didn't bet)
Seat 6: pipinoelbreve9 folded on the Turn



PokerStars Zoom Hand #257688963724:  Hold'em No Limit (€0.01/€0.02) - 2025/09/10 17:53:16 CET [2025/09/10 11:53:16 ET]
Table 'Arneb' 6-max Seat #1 is the button
Seat 1: pipinoelbreve9 (€2 in chips) 
Seat 2: alcalde19 (€3.81 in chips) 
Seat 3: loudydrix (€2 in chips) 
Seat 4: orosa (€2.27 in chips) 
Seat 5: DavSnook (€1.50 in chips) 
Seat 6: mikpepra (€1.15 in chips) 
alcalde19: posts small blind €0.01
loudydrix: posts big blind €0.02
*** HOLE CARDS ***
Dealt to pipinoelbreve9 [5c 4s]
orosa: folds 
DavSnook: folds 
mikpepra has timed out
mikpepra: folds 
pipinoelbreve9: folds 
alcalde19: folds 
Uncalled bet (€0.01) returned to loudydrix
loudydrix collected €0.02 from pot
loudydrix: doesn't show hand 
*** SUMMARY ***
Total pot €0.02 | Rake €0 
Seat 1: pipinoelbreve9 (button) folded before Flop (didn't bet)
Seat 2: alcalde19 (small blind) folded before Flop
Seat 3: loudydrix (big blind) collected (€0.02)
Seat 4: orosa folded before Flop (didn't bet)
Seat 5: DavSnook folded before Flop (didn't bet)
Seat 6: mikpepra folded before Flop (didn't bet)



PokerStars Zoom Hand #257688970231:  Hold'em No Limit (€0.01/€0.02) - 2025/09/10 17:53:51 CET [2025/09/10 11:53:51 ET]
Table 'Arneb' 6-max Seat #1 is the button
Seat 1: basurdia (€2 in chips) 
Seat 2: candarias (€0.98 in chips) 
Seat 3: pipinoelbreve9 (€2 in chips) 
Seat 4: franxu94poke (€2.27 in chips) 
Seat 5: nometoquesloshu (€0.98 in chips) 
Seat 6: ssjimmyss88 (€1.51 in chips) 
candarias: posts small blind €0.01
pipinoelbreve9: posts big blind €0.02
*** HOLE CARDS ***
Dealt to pipinoelbreve9 [Td As]
franxu94poke: folds 
nometoquesloshu: folds 
ssjimmyss88: folds 
basurdia: folds 
candarias: folds 
Uncalled bet (€0.01) returned to pipinoelbreve9
pipinoelbreve9 collected €0.02 from pot
pipinoelbreve9: doesn't show hand 
*** SUMMARY ***
Total pot €0.02 | Rake €0 
Seat 1: basurdia (button) folded before Flop (didn't bet)
Seat 2: candarias (small blind) folded before Flop
Seat 3: pipinoelbreve9 (big blind) collected (€0.02)
Seat 4: franxu94poke folded before Flop (didn't bet)
Seat 5: nometoquesloshu folded before Flop (didn't bet)
Seat 6: ssjimmyss88 folded before Flop (didn't bet)



PokerStars Zoom Hand #257688967800:  Hold'em No Limit (€0.01/€0.02) - 2025/09/10 17:53:38 CET [2025/09/10 11:53:38 ET]
Table 'Arneb' 6-max Seat #1 is the button
Seat 1: orosa (€2.32 in chips) 
Seat 2: Ruben1990869 (€2.08 in chips) 
Seat 3: alcalde19 (€3.80 in chips) 
Seat 4: MDKristian (€2 in chips) 
Seat 5: pipinoelbreve9 (€2 in chips) 
Seat 6: jeannono24 (€2.12 in chips) 
Ruben1990869: posts small blind €0.01
alcalde19: posts big blind €0.02
*** HOLE CARDS ***
Dealt to pipinoelbreve9 [6c Tc]
MDKristian: folds 
pipinoelbreve9: folds 
jeannono24: folds 
orosa: raises €0.04 to €0.06
Ruben1990869: folds 
alcalde19: folds 
Uncalled bet (€0.04) returned to orosa
orosa collected €0.05 from pot
orosa: doesn't show hand 
*** SUMMARY ***
Total pot €0.05 | Rake €0 
Seat 1: orosa (button) collected (€0.05)
Seat 2: Ruben1990869 (small blind) folded before Flop
Seat 3: alcalde19 (big blind) folded before Flop
Seat 4: MDKristian folded before Flop (didn't bet)
Seat 5: pipinoelbreve9 folded before Flop (didn't bet)
Seat 6: jeannono24 folded before Flop (didn't bet)



PokerStars Zoom Hand #257688969165:  Hold'em No Limit (€0.01/€0.02) - 2025/09/10 17:53:45 CET [2025/09/10 11:53:45 ET]
Table 'Arneb' 6-max Seat #1 is the button
Seat 1: Andricap (€1.80 in chips) 
Seat 2: candarias (€0.98 in chips) 
Seat 3: remiiiiiiii (€2.26 in chips) 
Seat 4: pipinoelbreve9 (€2 in chips) 
Seat 5: Siddharta33 (€1.08 in chips) 
Seat 6: jumv (€2.29 in chips) 
candarias: posts small blind €0.01
remiiiiiiii: posts big blind €0.02
*** HOLE CARDS ***
Dealt to pipinoelbreve9 [Qd 9c]
pipinoelbreve9: folds 
Siddharta33: folds 
jumv: folds 
Andricap: raises €0.03 to €0.05
candarias: folds 
remiiiiiiii: folds 
Uncalled bet (€0.03) returned to Andricap
Andricap collected €0.05 from pot
Andricap: doesn't show hand 
*** SUMMARY ***
Total pot €0.05 | Rake €0 
Seat 1: Andricap (button) collected (€0.05)
Seat 2: candarias (small blind) folded before Flop
Seat 3: remiiiiiiii (big blind) folded before Flop
Seat 4: pipinoelbreve9 folded before Flop (didn't bet)
Seat 5: Siddharta33 folded before Flop (didn't bet)
Seat 6: jumv folded before Flop (didn't bet)



PokerStars Zoom Hand #257688971680:  Hold'em No Limit (€0.01/€0.02) - 2025/09/10 17:53:59 CET [2025/09/10 11:53:59 ET]
Table 'Arneb' 6-max Seat #1 is the button
Seat 1: jeannono24 (€2.06 in chips) 
Seat 2: pipinoelbreve9 (€2.01 in chips) 
Seat 3: spiritwarrior29 (€1.60 in chips) 
Seat 4: Crubiov_1978 (€1.18 in chips) 
Seat 5: Andres010328 (€1 in chips) 
Seat 6: Siddharta33 (€3.31 in chips) 
pipinoelbreve9: posts small blind €0.01
spiritwarrior29: posts big blind €0.02
*** HOLE CARDS ***
Dealt to pipinoelbreve9 [Qs 3h]
Crubiov_1978: folds 
Andres010328: folds 
Siddharta33: folds 
jeannono24: folds 
pipinoelbreve9: folds 
Uncalled bet (€0.01) returned to spiritwarrior29
spiritwarrior29 collected €0.02 from pot
spiritwarrior29: doesn't show hand 
*** SUMMARY ***
Total pot €0.02 | Rake €0 
Seat 1: jeannono24 (button) folded before Flop (didn't bet)
Seat 2: pipinoelbreve9 (small blind) folded before Flop
Seat 3: spiritwarrior29 (big blind) collected (€0.02)
Seat 4: Crubiov_1978 folded before Flop (didn't bet)
Seat 5: Andres010328 folded before Flop (didn't bet)
Seat 6: Siddharta33 folded before Flop (didn't bet)



PokerStars Zoom Hand #257688972841:  Hold'em No Limit (€0.01/€0.02) - 2025/09/10 17:54:05 CET [2025/09/10 11:54:05 ET]
Table 'Arneb' 6-max Seat #1 is the button
Seat 1: pipinoelbreve9 (€2 in chips) 
Seat 2: bluffynuts (€1.42 in chips) 
Seat 3: easywithnuts84 (€2.44 in chips) 
Seat 4: MDKristian (€2.17 in chips) 
Seat 5: DavSnook (€2.94 in chips) 
Seat 6: candarias (€0.97 in chips) 
bluffynuts: posts small blind €0.01
easywithnuts84: posts big blind €0.02
*** HOLE CARDS ***
Dealt to pipinoelbreve9 [6d Ac]
MDKristian: folds 
DavSnook: folds 
candarias: folds 
pipinoelbreve9: raises €0.04 to €0.06
bluffynuts: folds 
easywithnuts84: folds 
Uncalled bet (€0.04) returned to pipinoelbreve9
pipinoelbreve9 collected €0.05 from pot
pipinoelbreve9: doesn't show hand 
*** SUMMARY ***
Total pot €0.05 | Rake €0 
Seat 1: pipinoelbreve9 (button) collected (€0.05)
Seat 2: bluffynuts (small blind) folded before Flop
Seat 3: easywithnuts84 (big blind) folded before Flop
Seat 4: MDKristian folded before Flop (didn't bet)
Seat 5: DavSnook folded before Flop (didn't bet)
Seat 6: candarias folded before Flop (didn't bet)



PokerStars Zoom Hand #257688976080:  Hold'em No Limit (€0.01/€0.02) - 2025/09/10 17:54:23 CET [2025/09/10 11:54:23 ET]
Table 'Arneb' 6-max Seat #1 is the button
Seat 1: danitorpedo (€1.50 in chips) 
Seat 2: Ruben1990869 (€2.37 in chips) 
Seat 3: jumv (€2.21 in chips) 
Seat 4: Siddharta33 (€3.28 in chips) 
Seat 5: Andricap (€1.83 in chips) 
Seat 6: pipinoelbreve9 (€2.03 in chips) 
Ruben1990869: posts small blind €0.01
jumv: posts big blind €0.02
*** HOLE CARDS ***
Dealt to pipinoelbreve9 [8h Jc]
Siddharta33: folds 
Andricap: folds 
pipinoelbreve9: folds 
danitorpedo: folds 
Ruben1990869: raises €0.04 to €0.06
jumv: calls €0.04
*** FLOP *** [9s 8s 3h]
Ruben1990869: checks 
jumv: bets €0.06
Ruben1990869: folds 
Uncalled bet (€0.06) returned to jumv
jumv collected €0.11 from pot
jumv: doesn't show hand 
*** SUMMARY ***
Total pot €0.12 | Rake €0.01 
Board [9s 8s 3h]
Seat 1: danitorpedo (button) folded before Flop (didn't bet)
Seat 2: Ruben1990869 (small blind) folded on the Flop
Seat 3: jumv (big blind) collected (€0.11)
Seat 4: Siddharta33 folded before Flop (didn't bet)
Seat 5: Andricap folded before Flop (didn't bet)
Seat 6: pipinoelbreve9 folded before Flop (didn't bet)



PokerStars Zoom Hand #257688979943:  Hold'em No Limit (€0.01/€0.02) - 2025/09/10 17:54:44 CET [2025/09/10 11:54:44 ET]
Table 'Arneb' 6-max Seat #1 is the button
Seat 1: JENOFONTE73 (€1.97 in chips) 
Seat 2: pipinoelbreve9 (€2.03 in chips) 
Seat 3: mxaencew (€2.80 in chips) 
Seat 4: DavSnook (€2.91 in chips) 
Seat 5: Andricap (€2.02 in chips) 
Seat 6: orosa (€3.31 in chips) 
pipinoelbreve9: posts small blind €0.01
mxaencew: posts big blind €0.02
*** HOLE CARDS ***
Dealt to pipinoelbreve9 [2c 8s]
DavSnook: folds 
Andricap: folds 
orosa: folds 
JENOFONTE73: folds 
pipinoelbreve9: folds 
Uncalled bet (€0.01) returned to mxaencew
mxaencew collected €0.02 from pot
mxaencew: doesn't show hand 
*** SUMMARY ***
Total pot €0.02 | Rake €0 
Seat 1: JENOFONTE73 (button) folded before Flop (didn't bet)
Seat 2: pipinoelbreve9 (small blind) folded before Flop
Seat 3: mxaencew (big blind) collected (€0.02)
Seat 4: DavSnook folded before Flop (didn't bet)
Seat 5: Andricap folded before Flop (didn't bet)
Seat 6: orosa folded before Flop (didn't bet)



PokerStars Zoom Hand #257688968526:  Hold'em No Limit (€0.01/€0.02) - 2025/09/10 17:53:42 CET [2025/09/10 11:53:42 ET]
Table 'Arneb' 6-max Seat #1 is the button
Seat 1: candarias (€0.98 in chips) 
Seat 2: jeannono24 (€2.19 in chips) 
Seat 3: Dood Francisco (€2.53 in chips) 
Seat 4: pipinoelbreve9 (€2 in chips) 
Seat 5: darkFoxxx47 (€2 in chips) 
Seat 6: Siddharta33 (€1 in chips) 
jeannono24: posts small blind €0.01
Dood Francisco: posts big blind €0.02
*** HOLE CARDS ***
Dealt to pipinoelbreve9 [6h Js]
pipinoelbreve9: folds 
darkFoxxx47: folds 
Siddharta33: folds 
candarias: folds 
jeannono24: raises €0.04 to €0.06
Dood Francisco: calls €0.04
*** FLOP *** [4h 8c Kh]
jeannono24: checks 
Dood Francisco: bets €0.06
jeannono24: calls €0.06
*** TURN *** [4h 8c Kh] [7h]
jeannono24: checks 
Dood Francisco: bets €0.12
jeannono24: calls €0.12
*** RIVER *** [4h 8c Kh 7h] [Ad]
jeannono24: checks 
Dood Francisco: checks 
*** SHOW DOWN ***
jeannono24: shows [Jc Ks] (a pair of Kings)
Dood Francisco: mucks hand 
jeannono24 collected €0.46 from pot
*** SUMMARY ***
Total pot €0.48 | Rake €0.02 
Board [4h 8c Kh 7h Ad]
Seat 1: candarias (button) folded before Flop (didn't bet)
Seat 2: jeannono24 (small blind) showed [Jc Ks] and won (€0.46) with a pair of Kings
Seat 3: Dood Francisco (big blind) mucked [6d 6c]
Seat 4: pipinoelbreve9 folded before Flop (didn't bet)
Seat 5: darkFoxxx47 folded before Flop (didn't bet)
Seat 6: Siddharta33 folded before Flop (didn't bet)



PokerStars Zoom Hand #257688978178:  Hold'em No Limit (€0.01/€0.02) - 2025/09/10 17:54:34 CET [2025/09/10 11:54:34 ET]
Table 'Arneb' 6-max Seat #1 is the button
Seat 1: Marc Perca (€1.97 in chips) 
Seat 2: easywithnuts84 (€3.68 in chips) 
Seat 3: Andricap (€1.82 in chips) 
Seat 4: loudydrix (€2 in chips) 
Seat 5: pipinoelbreve9 (€2.03 in chips) 
Seat 6: So4ar (€1.68 in chips) 
easywithnuts84: posts small blind €0.01
Andricap: posts big blind €0.02
*** HOLE CARDS ***
Dealt to pipinoelbreve9 [6c Qd]
loudydrix: calls €0.02
pipinoelbreve9: folds 
So4ar: folds 
Marc Perca: folds 
easywithnuts84: folds 
Andricap: checks 
*** FLOP *** [7s Jd Ts]
Andricap: checks 
loudydrix: checks 
*** TURN *** [7s Jd Ts] [Jh]
Andricap: bets €0.05
loudydrix: raises €0.05 to €0.10
Andricap: calls €0.05
*** RIVER *** [7s Jd Ts Jh] [Qc]
Andricap: checks 
loudydrix: bets €0.20
Andricap: calls €0.20
*** SHOW DOWN ***
loudydrix: shows [6h Ah] (a pair of Jacks)
Andricap: shows [3c Jc] (three of a kind, Jacks)
Andricap collected €0.62 from pot
*** SUMMARY ***
Total pot €0.65 | Rake €0.03 
Board [7s Jd Ts Jh Qc]
Seat 1: Marc Perca (button) folded before Flop (didn't bet)
Seat 2: easywithnuts84 (small blind) folded before Flop
Seat 3: Andricap (big blind) showed [3c Jc] and won (€0.62) with three of a kind, Jacks
Seat 4: loudydrix showed [6h Ah] and lost with a pair of Jacks
Seat 5: pipinoelbreve9 folded before Flop (didn't bet)
Seat 6: So4ar folded before Flop (didn't bet)



PokerStars Zoom Hand #257688982333:  Hold'em No Limit (€0.01/€0.02) - 2025/09/10 17:54:56 CET [2025/09/10 11:54:56 ET]
Table 'Arneb' 6-max Seat #1 is the button
Seat 1: marcosbalsaa (€1.98 in chips) 
Seat 2: Dood Francisco (€2.29 in chips) 
Seat 3: Alejandr_666 (€2.29 in chips) 
Seat 4: pipinoelbreve9 (€2 in chips) 
Seat 5: jumv (€2.25 in chips) 
Seat 6: PARAG00MBA (€2.28 in chips) 
Dood Francisco: posts small blind €0.01
Alejandr_666: posts big blind €0.02
*** HOLE CARDS ***
Dealt to pipinoelbreve9 [4c Kd]
pipinoelbreve9: folds 
jumv: raises €0.06 to €0.08
PARAG00MBA: folds 
marcosbalsaa: folds 
Dood Francisco: folds 
Alejandr_666: folds 
Uncalled bet (€0.06) returned to jumv
jumv collected €0.05 from pot
jumv: doesn't show hand 
*** SUMMARY ***
Total pot €0.05 | Rake €0 
Seat 1: marcosbalsaa (button) folded before Flop (didn't bet)
Seat 2: Dood Francisco (small blind) folded before Flop
Seat 3: Alejandr_666 (big blind) folded before Flop
Seat 4: pipinoelbreve9 folded before Flop (didn't bet)
Seat 5: jumv collected (€0.05)
Seat 6: PARAG00MBA folded before Flop (didn't bet)



PokerStars Zoom Hand #257688980518:  Hold'em No Limit (€0.01/€0.02) - 2025/09/10 17:54:47 CET [2025/09/10 11:54:47 ET]
Table 'Arneb' 6-max Seat #1 is the button
Seat 1: jeannono24 (€2.12 in chips) 
Seat 2: Sportacus911 (€1.80 in chips) 
Seat 3: pipinoelbreve9 (€2.02 in chips) 
Seat 4: Doblea315 (€2.35 in chips) 
Seat 5: Andricap (€2.02 in chips) 
Seat 6: franxu94poke (€2.24 in chips) 
Sportacus911: posts small blind €0.01
pipinoelbreve9: posts big blind €0.02
*** HOLE CARDS ***
Dealt to pipinoelbreve9 [2s 3s]
Doblea315: raises €0.04 to €0.06
Andricap: folds 
franxu94poke: folds 
jeannono24: calls €0.06
Sportacus911: folds 
pipinoelbreve9: folds 
*** FLOP *** [Ts Kc 3c]
Doblea315: bets €0.07
jeannono24: folds 
Uncalled bet (€0.07) returned to Doblea315
Doblea315 collected €0.14 from pot
Doblea315: doesn't show hand 
*** SUMMARY ***
Total pot €0.15 | Rake €0.01 
Board [Ts Kc 3c]
Seat 1: jeannono24 (button) folded on the Flop
Seat 2: Sportacus911 (small blind) folded before Flop
Seat 3: pipinoelbreve9 (big blind) folded before Flop
Seat 4: Doblea315 collected (€0.14)
Seat 5: Andricap folded before Flop (didn't bet)
Seat 6: franxu94poke folded before Flop (didn't bet)



PokerStars Zoom Hand #257688982925:  Hold'em No Limit (€0.01/€0.02) - 2025/09/10 17:55:00 CET [2025/09/10 11:55:00 ET]
Table 'Arneb' 6-max Seat #1 is the button
Seat 1: pipinoelbreve9 (€2 in chips) 
Seat 2: cherda33 (€2.56 in chips) 
Seat 3: mikpepra (€2.13 in chips) 
Seat 4: Popins0011 (€2.19 in chips) 
Seat 5: blout-blout (€3.96 in chips) 
Seat 6: jeannono24 (€2.09 in chips) 
cherda33: posts small blind €0.01
mikpepra: posts big blind €0.02
*** HOLE CARDS ***
Dealt to pipinoelbreve9 [6d 4d]
Popins0011: folds 
blout-blout: raises €0.02 to €0.04
jeannono24: folds 
pipinoelbreve9: calls €0.04
cherda33: folds 
mikpepra: calls €0.02
*** FLOP *** [8s Qh 3s]
mikpepra: checks 
blout-blout: checks 
pipinoelbreve9: checks 
*** TURN *** [8s Qh 3s] [Qc]
mikpepra: checks 
blout-blout: checks 
pipinoelbreve9: checks 
*** RIVER *** [8s Qh 3s Qc] [Kc]
mikpepra: checks 
blout-blout: bets €0.06
pipinoelbreve9: folds 
mikpepra: folds 
Uncalled bet (€0.06) returned to blout-blout
blout-blout collected €0.12 from pot
blout-blout: doesn't show hand 
*** SUMMARY ***
Total pot €0.13 | Rake €0.01 
Board [8s Qh 3s Qc Kc]
Seat 1: pipinoelbreve9 (button) folded on the River
Seat 2: cherda33 (small blind) folded before Flop
Seat 3: mikpepra (big blind) folded on the River
Seat 4: Popins0011 folded before Flop (didn't bet)
Seat 5: blout-blout collected (€0.12)
Seat 6: jeannono24 folded before Flop (didn't bet)



PokerStars Zoom Hand #257688991338:  Hold'em No Limit (€0.01/€0.02) - 2025/09/10 17:55:56 CET [2025/09/10 11:55:56 ET]
Table 'Arneb' 6-max Seat #1 is the button
Seat 1: Doblea315 (€2.26 in chips) 
Seat 2: chonji24 (€3.44 in chips) 
Seat 3: remiiiiiiii (€1.94 in chips) 
Seat 4: Rochinha1179 (€1.48 in chips) 
Seat 5: pipinoelbreve9 (€2 in chips) 
Seat 6: jeannono24 (€2.03 in chips) 
chonji24: posts small blind €0.01
remiiiiiiii: posts big blind €0.02
*** HOLE CARDS ***
Dealt to pipinoelbreve9 [5h 4c]
Rochinha1179: folds 
pipinoelbreve9: folds 
jeannono24: folds 
Doblea315: folds 
chonji24: folds 
Uncalled bet (€0.01) returned to remiiiiiiii
remiiiiiiii collected €0.02 from pot
remiiiiiiii: doesn't show hand 
*** SUMMARY ***
Total pot €0.02 | Rake €0 
Seat 1: Doblea315 (button) folded before Flop (didn't bet)
Seat 2: chonji24 (small blind) folded before Flop
Seat 3: remiiiiiiii (big blind) collected (€0.02)
Seat 4: Rochinha1179 folded before Flop (didn't bet)
Seat 5: pipinoelbreve9 folded before Flop (didn't bet)
Seat 6: jeannono24 folded before Flop (didn't bet)



PokerStars Zoom Hand #257688990037:  Hold'em No Limit (€0.01/€0.02) - 2025/09/10 17:55:47 CET [2025/09/10 11:55:47 ET]
Table 'Arneb' 6-max Seat #1 is the button
Seat 1: Andricap (€2.09 in chips) 
Seat 2: jeannono24 (€2.06 in chips) 
Seat 3: Marc Perca (€1.69 in chips) 
Seat 4: DarKraken97 (€1.87 in chips) 
Seat 5: raptureman1 (€2.31 in chips) 
Seat 6: pipinoelbreve9 (€2 in chips) 
jeannono24: posts small blind €0.01
Marc Perca: posts big blind €0.02
*** HOLE CARDS ***
Dealt to pipinoelbreve9 [7s 9h]
DarKraken97: folds 
raptureman1: folds 
pipinoelbreve9: folds 
Andricap: folds 
jeannono24: raises €0.04 to €0.06
Marc Perca: folds 
Uncalled bet (€0.04) returned to jeannono24
jeannono24 collected €0.04 from pot
jeannono24: doesn't show hand 
*** SUMMARY ***
Total pot €0.04 | Rake €0 
Seat 1: Andricap (button) folded before Flop (didn't bet)
Seat 2: jeannono24 (small blind) collected (€0.04)
Seat 3: Marc Perca (big blind) folded before Flop
Seat 4: DarKraken97 folded before Flop (didn't bet)
Seat 5: raptureman1 folded before Flop (didn't bet)
Seat 6: pipinoelbreve9 folded before Flop (didn't bet)



PokerStars Zoom Hand #257688992274:  Hold'em No Limit (€0.01/€0.02) - 2025/09/10 17:56:03 CET [2025/09/10 11:56:03 ET]
Table 'Arneb' 6-max Seat #1 is the button
Seat 1: Ruben1990869 (€2.02 in chips) 
Seat 2: pipinoelbreve9 (€2 in chips) 
Seat 3: ssjimmyss88 (€0.39 in chips) 
Seat 4: franxu94poke (€4.28 in chips) 
Seat 5: easywithnuts84 (€3.67 in chips) 
Seat 6: Siddharta33 (€1 in chips) 
pipinoelbreve9: posts small blind €0.01
ssjimmyss88: posts big blind €0.02
*** HOLE CARDS ***
Dealt to pipinoelbreve9 [Jd Ks]
franxu94poke: folds 
easywithnuts84: raises €0.03 to €0.05
Siddharta33: folds 
Ruben1990869: folds 
pipinoelbreve9: raises €0.13 to €0.18
ssjimmyss88: folds 
easywithnuts84: folds 
Uncalled bet (€0.13) returned to pipinoelbreve9
pipinoelbreve9 collected €0.12 from pot
pipinoelbreve9: doesn't show hand 
*** SUMMARY ***
Total pot €0.12 | Rake €0 
Seat 1: Ruben1990869 (button) folded before Flop (didn't bet)
Seat 2: pipinoelbreve9 (small blind) collected (€0.12)
Seat 3: ssjimmyss88 (big blind) folded before Flop
Seat 4: franxu94poke folded before Flop (didn't bet)
Seat 5: easywithnuts84 folded before Flop
Seat 6: Siddharta33 folded before Flop (didn't bet)



PokerStars Zoom Hand #257688995483:  Hold'em No Limit (€0.01/€0.02) - 2025/09/10 17:56:27 CET [2025/09/10 11:56:27 ET]
Table 'Arneb' 6-max Seat #1 is the button
Seat 1: pipinoelbreve9 (€2.07 in chips) 
Seat 2: Doblea315 (€2.38 in chips) 
Seat 3: easywithnuts84 (€3.62 in chips) 
Seat 4: Marc Perca (€1.67 in chips) 
Seat 5: Siddharta33 (€1 in chips) 
Seat 6: franxu94poke (€4.29 in chips) 
Doblea315: posts small blind €0.01
easywithnuts84: posts big blind €0.02
*** HOLE CARDS ***
Dealt to pipinoelbreve9 [5c Qh]
Marc Perca: folds 
Siddharta33: folds 
franxu94poke: raises €0.04 to €0.06
pipinoelbreve9: folds 
Doblea315: folds 
easywithnuts84: folds 
Uncalled bet (€0.04) returned to franxu94poke
franxu94poke collected €0.05 from pot
franxu94poke: doesn't show hand 
*** SUMMARY ***
Total pot €0.05 | Rake €0 
Seat 1: pipinoelbreve9 (button) folded before Flop (didn't bet)
Seat 2: Doblea315 (small blind) folded before Flop
Seat 3: easywithnuts84 (big blind) folded before Flop
Seat 4: Marc Perca folded before Flop (didn't bet)
Seat 5: Siddharta33 folded before Flop (didn't bet)
Seat 6: franxu94poke collected (€0.05)



PokerStars Zoom Hand #257688998243:  Hold'em No Limit (€0.01/€0.02) - 2025/09/10 17:56:47 CET [2025/09/10 11:56:47 ET]
Table 'Arneb' 6-max Seat #1 is the button
Seat 1: loudydrix (€1.79 in chips) 
Seat 2: Andricap (€2.61 in chips) 
Seat 3: pipinoelbreve9 (€2.07 in chips) 
Seat 4: malmeto45 (€2.06 in chips) 
Seat 5: candarias (€0.88 in chips) 
Seat 6: raptureman1 (€2.28 in chips) 
Andricap: posts small blind €0.01
pipinoelbreve9: posts big blind €0.02
*** HOLE CARDS ***
Dealt to pipinoelbreve9 [Ad Qs]
malmeto45: folds 
candarias: folds 
raptureman1: folds 
loudydrix: calls €0.02
Andricap: folds 
pipinoelbreve9: raises €0.08 to €0.10
loudydrix: calls €0.08
*** FLOP *** [4d 7s 9c]
pipinoelbreve9: bets €0.08
loudydrix: raises €1.61 to €1.69 and is all-in
pipinoelbreve9: folds 
Uncalled bet (€1.61) returned to loudydrix
loudydrix collected €0.35 from pot
loudydrix: doesn't show hand 
*** SUMMARY ***
Total pot €0.37 | Rake €0.02 
Board [4d 7s 9c]
Seat 1: loudydrix (button) collected (€0.35)
Seat 2: Andricap (small blind) folded before Flop
Seat 3: pipinoelbreve9 (big blind) folded on the Flop
Seat 4: malmeto45 folded before Flop (didn't bet)
Seat 5: candarias folded before Flop (didn't bet)
Seat 6: raptureman1 folded before Flop (didn't bet)



PokerStars Zoom Hand #257689004783:  Hold'em No Limit (€0.01/€0.02) - 2025/09/10 17:57:35 CET [2025/09/10 11:57:35 ET]
Table 'Arneb' 6-max Seat #1 is the button
Seat 1: grao1 (€1.71 in chips) 
Seat 2: vadozeca95 (€1.90 in chips) 
Seat 3: claret505 (€1.04 in chips) 
Seat 4: QUIQUE JONES (€0.94 in chips) 
Seat 5: pipinoelbreve9 (€2 in chips) 
Seat 6: cuenca10 (€3.67 in chips) 
vadozeca95: posts small blind €0.01
claret505: posts big blind €0.02
*** HOLE CARDS ***
Dealt to pipinoelbreve9 [3h 8s]
QUIQUE JONES: folds 
pipinoelbreve9: folds 
cuenca10: folds 
grao1: folds 
vadozeca95: calls €0.01
claret505: checks 
*** FLOP *** [Th Qd Td]
vadozeca95: bets €0.02
claret505: folds 
Uncalled bet (€0.02) returned to vadozeca95
vadozeca95 collected €0.04 from pot
vadozeca95: doesn't show hand 
*** SUMMARY ***
Total pot €0.04 | Rake €0 
Board [Th Qd Td]
Seat 1: grao1 (button) folded before Flop (didn't bet)
Seat 2: vadozeca95 (small blind) collected (€0.04)
Seat 3: claret505 (big blind) folded on the Flop
Seat 4: QUIQUE JONES folded before Flop (didn't bet)
Seat 5: pipinoelbreve9 folded before Flop (didn't bet)
Seat 6: cuenca10 folded before Flop (didn't bet)



PokerStars Zoom Hand #257689003878:  Hold'em No Limit (€0.01/€0.02) - 2025/09/10 17:57:28 CET [2025/09/10 11:57:28 ET]
Table 'Arneb' 6-max Seat #1 is the button
Seat 1: jeannono24 (€2.10 in chips) 
Seat 2: Siddharta33 (€1.06 in chips) 
Seat 3: Rochinha1179 (€1.44 in chips) 
Seat 4: malmeto45 (€1.89 in chips) 
Seat 5: orosa (€2.24 in chips) 
Seat 6: pipinoelbreve9 (€2 in chips) 
Siddharta33: posts small blind €0.01
Rochinha1179: posts big blind €0.02
*** HOLE CARDS ***
Dealt to pipinoelbreve9 [Jh 2h]
malmeto45: raises €0.04 to €0.06
orosa: folds 
pipinoelbreve9: folds 
jeannono24: raises €0.12 to €0.18
Siddharta33: folds 
Rochinha1179: folds 
malmeto45: folds 
Uncalled bet (€0.12) returned to jeannono24
jeannono24 collected €0.15 from pot
jeannono24: doesn't show hand 
*** SUMMARY ***
Total pot €0.15 | Rake €0 
Seat 1: jeannono24 (button) collected (€0.15)
Seat 2: Siddharta33 (small blind) folded before Flop
Seat 3: Rochinha1179 (big blind) folded before Flop
Seat 4: malmeto45 folded before Flop
Seat 5: orosa folded before Flop (didn't bet)
Seat 6: pipinoelbreve9 folded before Flop (didn't bet)



PokerStars Zoom Hand #257689005685:  Hold'em No Limit (€0.01/€0.02) - 2025/09/10 17:57:42 CET [2025/09/10 11:57:42 ET]
Table 'Arneb' 6-max Seat #1 is the button
Seat 1: easywithnuts84 (€3.59 in chips) 
Seat 2: remiiiiiiii (€2.06 in chips) 
Seat 3: Siddharta33 (€1.07 in chips) 
Seat 4: CassecouIL74 (€3.40 in chips) 
Seat 5: pipinoelbreve9 (€2 in chips) 
Seat 6: Dood Francisco (€2.25 in chips) 
remiiiiiiii: posts small blind €0.01
Siddharta33: posts big blind €0.02
*** HOLE CARDS ***
Dealt to pipinoelbreve9 [Ac Kd]
CassecouIL74: folds 
pipinoelbreve9: raises €0.02 to €0.04
Dood Francisco: folds 
easywithnuts84: folds 
remiiiiiiii: calls €0.03
Siddharta33: folds 
*** FLOP *** [4d 5d 9c]
remiiiiiiii: checks 
pipinoelbreve9: checks 
*** TURN *** [4d 5d 9c] [Kc]
remiiiiiiii: checks 
pipinoelbreve9: bets €0.10
remiiiiiiii: folds 
Uncalled bet (€0.10) returned to pipinoelbreve9
pipinoelbreve9 collected €0.10 from pot
pipinoelbreve9: doesn't show hand 
*** SUMMARY ***
Total pot €0.10 | Rake €0 
Board [4d 5d 9c Kc]
Seat 1: easywithnuts84 (button) folded before Flop (didn't bet)
Seat 2: remiiiiiiii (small blind) folded on the Turn
Seat 3: Siddharta33 (big blind) folded before Flop
Seat 4: CassecouIL74 folded before Flop (didn't bet)
Seat 5: pipinoelbreve9 collected (€0.10)
Seat 6: Dood Francisco folded before Flop (didn't bet)



PokerStars Zoom Hand #257689014871:  Hold'em No Limit (€0.01/€0.02) - 2025/09/10 17:58:49 CET [2025/09/10 11:58:49 ET]
Table 'Arneb' 6-max Seat #1 is the button
Seat 1: CORDEVIGO (€5.43 in chips) 
Seat 2: Siddharta33 (€1.03 in chips) 
Seat 3: soyeterno (€3.47 in chips) 
Seat 4: DavSnook (€2.56 in chips) 
Seat 5: Dood Francisco (€2.43 in chips) 
Seat 6: pipinoelbreve9 (€2.06 in chips) 
Siddharta33: posts small blind €0.01
soyeterno: posts big blind €0.02
*** HOLE CARDS ***
Dealt to pipinoelbreve9 [3c 6h]
DavSnook: folds 
Dood Francisco: folds 
pipinoelbreve9: folds 
CORDEVIGO: folds 
Siddharta33: folds 
Uncalled bet (€0.01) returned to soyeterno
soyeterno collected €0.02 from pot
soyeterno: doesn't show hand 
*** SUMMARY ***
Total pot €0.02 | Rake €0 
Seat 1: CORDEVIGO (button) folded before Flop (didn't bet)
Seat 2: Siddharta33 (small blind) folded before Flop
Seat 3: soyeterno (big blind) collected (€0.02)
Seat 4: DavSnook folded before Flop (didn't bet)
Seat 5: Dood Francisco folded before Flop (didn't bet)
Seat 6: pipinoelbreve9 folded before Flop (didn't bet)



PokerStars Zoom Hand #257689014226:  Hold'em No Limit (€0.01/€0.02) - 2025/09/10 17:58:44 CET [2025/09/10 11:58:44 ET]
Table 'Arneb' 6-max Seat #1 is the button
Seat 1: orosa (€2 in chips) 
Seat 2: raptureman1 (€2.30 in chips) 
Seat 3: chonji24 (€3.67 in chips) 
Seat 4: pipinoelbreve9 (€2.06 in chips) 
Seat 5: Sportacus911 (€1.47 in chips) 
Seat 6: DavSnook (€5.17 in chips) 
raptureman1: posts small blind €0.01
chonji24: posts big blind €0.02
*** HOLE CARDS ***
Dealt to pipinoelbreve9 [3h 9s]
pipinoelbreve9: folds 
Sportacus911: folds 
DavSnook: folds 
orosa: folds 
raptureman1: raises €0.04 to €0.06
chonji24: calls €0.04
*** FLOP *** [Ac 8h 2h]
raptureman1: bets €0.06
chonji24: calls €0.06
*** TURN *** [Ac 8h 2h] [9h]
raptureman1: bets €0.12
chonji24: calls €0.12
*** RIVER *** [Ac 8h 2h 9h] [3s]
raptureman1: bets €2.06 and is all-in
chonji24: calls €2.06
*** SHOW DOWN ***
raptureman1: shows [5h Ah] (a flush, Ace high)
chonji24: shows [7h 6h] (a flush, Nine high)
raptureman1 collected €4.37 from pot
*** SUMMARY ***
Total pot €4.60 | Rake €0.23 
Board [Ac 8h 2h 9h 3s]
Seat 1: orosa (button) folded before Flop (didn't bet)
Seat 2: raptureman1 (small blind) showed [5h Ah] and won (€4.37) with a flush, Ace high
Seat 3: chonji24 (big blind) showed [7h 6h] and lost with a flush, Nine high
Seat 4: pipinoelbreve9 folded before Flop (didn't bet)
Seat 5: Sportacus911 folded before Flop (didn't bet)
Seat 6: DavSnook folded before Flop (didn't bet)



PokerStars Zoom Hand #257689015277:  Hold'em No Limit (€0.01/€0.02) - 2025/09/10 17:58:52 CET [2025/09/10 11:58:52 ET]
Table 'Arneb' 6-max Seat #1 is the button
Seat 1: eyeeel (€0.85 in chips) 
Seat 2: stocchi51 (€1.44 in chips) 
Seat 3: pipinoelbreve9 (€2.06 in chips) 
Seat 4: SMN242 (€2.46 in chips) 
Seat 5: cherda33 (€2.70 in chips) 
Seat 6: DavSnook (€2.56 in chips) 
stocchi51: posts small blind €0.01
pipinoelbreve9: posts big blind €0.02
*** HOLE CARDS ***
Dealt to pipinoelbreve9 [Jd Ks]
SMN242: raises €0.03 to €0.05
cherda33: folds 
DavSnook: folds 
eyeeel: folds 
stocchi51: raises €0.03 to €0.08
pipinoelbreve9: calls €0.06
SMN242: calls €0.03
*** FLOP *** [8d Jh 4d]
stocchi51: bets €0.12
pipinoelbreve9: calls €0.12
SMN242: folds 
*** TURN *** [8d Jh 4d] [8c]
stocchi51: bets €0.23
pipinoelbreve9: calls €0.23
*** RIVER *** [8d Jh 4d 8c] [Ts]
stocchi51: bets €0.89
pipinoelbreve9: calls €0.89
*** SHOW DOWN ***
stocchi51: shows [Th Tc] (a full house, Tens full of Eights)
pipinoelbreve9: mucks hand 
stocchi51 collected €2.58 from pot
*** SUMMARY ***
Total pot €2.72 | Rake €0.14 
Board [8d Jh 4d 8c Ts]
Seat 1: eyeeel (button) folded before Flop (didn't bet)
Seat 2: stocchi51 (small blind) showed [Th Tc] and won (€2.58) with a full house, Tens full of Eights
Seat 3: pipinoelbreve9 (big blind) mucked [Jd Ks]
Seat 4: SMN242 folded on the Flop
Seat 5: cherda33 folded before Flop (didn't bet)
Seat 6: DavSnook folded before Flop (didn't bet)



PokerStars Zoom Hand #257689020618:  Hold'em No Limit (€0.01/€0.02) - 2025/09/10 17:59:30 CET [2025/09/10 11:59:30 ET]
Table 'Arneb' 6-max Seat #1 is the button
Seat 1: soyeterno (€0.84 in chips) 
Seat 2: pipinoelbreve9 (€2 in chips) 
Seat 3: danitorpedo (€0.34 in chips) 
Seat 4: Ruben1990869 (€2 in chips) 
Seat 5: serviettski(fr) (€2 in chips) 
Seat 6: PARAG00MBA (€2.68 in chips) 
pipinoelbreve9: posts small blind €0.01
danitorpedo: posts big blind €0.02
*** HOLE CARDS ***
Dealt to pipinoelbreve9 [8h Jc]
Ruben1990869: folds 
serviettski(fr): folds 
PARAG00MBA: raises €0.03 to €0.05
soyeterno: folds 
pipinoelbreve9: folds 
danitorpedo: calls €0.03
*** FLOP *** [Ks 8s Ac]
danitorpedo: checks 
PARAG00MBA: bets €0.03
danitorpedo: folds 
Uncalled bet (€0.03) returned to PARAG00MBA
PARAG00MBA collected €0.10 from pot
PARAG00MBA: doesn't show hand 
*** SUMMARY ***
Total pot €0.11 | Rake €0.01 
Board [Ks 8s Ac]
Seat 1: soyeterno (button) folded before Flop (didn't bet)
Seat 2: pipinoelbreve9 (small blind) folded before Flop
Seat 3: danitorpedo (big blind) folded on the Flop
Seat 4: Ruben1990869 folded before Flop (didn't bet)
Seat 5: serviettski(fr) folded before Flop (didn't bet)
Seat 6: PARAG00MBA collected (€0.10)



PokerStars Zoom Hand #257689021797:  Hold'em No Limit (€0.01/€0.02) - 2025/09/10 17:59:39 CET [2025/09/10 11:59:39 ET]
Table 'Arneb' 6-max Seat #1 is the button
Seat 1: pipinoelbreve9 (€2 in chips) 
Seat 2: Doblea315 (€2.41 in chips) 
Seat 3: ssjimmyss88 (€1.07 in chips) 
Seat 4: stocchi51 (€2.70 in chips) 
Seat 5: grao1 (€1.67 in chips) 
Seat 6: caroleli10 (€3.37 in chips) 
Doblea315: posts small blind €0.01
ssjimmyss88: posts big blind €0.02
*** HOLE CARDS ***
Dealt to pipinoelbreve9 [Js As]
stocchi51: folds 
grao1: raises €0.02 to €0.04
caroleli10: raises €0.11 to €0.15
pipinoelbreve9: calls €0.15
Doblea315: folds 
ssjimmyss88: calls €0.13
grao1: folds 
*** FLOP *** [Ac Ts 4c]
ssjimmyss88: checks 
caroleli10: checks 
pipinoelbreve9: bets €0.24
ssjimmyss88: folds 
caroleli10: folds 
Uncalled bet (€0.24) returned to pipinoelbreve9
pipinoelbreve9 collected €0.48 from pot
pipinoelbreve9: doesn't show hand 
*** SUMMARY ***
Total pot €0.50 | Rake €0.02 
Board [Ac Ts 4c]
Seat 1: pipinoelbreve9 (button) collected (€0.48)
Seat 2: Doblea315 (small blind) folded before Flop
Seat 3: ssjimmyss88 (big blind) folded on the Flop
Seat 4: stocchi51 folded before Flop (didn't bet)
Seat 5: grao1 folded before Flop
Seat 6: caroleli10 folded on the Flop



PokerStars Zoom Hand #257689029031:  Hold'em No Limit (€0.01/€0.02) - 2025/09/10 18:00:31 CET [2025/09/10 12:00:31 ET]
Table 'Arneb' 6-max Seat #1 is the button
Seat 1: orosa (€2.09 in chips) 
Seat 2: alcalde19 (€1.35 in chips) 
Seat 3: stocchi51 (€2.76 in chips) 
Seat 4: Siddharta33 (€1.04 in chips) 
Seat 5: jeannono24 (€2.11 in chips) 
Seat 6: pipinoelbreve9 (€2.33 in chips) 
alcalde19: posts small blind €0.01
stocchi51: posts big blind €0.02
*** HOLE CARDS ***
Dealt to pipinoelbreve9 [Jh Qs]
Siddharta33: folds 
jeannono24: folds 
pipinoelbreve9: raises €0.04 to €0.06
orosa: folds 
alcalde19: folds 
stocchi51: calls €0.04
*** FLOP *** [4c 8d Qc]
stocchi51: checks 
pipinoelbreve9: bets €0.08
stocchi51: folds 
Uncalled bet (€0.08) returned to pipinoelbreve9
pipinoelbreve9 collected €0.12 from pot
pipinoelbreve9: doesn't show hand 
*** SUMMARY ***
Total pot €0.13 | Rake €0.01 
Board [4c 8d Qc]
Seat 1: orosa (button) folded before Flop (didn't bet)
Seat 2: alcalde19 (small blind) folded before Flop
Seat 3: stocchi51 (big blind) folded on the Flop
Seat 4: Siddharta33 folded before Flop (didn't bet)
Seat 5: jeannono24 folded before Flop (didn't bet)
Seat 6: pipinoelbreve9 collected (€0.12)



PokerStars Zoom Hand #257689032615:  Hold'em No Limit (€0.01/€0.02) - 2025/09/10 18:00:54 CET [2025/09/10 12:00:54 ET]
Table 'Arneb' 6-max Seat #1 is the button
Seat 1: claret505 (€1.10 in chips) 
Seat 2: pipinoelbreve9 (€2.39 in chips) 
Seat 3: alcalde19 (€1.34 in chips) 
Seat 4: blout-blout (€4.23 in chips) 
Seat 5: loudydrix (€2.92 in chips) 
Seat 6: Pedrovsc21 (€2.61 in chips) 
pipinoelbreve9: posts small blind €0.01
alcalde19: posts big blind €0.02
*** HOLE CARDS ***
Dealt to pipinoelbreve9 [6h 8c]
blout-blout: folds 
loudydrix: folds 
Pedrovsc21: folds 
claret505: folds 
pipinoelbreve9: calls €0.01
alcalde19: checks 
*** FLOP *** [Qc 5c Js]
pipinoelbreve9: bets €0.02
alcalde19: folds 
Uncalled bet (€0.02) returned to pipinoelbreve9
pipinoelbreve9 collected €0.04 from pot
pipinoelbreve9: doesn't show hand 
*** SUMMARY ***
Total pot €0.04 | Rake €0 
Board [Qc 5c Js]
Seat 1: claret505 (button) folded before Flop (didn't bet)
Seat 2: pipinoelbreve9 (small blind) collected (€0.04)
Seat 3: alcalde19 (big blind) folded on the Flop
Seat 4: blout-blout folded before Flop (didn't bet)
Seat 5: loudydrix folded before Flop (didn't bet)
Seat 6: Pedrovsc21 folded before Flop (didn't bet)



PokerStars Zoom Hand #257689036887:  Hold'em No Limit (€0.01/€0.02) - 2025/09/10 18:01:20 CET [2025/09/10 12:01:20 ET]
Table 'Arneb' 6-max Seat #1 is the button
Seat 1: jeannono24 (€2 in chips) 
Seat 2: remiiiiiiii (€2.10 in chips) 
Seat 3: Dood Francisco (€2.53 in chips) 
Seat 4: linto2800 (€2.84 in chips) 
Seat 5: pipinoelbreve9 (€2.41 in chips) 
Seat 6: soyeterno (€0.75 in chips) 
remiiiiiiii: posts small blind €0.01
Dood Francisco: posts big blind €0.02
*** HOLE CARDS ***
Dealt to pipinoelbreve9 [3s 8d]
linto2800: raises €0.03 to €0.05
pipinoelbreve9: folds 
soyeterno: folds 
jeannono24: folds 
remiiiiiiii: folds 
Dood Francisco: calls €0.03
*** FLOP *** [7s Td 5c]
Dood Francisco: checks 
linto2800: bets €0.05
Dood Francisco: folds 
Uncalled bet (€0.05) returned to linto2800
linto2800 collected €0.10 from pot
linto2800: doesn't show hand 
*** SUMMARY ***
Total pot €0.11 | Rake €0.01 
Board [7s Td 5c]
Seat 1: jeannono24 (button) folded before Flop (didn't bet)
Seat 2: remiiiiiiii (small blind) folded before Flop
Seat 3: Dood Francisco (big blind) folded on the Flop
Seat 4: linto2800 collected (€0.10)
Seat 5: pipinoelbreve9 folded before Flop (didn't bet)
Seat 6: soyeterno folded before Flop (didn't bet)



PokerStars Zoom Hand #257689037554:  Hold'em No Limit (€0.01/€0.02) - 2025/09/10 18:01:25 CET [2025/09/10 12:01:25 ET]
Table 'Arneb' 6-max Seat #1 is the button
Seat 1: spiritwarrior29 (€1.83 in chips) 
Seat 2: cuenca10 (€3.22 in chips) 
Seat 3: pipinoelbreve9 (€2.41 in chips) 
Seat 4: Siddharta33 (€1.07 in chips) 
Seat 5: DavSnook (€1.74 in chips) 
Seat 6: alvlugom (€1.95 in chips) 
cuenca10: posts small blind €0.01
pipinoelbreve9: posts big blind €0.02
*** HOLE CARDS ***
Dealt to pipinoelbreve9 [Ks 4s]
Siddharta33: folds 
DavSnook: raises €0.05 to €0.07
alvlugom: folds 
spiritwarrior29: folds 
cuenca10: folds 
pipinoelbreve9: calls €0.05
*** FLOP *** [5c Ts Tc]
pipinoelbreve9: checks 
DavSnook: bets €0.07
pipinoelbreve9: folds 
Uncalled bet (€0.07) returned to DavSnook
DavSnook collected €0.14 from pot
DavSnook: doesn't show hand 
*** SUMMARY ***
Total pot €0.15 | Rake €0.01 
Board [5c Ts Tc]
Seat 1: spiritwarrior29 (button) folded before Flop (didn't bet)
Seat 2: cuenca10 (small blind) folded before Flop
Seat 3: pipinoelbreve9 (big blind) folded on the Flop
Seat 4: Siddharta33 folded before Flop (didn't bet)
Seat 5: DavSnook collected (€0.14)
Seat 6: alvlugom folded before Flop (didn't bet)



PokerStars Zoom Hand #257689041183:  Hold'em No Limit (€0.01/€0.02) - 2025/09/10 18:01:46 CET [2025/09/10 12:01:46 ET]
Table 'Arneb' 6-max Seat #1 is the button
Seat 1: MDKristian (€2 in chips) 
Seat 2: JENOFONTE73 (€3.02 in chips) 
Seat 3: jeannono24 (€2.26 in chips) 
Seat 4: pipinoelbreve9 (€2.34 in chips) 
Seat 5: chonji24 (€2.08 in chips) 
Seat 6: CORDEVIGO (€5.36 in chips) 
JENOFONTE73: posts small blind €0.01
jeannono24: posts big blind €0.02
*** HOLE CARDS ***
Dealt to pipinoelbreve9 [Qs 5c]
pipinoelbreve9: folds 
chonji24: folds 
CORDEVIGO: raises €0.04 to €0.06
MDKristian: folds 
JENOFONTE73: folds 
jeannono24: folds 
Uncalled bet (€0.04) returned to CORDEVIGO
CORDEVIGO collected €0.05 from pot
CORDEVIGO: doesn't show hand 
*** SUMMARY ***
Total pot €0.05 | Rake €0 
Seat 1: MDKristian (button) folded before Flop (didn't bet)
Seat 2: JENOFONTE73 (small blind) folded before Flop
Seat 3: jeannono24 (big blind) folded before Flop
Seat 4: pipinoelbreve9 folded before Flop (didn't bet)
Seat 5: chonji24 folded before Flop (didn't bet)
Seat 6: CORDEVIGO collected (€0.05)



PokerStars Zoom Hand #257689042443:  Hold'em No Limit (€0.01/€0.02) - 2025/09/10 18:01:53 CET [2025/09/10 12:01:53 ET]
Table 'Arneb' 6-max Seat #1 is the button
Seat 1: pipinoelbreve9 (€2.34 in chips) 
Seat 2: chonji24 (€2.08 in chips) 
Seat 3: jeannono24 (€2 in chips) 
Seat 4: Doblea315 (€2.35 in chips) 
Seat 5: vaness47985 (€1.87 in chips) 
Seat 6: Dood Francisco (€2.47 in chips) 
chonji24: posts small blind €0.01
jeannono24: posts big blind €0.02
*** HOLE CARDS ***
Dealt to pipinoelbreve9 [Kd Qd]
Doblea315: folds 
vaness47985: folds 
Dood Francisco: folds 
pipinoelbreve9: raises €0.04 to €0.06
chonji24: folds 
jeannono24: calls €0.04
*** FLOP *** [9h 8c 9c]
jeannono24: checks 
pipinoelbreve9: bets €0.06
jeannono24: calls €0.06
*** TURN *** [9h 8c 9c] [4c]
jeannono24: checks 
pipinoelbreve9: bets €0.24
jeannono24: folds 
Uncalled bet (€0.24) returned to pipinoelbreve9
pipinoelbreve9 collected €0.24 from pot
pipinoelbreve9: doesn't show hand 
*** SUMMARY ***
Total pot €0.25 | Rake €0.01 
Board [9h 8c 9c 4c]
Seat 1: pipinoelbreve9 (button) collected (€0.24)
Seat 2: chonji24 (small blind) folded before Flop
Seat 3: jeannono24 (big blind) folded on the Turn
Seat 4: Doblea315 folded before Flop (didn't bet)
Seat 5: vaness47985 folded before Flop (didn't bet)
Seat 6: Dood Francisco folded before Flop (didn't bet)



PokerStars Zoom Hand #257689049783:  Hold'em No Limit (€0.01/€0.02) - 2025/09/10 18:02:35 CET [2025/09/10 12:02:35 ET]
Table 'Arneb' 6-max Seat #1 is the button
Seat 1: alvlugom (€2.14 in chips) 
Seat 2: Ruben1990869 (€2.11 in chips) 
Seat 3: jeannono24 (€2.16 in chips) 
Seat 4: orosa (€2.09 in chips) 
Seat 5: pipinoelbreve9 (€2.46 in chips) 
Seat 6: fvprodigy (€2.26 in chips) 
Ruben1990869: posts small blind €0.01
jeannono24: posts big blind €0.02
*** HOLE CARDS ***
Dealt to pipinoelbreve9 [7d 2h]
orosa: folds 
pipinoelbreve9: folds 
fvprodigy: folds 
alvlugom: folds 
Ruben1990869: raises €0.04 to €0.06
jeannono24: raises €0.12 to €0.18
Ruben1990869: folds 
Uncalled bet (€0.12) returned to jeannono24
jeannono24 collected €0.12 from pot
jeannono24: doesn't show hand 
*** SUMMARY ***
Total pot €0.12 | Rake €0 
Seat 1: alvlugom (button) folded before Flop (didn't bet)
Seat 2: Ruben1990869 (small blind) folded before Flop
Seat 3: jeannono24 (big blind) collected (€0.12)
Seat 4: orosa folded before Flop (didn't bet)
Seat 5: pipinoelbreve9 folded before Flop (didn't bet)
Seat 6: fvprodigy folded before Flop (didn't bet)



PokerStars Zoom Hand #257689051456:  Hold'em No Limit (€0.01/€0.02) - 2025/09/10 18:02:44 CET [2025/09/10 12:02:44 ET]
Table 'Arneb' 6-max Seat #1 is the button
Seat 1: pipinoelbreve9 (€2.46 in chips) 
Seat 2: Dood Francisco (€2.55 in chips) 
Seat 3: MDKristian (€2.03 in chips) 
Seat 4: SMN242 (€2.37 in chips) 
Seat 5: Alejandr_666 (€1.46 in chips) 
Seat 6: troptar (€0.86 in chips) 
Dood Francisco: posts small blind €0.01
MDKristian: posts big blind €0.02
*** HOLE CARDS ***
Dealt to pipinoelbreve9 [Th 9c]
SMN242: raises €0.03 to €0.05
Alejandr_666: folds 
troptar: calls €0.05
pipinoelbreve9: folds 
Dood Francisco: folds 
MDKristian: folds 
*** FLOP *** [9h 8s Ac]
SMN242: bets €0.06
troptar: calls €0.06
*** TURN *** [9h 8s Ac] [5d]
SMN242: bets €0.12
troptar: calls €0.12
*** RIVER *** [9h 8s Ac 5d] [4d]
SMN242: bets €0.16
troptar: folds 
Uncalled bet (€0.16) returned to SMN242
SMN242 collected €0.47 from pot
SMN242: doesn't show hand 
*** SUMMARY ***
Total pot €0.49 | Rake €0.02 
Board [9h 8s Ac 5d 4d]
Seat 1: pipinoelbreve9 (button) folded before Flop (didn't bet)
Seat 2: Dood Francisco (small blind) folded before Flop
Seat 3: MDKristian (big blind) folded before Flop
Seat 4: SMN242 collected (€0.47)
Seat 5: Alejandr_666 folded before Flop (didn't bet)
Seat 6: troptar folded on the River



PokerStars Zoom Hand #257689053108:  Hold'em No Limit (€0.01/€0.02) - 2025/09/10 18:02:53 CET [2025/09/10 12:02:53 ET]
Table 'Arneb' 6-max Seat #1 is the button
Seat 1: spiritwarrior29 (€3.43 in chips) 
Seat 2: pipinoelbreve9 (€2.46 in chips) 
Seat 3: orosa (€2.08 in chips) 
Seat 4: CORDEVIGO (€5.42 in chips) 
Seat 5: DavSnook (€3.62 in chips) 
Seat 6: MDKristian (€2.01 in chips) 
pipinoelbreve9: posts small blind €0.01
orosa: posts big blind €0.02
*** HOLE CARDS ***
Dealt to pipinoelbreve9 [Qc 6s]
CORDEVIGO: folds 
DavSnook: raises €0.05 to €0.07
MDKristian: folds 
spiritwarrior29: folds 
pipinoelbreve9: folds 
orosa: folds 
Uncalled bet (€0.05) returned to DavSnook
DavSnook collected €0.05 from pot
DavSnook: doesn't show hand 
*** SUMMARY ***
Total pot €0.05 | Rake €0 
Seat 1: spiritwarrior29 (button) folded before Flop (didn't bet)
Seat 2: pipinoelbreve9 (small blind) folded before Flop
Seat 3: orosa (big blind) folded before Flop
Seat 4: CORDEVIGO folded before Flop (didn't bet)
Seat 5: DavSnook collected (€0.05)
Seat 6: MDKristian folded before Flop (didn't bet)



PokerStars Zoom Hand #257689050881:  Hold'em No Limit (€0.01/€0.02) - 2025/09/10 18:02:40 CET [2025/09/10 12:02:40 ET]
Table 'Arneb' 6-max Seat #1 is the button
Seat 1: fvprodigy (€2.26 in chips) 
Seat 2: mxaencew (€1.26 in chips) 
Seat 3: Masticore1 (€1.70 in chips) 
Seat 4: pipinoelbreve9 (€2.46 in chips) 
Seat 5: caroleli10 (€6.32 in chips) 
Seat 6: JENOFONTE73 (€3.13 in chips) 
mxaencew: posts small blind €0.01
Masticore1: posts big blind €0.02
*** HOLE CARDS ***
Dealt to pipinoelbreve9 [6d Qh]
pipinoelbreve9: folds 
caroleli10: folds 
JENOFONTE73: folds 
fvprodigy: folds 
mxaencew: calls €0.01
Masticore1: raises €0.08 to €0.10
mxaencew: calls €0.08
*** FLOP *** [8s 5h 9c]
mxaencew: checks 
Masticore1: checks 
*** TURN *** [8s 5h 9c] [3c]
mxaencew: checks 
Masticore1: bets €0.16
mxaencew: calls €0.16
*** RIVER *** [8s 5h 9c 3c] [9d]
mxaencew: checks 
Masticore1: checks 
*** SHOW DOWN ***
mxaencew: shows [Jc Jd] (two pair, Jacks and Nines)
Masticore1: mucks hand 
mxaencew collected €0.49 from pot
*** SUMMARY ***
Total pot €0.52 | Rake €0.03 
Board [8s 5h 9c 3c 9d]
Seat 1: fvprodigy (button) folded before Flop (didn't bet)
Seat 2: mxaencew (small blind) showed [Jc Jd] and won (€0.49) with two pair, Jacks and Nines
Seat 3: Masticore1 (big blind) mucked [Kh Ac]
Seat 4: pipinoelbreve9 folded before Flop (didn't bet)
Seat 5: caroleli10 folded before Flop (didn't bet)
Seat 6: JENOFONTE73 folded before Flop (didn't bet)



PokerStars Zoom Hand #257689057410:  Hold'em No Limit (€0.01/€0.02) - 2025/09/10 18:03:15 CET [2025/09/10 12:03:15 ET]
Table 'Arneb' 6-max Seat #1 is the button
Seat 1: Hotspot9119 (€2.90 in chips) 
Seat 2: danitorpedo (€1.35 in chips) 
Seat 3: pipinoelbreve9 (€2.45 in chips) 
Seat 4: cuenca10 (€3.13 in chips) 
Seat 5: PARAG00MBA (€2.61 in chips) 
Seat 6: Elons_Mucks (€2.35 in chips) 
danitorpedo: posts small blind €0.01
pipinoelbreve9: posts big blind €0.02
*** HOLE CARDS ***
Dealt to pipinoelbreve9 [8c 5h]
cuenca10: folds 
PARAG00MBA: raises €0.03 to €0.05
Elons_Mucks: folds 
Hotspot9119: folds 
danitorpedo: folds 
pipinoelbreve9: folds 
Uncalled bet (€0.03) returned to PARAG00MBA
PARAG00MBA collected €0.05 from pot
PARAG00MBA: doesn't show hand 
*** SUMMARY ***
Total pot €0.05 | Rake €0 
Seat 1: Hotspot9119 (button) folded before Flop (didn't bet)
Seat 2: danitorpedo (small blind) folded before Flop
Seat 3: pipinoelbreve9 (big blind) folded before Flop
Seat 4: cuenca10 folded before Flop (didn't bet)
Seat 5: PARAG00MBA collected (€0.05)
Seat 6: Elons_Mucks folded before Flop (didn't bet)



PokerStars Zoom Hand #257689059686:  Hold'em No Limit (€0.01/€0.02) - 2025/09/10 18:03:28 CET [2025/09/10 12:03:28 ET]
Table 'Arneb' 6-max Seat #1 is the button
Seat 1: soyeterno (€3.20 in chips) 
Seat 2: smrj1976 (€1.99 in chips) 
Seat 3: orosa (€2.26 in chips) 
Seat 4: remiiiiiiii (€2.04 in chips) 
Seat 5: Alejandr_666 (€1.42 in chips) 
Seat 6: pipinoelbreve9 (€2.43 in chips) 
smrj1976: posts small blind €0.01
orosa: posts big blind €0.02
*** HOLE CARDS ***
Dealt to pipinoelbreve9 [Js Qs]
remiiiiiiii: folds 
Alejandr_666 is disconnected 
Alejandr_666 has timed out while disconnected
Alejandr_666: folds 
pipinoelbreve9: raises €0.04 to €0.06
soyeterno: folds 
smrj1976: folds 
orosa: folds 
Uncalled bet (€0.04) returned to pipinoelbreve9
pipinoelbreve9 collected €0.05 from pot
pipinoelbreve9: doesn't show hand 
*** SUMMARY ***
Total pot €0.05 | Rake €0 
Seat 1: soyeterno (button) folded before Flop (didn't bet)
Seat 2: smrj1976 (small blind) folded before Flop
Seat 3: orosa (big blind) folded before Flop
Seat 4: remiiiiiiii folded before Flop (didn't bet)
Seat 5: Alejandr_666 folded before Flop (didn't bet)
Seat 6: pipinoelbreve9 collected (€0.05)



PokerStars Zoom Hand #257689063433:  Hold'em No Limit (€0.01/€0.02) - 2025/09/10 18:03:48 CET [2025/09/10 12:03:48 ET]
Table 'Arneb' 6-max Seat #1 is the button
Seat 1: profequimica66 (€0.58 in chips) 
Seat 2: caroleli10 (€6.12 in chips) 
Seat 3: Siddharta33 (€3.06 in chips) 
Seat 4: pipinoelbreve9 (€2.46 in chips) 
Seat 5: eyeeel (€0.56 in chips) 
Seat 6: orosa (€2.24 in chips) 
caroleli10: posts small blind €0.01
Siddharta33: posts big blind €0.02
*** HOLE CARDS ***
Dealt to pipinoelbreve9 [7s 5s]
pipinoelbreve9: folds 
eyeeel: folds 
orosa: folds 
profequimica66: folds 
caroleli10: raises €0.04 to €0.06
Siddharta33: folds 
Uncalled bet (€0.04) returned to caroleli10
caroleli10 collected €0.04 from pot
caroleli10: doesn't show hand 
*** SUMMARY ***
Total pot €0.04 | Rake €0 
Seat 1: profequimica66 (button) folded before Flop (didn't bet)
Seat 2: caroleli10 (small blind) collected (€0.04)
Seat 3: Siddharta33 (big blind) folded before Flop
Seat 4: pipinoelbreve9 folded before Flop (didn't bet)
Seat 5: eyeeel folded before Flop (didn't bet)
Seat 6: orosa folded before Flop (didn't bet)



PokerStars Zoom Hand #257689065631:  Hold'em No Limit (€0.01/€0.02) - 2025/09/10 18:04:00 CET [2025/09/10 12:04:00 ET]
Table 'Arneb' 6-max Seat #1 is the button
Seat 1: Sportacus911 (€2.43 in chips) 
Seat 2: jeannono24 (€2.02 in chips) 
Seat 3: serviettski(fr) (€2 in chips) 
Seat 4: Crubiov_1978 (€0.42 in chips) 
Seat 5: pipinoelbreve9 (€2.46 in chips) 
Seat 6: Doblea315 (€2.26 in chips) 
jeannono24: posts small blind €0.01
serviettski(fr): posts big blind €0.02
*** HOLE CARDS ***
Dealt to pipinoelbreve9 [Th 2s]
Crubiov_1978: folds 
pipinoelbreve9: folds 
Doblea315: folds 
Sportacus911: folds 
jeannono24: raises €0.04 to €0.06
serviettski(fr): folds 
Uncalled bet (€0.04) returned to jeannono24
jeannono24 collected €0.04 from pot
jeannono24: doesn't show hand 
*** SUMMARY ***
Total pot €0.04 | Rake €0 
Seat 1: Sportacus911 (button) folded before Flop (didn't bet)
Seat 2: jeannono24 (small blind) collected (€0.04)
Seat 3: serviettski(fr) (big blind) folded before Flop
Seat 4: Crubiov_1978 folded before Flop (didn't bet)
Seat 5: pipinoelbreve9 folded before Flop (didn't bet)
Seat 6: Doblea315 folded before Flop (didn't bet)



PokerStars Zoom Hand #257689067222:  Hold'em No Limit (€0.01/€0.02) - 2025/09/10 18:04:08 CET [2025/09/10 12:04:08 ET]
Table 'Arneb' 6-max Seat #1 is the button
Seat 1: pastor2611 (€0.72 in chips) 
Seat 2: Abrelatas787 (€2 in chips) 
Seat 3: pipinoelbreve9 (€2.46 in chips) 
Seat 4: AFRAGIL79 (€1.81 in chips) 
Seat 5: JENOFONTE73 (€3.06 in chips) 
Seat 6: dragonfly2467 (€2 in chips) 
Abrelatas787: posts small blind €0.01
pipinoelbreve9: posts big blind €0.02
*** HOLE CARDS ***
Dealt to pipinoelbreve9 [7d Td]
AFRAGIL79: folds 
JENOFONTE73: folds 
dragonfly2467: raises €0.04 to €0.06
pastor2611: folds 
Abrelatas787: folds 
pipinoelbreve9: folds 
Uncalled bet (€0.04) returned to dragonfly2467
dragonfly2467 collected €0.05 from pot
dragonfly2467: doesn't show hand 
*** SUMMARY ***
Total pot €0.05 | Rake €0 
Seat 1: pastor2611 (button) folded before Flop (didn't bet)
Seat 2: Abrelatas787 (small blind) folded before Flop
Seat 3: pipinoelbreve9 (big blind) folded before Flop
Seat 4: AFRAGIL79 folded before Flop (didn't bet)
Seat 5: JENOFONTE73 folded before Flop (didn't bet)
Seat 6: dragonfly2467 collected (€0.05)



PokerStars Zoom Hand #257689069685:  Hold'em No Limit (€0.01/€0.02) - 2025/09/10 18:04:21 CET [2025/09/10 12:04:21 ET]
Table 'Arneb' 6-max Seat #1 is the button
Seat 1: MDKristian (€2.66 in chips) 
Seat 2: pipinoelbreve9 (€2.44 in chips) 
Seat 3: ssjimmyss88 (€0.96 in chips) 
Seat 4: DavSnook (€5.06 in chips) 
Seat 5: spiritwarrior29 (€1.70 in chips) 
Seat 6: caroleli10 (€2.95 in chips) 
pipinoelbreve9: posts small blind €0.01
ssjimmyss88: posts big blind €0.02
*** HOLE CARDS ***
Dealt to pipinoelbreve9 [8c Th]
DavSnook: folds 
spiritwarrior29: folds 
caroleli10: folds 
MDKristian: folds 
pipinoelbreve9: folds 
Uncalled bet (€0.01) returned to ssjimmyss88
ssjimmyss88 collected €0.02 from pot
ssjimmyss88: doesn't show hand 
*** SUMMARY ***
Total pot €0.02 | Rake €0 
Seat 1: MDKristian (button) folded before Flop (didn't bet)
Seat 2: pipinoelbreve9 (small blind) folded before Flop
Seat 3: ssjimmyss88 (big blind) collected (€0.02)
Seat 4: DavSnook folded before Flop (didn't bet)
Seat 5: spiritwarrior29 folded before Flop (didn't bet)
Seat 6: caroleli10 folded before Flop (didn't bet)



PokerStars Zoom Hand #257689070433:  Hold'em No Limit (€0.01/€0.02) - 2025/09/10 18:04:25 CET [2025/09/10 12:04:25 ET]
Table 'Arneb' 6-max Seat #1 is the button
Seat 1: pipinoelbreve9 (€2.43 in chips) 
Seat 2: iam_xCidx (€2.15 in chips) 
Seat 3: mxaencew (€1.60 in chips) 
Seat 4: pastor2611 (€0.72 in chips) 
Seat 5: claret505 (€1.95 in chips) 
Seat 6: jeannono24 (€2.26 in chips) 
iam_xCidx: posts small blind €0.01
mxaencew: posts big blind €0.02
*** HOLE CARDS ***
Dealt to pipinoelbreve9 [3c Jh]
pastor2611: folds 
claret505: calls €0.02
jeannono24: folds 
pipinoelbreve9: folds 
iam_xCidx: folds 
mxaencew: checks 
*** FLOP *** [5d 7h Td]
mxaencew: checks 
claret505: checks 
*** TURN *** [5d 7h Td] [6s]
mxaencew: checks 
claret505: bets €0.02
mxaencew: folds 
Uncalled bet (€0.02) returned to claret505
claret505 collected €0.05 from pot
claret505: doesn't show hand 
*** SUMMARY ***
Total pot €0.05 | Rake €0 
Board [5d 7h Td 6s]
Seat 1: pipinoelbreve9 (button) folded before Flop (didn't bet)
Seat 2: iam_xCidx (small blind) folded before Flop
Seat 3: mxaencew (big blind) folded on the Turn
Seat 4: pastor2611 folded before Flop (didn't bet)
Seat 5: claret505 collected (€0.05)
Seat 6: jeannono24 folded before Flop (didn't bet)



PokerStars Zoom Hand #257689072215:  Hold'em No Limit (€0.01/€0.02) - 2025/09/10 18:04:34 CET [2025/09/10 12:04:34 ET]
Table 'Arneb' 6-max Seat #1 is the button
Seat 1: SMN242 (€2.47 in chips) 
Seat 2: JENOFONTE73 (€3.07 in chips) 
Seat 3: nometoquesloshu (€0.94 in chips) 
Seat 4: pipinoelbreve9 (€2.43 in chips) 
Seat 5: raptureman1 (€4.30 in chips) 
Seat 6: Doblea315 (€5.59 in chips) 
JENOFONTE73: posts small blind €0.01
nometoquesloshu: posts big blind €0.02
*** HOLE CARDS ***
Dealt to pipinoelbreve9 [Kh 3d]
pipinoelbreve9: folds 
raptureman1: folds 
Doblea315: folds 
SMN242: folds 
JENOFONTE73: folds 
Uncalled bet (€0.01) returned to nometoquesloshu
nometoquesloshu collected €0.02 from pot
nometoquesloshu: doesn't show hand 
*** SUMMARY ***
Total pot €0.02 | Rake €0 
Seat 1: SMN242 (button) folded before Flop (didn't bet)
Seat 2: JENOFONTE73 (small blind) folded before Flop
Seat 3: nometoquesloshu (big blind) collected (€0.02)
Seat 4: pipinoelbreve9 folded before Flop (didn't bet)
Seat 5: raptureman1 folded before Flop (didn't bet)
Seat 6: Doblea315 folded before Flop (didn't bet)



PokerStars Zoom Hand #257689074122:  Hold'em No Limit (€0.01/€0.02) - 2025/09/10 18:04:45 CET [2025/09/10 12:04:45 ET]
Table 'Arneb' 6-max Seat #1 is the button
Seat 1: chonji24 (€2.59 in chips) 
Seat 2: alvlugom (€2.80 in chips) 
Seat 3: Crubiov_1978 (€0.34 in chips) 
Seat 4: Doblea315 (€2.14 in chips) 
Seat 5: marcel13013 (€1.21 in chips) 
Seat 6: pipinoelbreve9 (€2.43 in chips) 
alvlugom: posts small blind €0.01
Crubiov_1978: posts big blind €0.02
*** HOLE CARDS ***
Dealt to pipinoelbreve9 [6s 5d]
Doblea315: folds 
marcel13013: calls €0.02
pipinoelbreve9: folds 
chonji24: folds 
alvlugom: folds 
Crubiov_1978: checks 
*** FLOP *** [9h Tc 5c]
Crubiov_1978: checks 
marcel13013: checks 
*** TURN *** [9h Tc 5c] [8d]
Crubiov_1978: checks 
marcel13013: checks 
*** RIVER *** [9h Tc 5c 8d] [8s]
Crubiov_1978: checks 
marcel13013: checks 
*** SHOW DOWN ***
Crubiov_1978: shows [Qh 3d] (a pair of Eights)
marcel13013: shows [2c Ac] (a pair of Eights - Ace kicker)
marcel13013 collected €0.05 from pot
*** SUMMARY ***
Total pot €0.05 | Rake €0 
Board [9h Tc 5c 8d 8s]
Seat 1: chonji24 (button) folded before Flop (didn't bet)
Seat 2: alvlugom (small blind) folded before Flop
Seat 3: Crubiov_1978 (big blind) showed [Qh 3d] and lost with a pair of Eights
Seat 4: Doblea315 folded before Flop (didn't bet)
Seat 5: marcel13013 showed [2c Ac] and won (€0.05) with a pair of Eights
Seat 6: pipinoelbreve9 folded before Flop (didn't bet)



PokerStars Zoom Hand #257689071570:  Hold'em No Limit (€0.01/€0.02) - 2025/09/10 18:04:31 CET [2025/09/10 12:04:31 ET]
Table 'Arneb' 6-max Seat #1 is the button
Seat 1: orosa (€2 in chips) 
Seat 2: nometoquesloshu (€0.95 in chips) 
Seat 3: remiiiiiiii (€2.04 in chips) 
Seat 4: Ruben1990869 (€2 in chips) 
Seat 5: blout-blout (€4.07 in chips) 
Seat 6: pipinoelbreve9 (€2.43 in chips) 
nometoquesloshu: posts small blind €0.01
remiiiiiiii: posts big blind €0.02
*** HOLE CARDS ***
Dealt to pipinoelbreve9 [5s Td]
Ruben1990869: folds 
blout-blout: calls €0.02
pipinoelbreve9: folds 
orosa: folds 
nometoquesloshu: folds 
remiiiiiiii: checks 
*** FLOP *** [9s Qh 5h]
remiiiiiiii: checks 
blout-blout: checks 
*** TURN *** [9s Qh 5h] [3h]
remiiiiiiii: checks 
blout-blout: checks 
*** RIVER *** [9s Qh 5h 3h] [6c]
remiiiiiiii: checks 
blout-blout: checks 
*** SHOW DOWN ***
remiiiiiiii: shows [8c 5c] (a pair of Fives)
blout-blout: mucks hand 
remiiiiiiii collected €0.05 from pot
*** SUMMARY ***
Total pot €0.05 | Rake €0 
Board [9s Qh 5h 3h 6c]
Seat 1: orosa (button) folded before Flop (didn't bet)
Seat 2: nometoquesloshu (small blind) folded before Flop
Seat 3: remiiiiiiii (big blind) showed [8c 5c] and won (€0.05) with a pair of Fives
Seat 4: Ruben1990869 folded before Flop (didn't bet)
Seat 5: blout-blout mucked [As 7c]
Seat 6: pipinoelbreve9 folded before Flop (didn't bet)



PokerStars Zoom Hand #257689073011:  Hold'em No Limit (€0.01/€0.02) - 2025/09/10 18:04:39 CET [2025/09/10 12:04:39 ET]
Table 'Arneb' 6-max Seat #1 is the button
Seat 1: troptar (€0.59 in chips) 
Seat 2: Hugo OGM (€2.02 in chips) 
Seat 3: FAUCES (€2 in chips) 
Seat 4: candarias (€3.03 in chips) 
Seat 5: pipinoelbreve9 (€2.43 in chips) 
Seat 6: Siddharta33 (€1.15 in chips) 
Hugo OGM: posts small blind €0.01
FAUCES: posts big blind €0.02
*** HOLE CARDS ***
Dealt to pipinoelbreve9 [8c 6c]
candarias: folds 
pipinoelbreve9: folds 
Siddharta33: folds 
troptar: calls €0.02
Hugo OGM: calls €0.01
FAUCES: checks 
*** FLOP *** [7c Qd Td]
Hugo OGM: checks 
FAUCES: checks 
troptar: checks 
*** TURN *** [7c Qd Td] [4s]
Hugo OGM: checks 
FAUCES: checks 
troptar: bets €0.06
Hugo OGM: folds 
FAUCES: folds 
Uncalled bet (€0.06) returned to troptar
troptar collected €0.06 from pot
troptar: doesn't show hand 
*** SUMMARY ***
Total pot €0.06 | Rake €0 
Board [7c Qd Td 4s]
Seat 1: troptar (button) collected (€0.06)
Seat 2: Hugo OGM (small blind) folded on the Turn
Seat 3: FAUCES (big blind) folded on the Turn
Seat 4: candarias folded before Flop (didn't bet)
Seat 5: pipinoelbreve9 folded before Flop (didn't bet)
Seat 6: Siddharta33 folded before Flop (didn't bet)



PokerStars Zoom Hand #257689075608:  Hold'em No Limit (€0.01/€0.02) - 2025/09/10 18:04:52 CET [2025/09/10 12:04:52 ET]
Table 'Arneb' 6-max Seat #1 is the button
Seat 1: DavSnook (€3.90 in chips) 
Seat 2: pipinoelbreve9 (€2.43 in chips) 
Seat 3: chonji24 (€2.59 in chips) 
Seat 4: cherda33 (€2.91 in chips) 
Seat 5: serviettski(fr) (€2 in chips) 
Seat 6: nometoquesloshu (€0.95 in chips) 
pipinoelbreve9: posts small blind €0.01
chonji24: posts big blind €0.02
*** HOLE CARDS ***
Dealt to pipinoelbreve9 [As 7c]
cherda33: calls €0.02
serviettski(fr): folds 
nometoquesloshu: folds 
DavSnook: folds 
pipinoelbreve9: raises €0.06 to €0.08
chonji24: folds 
cherda33: calls €0.06
*** FLOP *** [8h 7h 6h]
pipinoelbreve9: bets €0.09
cherda33: raises €0.35 to €0.44
pipinoelbreve9: folds 
Uncalled bet (€0.35) returned to cherda33
cherda33 collected €0.34 from pot
cherda33: doesn't show hand 
*** SUMMARY ***
Total pot €0.36 | Rake €0.02 
Board [8h 7h 6h]
Seat 1: DavSnook (button) folded before Flop (didn't bet)
Seat 2: pipinoelbreve9 (small blind) folded on the Flop
Seat 3: chonji24 (big blind) folded before Flop
Seat 4: cherda33 collected (€0.34)
Seat 5: serviettski(fr) folded before Flop (didn't bet)
Seat 6: nometoquesloshu folded before Flop (didn't bet)



PokerStars Zoom Hand #257689081716:  Hold'em No Limit (€0.01/€0.02) - 2025/09/10 18:05:25 CET [2025/09/10 12:05:25 ET]
Table 'Arneb' 6-max Seat #1 is the button
Seat 1: Popins0011 (€4.62 in chips) 
Seat 2: dragonfly2467 (€2 in chips) 
Seat 3: pipinoelbreve9 (€2.26 in chips) 
Seat 4: jeannono24 (€2 in chips) 
Seat 5: Diegot2119 (€1.93 in chips) 
Seat 6: JENOFONTE73 (€1.33 in chips) 
dragonfly2467: posts small blind €0.01
pipinoelbreve9: posts big blind €0.02
*** HOLE CARDS ***
Dealt to pipinoelbreve9 [5c 7c]
jeannono24: folds 
Diegot2119 is disconnected 
Diegot2119 has timed out while disconnected
Diegot2119: folds 
JENOFONTE73: raises €0.03 to €0.05
Popins0011: folds 
dragonfly2467: folds 
pipinoelbreve9: folds 
Uncalled bet (€0.03) returned to JENOFONTE73
JENOFONTE73 collected €0.05 from pot
JENOFONTE73: doesn't show hand 
*** SUMMARY ***
Total pot €0.05 | Rake €0 
Seat 1: Popins0011 (button) folded before Flop (didn't bet)
Seat 2: dragonfly2467 (small blind) folded before Flop
Seat 3: pipinoelbreve9 (big blind) folded before Flop
Seat 4: jeannono24 folded before Flop (didn't bet)
Seat 5: Diegot2119 folded before Flop (didn't bet)
Seat 6: JENOFONTE73 collected (€0.05)



PokerStars Zoom Hand #257689086433:  Hold'em No Limit (€0.01/€0.02) - 2025/09/10 18:05:49 CET [2025/09/10 12:05:49 ET]
Table 'Arneb' 6-max Seat #1 is the button
Seat 1: pipinoelbreve9 (€2.24 in chips) 
Seat 2: JENOFONTE73 (€1.36 in chips) 
Seat 3: serviettski(fr) (€2 in chips) 
Seat 4: Crubiov_1978 (€0.30 in chips) 
Seat 5: caroleli10 (€3.08 in chips) 
Seat 6: DavSnook (€3.62 in chips) 
JENOFONTE73: posts small blind €0.01
serviettski(fr): posts big blind €0.02
*** HOLE CARDS ***
Dealt to pipinoelbreve9 [5c 3d]
Crubiov_1978: folds 
caroleli10: folds 
DavSnook: raises €0.05 to €0.07
pipinoelbreve9: folds 
JENOFONTE73: folds 
serviettski(fr): folds 
Uncalled bet (€0.05) returned to DavSnook
DavSnook collected €0.05 from pot
DavSnook: doesn't show hand 
*** SUMMARY ***
Total pot €0.05 | Rake €0 
Seat 1: pipinoelbreve9 (button) folded before Flop (didn't bet)
Seat 2: JENOFONTE73 (small blind) folded before Flop
Seat 3: serviettski(fr) (big blind) folded before Flop
Seat 4: Crubiov_1978 folded before Flop (didn't bet)
Seat 5: caroleli10 folded before Flop (didn't bet)
Seat 6: DavSnook collected (€0.05)



PokerStars Zoom Hand #257689088172:  Hold'em No Limit (€0.01/€0.02) - 2025/09/10 18:05:58 CET [2025/09/10 12:05:58 ET]
Table 'Arneb' 6-max Seat #1 is the button
Seat 1: Hugo OGM (€2 in chips) 
Seat 2: easywithnuts84 (€2.51 in chips) 
Seat 3: DavSnook (€3.67 in chips) 
Seat 4: smrj1976 (€1.74 in chips) 
Seat 5: pipinoelbreve9 (€2.24 in chips) 
Seat 6: jeannono24 (€2.21 in chips) 
easywithnuts84: posts small blind €0.01
DavSnook: posts big blind €0.02
*** HOLE CARDS ***
Dealt to pipinoelbreve9 [3s 5h]
smrj1976: folds 
pipinoelbreve9: folds 
jeannono24: folds 
Hugo OGM: folds 
easywithnuts84: raises €0.04 to €0.06
DavSnook: folds 
Uncalled bet (€0.04) returned to easywithnuts84
easywithnuts84 collected €0.04 from pot
easywithnuts84: doesn't show hand 
*** SUMMARY ***
Total pot €0.04 | Rake €0 
Seat 1: Hugo OGM (button) folded before Flop (didn't bet)
Seat 2: easywithnuts84 (small blind) collected (€0.04)
Seat 3: DavSnook (big blind) folded before Flop
Seat 4: smrj1976 folded before Flop (didn't bet)
Seat 5: pipinoelbreve9 folded before Flop (didn't bet)
Seat 6: jeannono24 folded before Flop (didn't bet)



PokerStars Zoom Hand #257689087267:  Hold'em No Limit (€0.01/€0.02) - 2025/09/10 18:05:53 CET [2025/09/10 12:05:53 ET]
Table 'Arneb' 6-max Seat #1 is the button
Seat 1: caroleli10 (€3.08 in chips) 
Seat 2: Crubiov_1978 (€0.30 in chips) 
Seat 3: Elons_Mucks (€2.42 in chips) 
Seat 4: pipinoelbreve9 (€2.24 in chips) 
Seat 5: smrj1976 (€1.74 in chips) 
Seat 6: claret505 (€1.86 in chips) 
Crubiov_1978: posts small blind €0.01
Elons_Mucks: posts big blind €0.02
*** HOLE CARDS ***
Dealt to pipinoelbreve9 [8c As]
pipinoelbreve9: folds 
smrj1976: folds 
claret505: folds 
caroleli10: folds 
Crubiov_1978: raises €0.02 to €0.04
Elons_Mucks: raises €0.14 to €0.18
Crubiov_1978: raises €0.12 to €0.30 and is all-in
Elons_Mucks: calls €0.12
*** FLOP *** [5d 4s Kh]
*** TURN *** [5d 4s Kh] [3h]
*** RIVER *** [5d 4s Kh 3h] [Th]
*** SHOW DOWN ***
Crubiov_1978: shows [Qh Qs] (a pair of Queens)
Elons_Mucks: shows [Ad Kc] (a pair of Kings)
Elons_Mucks collected €0.57 from pot
*** SUMMARY ***
Total pot €0.60 | Rake €0.03 
Board [5d 4s Kh 3h Th]
Seat 1: caroleli10 (button) folded before Flop (didn't bet)
Seat 2: Crubiov_1978 (small blind) showed [Qh Qs] and lost with a pair of Queens
Seat 3: Elons_Mucks (big blind) showed [Ad Kc] and won (€0.57) with a pair of Kings
Seat 4: pipinoelbreve9 folded before Flop (didn't bet)
Seat 5: smrj1976 folded before Flop (didn't bet)
Seat 6: claret505 folded before Flop (didn't bet)



PokerStars Zoom Hand #257689089158:  Hold'em No Limit (€0.01/€0.02) - 2025/09/10 18:06:03 CET [2025/09/10 12:06:03 ET]
Table 'Arneb' 6-max Seat #1 is the button
Seat 1: pucelazo (€2.57 in chips) 
Seat 2: pipinoelbreve9 (€2.24 in chips) 
Seat 3: Hugo OGM (€2 in chips) 
Seat 4: jeannono24 (€2.21 in chips) 
Seat 5: alvlugom (€1.44 in chips) 
Seat 6: orosa (€2.20 in chips) 
pipinoelbreve9: posts small blind €0.01
Hugo OGM: posts big blind €0.02
*** HOLE CARDS ***
Dealt to pipinoelbreve9 [9c Td]
jeannono24: folds 
alvlugom: folds 
orosa: folds 
pucelazo: folds 
pipinoelbreve9: raises €0.04 to €0.06
Hugo OGM: raises €0.12 to €0.18
pipinoelbreve9: calls €0.12
*** FLOP *** [Tc 2d 8d]
pipinoelbreve9: bets €0.17
Hugo OGM: calls €0.17
*** TURN *** [Tc 2d 8d] [6c]
pipinoelbreve9: bets €0.31
Hugo OGM: folds 
Uncalled bet (€0.31) returned to pipinoelbreve9
pipinoelbreve9 collected €0.66 from pot
pipinoelbreve9: doesn't show hand 
*** SUMMARY ***
Total pot €0.70 | Rake €0.04 
Board [Tc 2d 8d 6c]
Seat 1: pucelazo (button) folded before Flop (didn't bet)
Seat 2: pipinoelbreve9 (small blind) collected (€0.66)
Seat 3: Hugo OGM (big blind) folded on the Turn
Seat 4: jeannono24 folded before Flop (didn't bet)
Seat 5: alvlugom folded before Flop (didn't bet)
Seat 6: orosa folded before Flop (didn't bet)



PokerStars Zoom Hand #257689098697:  Hold'em No Limit (€0.01/€0.02) - 2025/09/10 18:06:54 CET [2025/09/10 12:06:54 ET]
Table 'Arneb' 6-max Seat #1 is the button
Seat 1: pipinoelbreve9 (€2.55 in chips) 
Seat 2: Hotspot9119 (€3.16 in chips) 
Seat 3: Mr7331 (€1.97 in chips) 
Seat 4: Ruben1990869 (€2 in chips) 
Seat 5: cuenca10 (€3.24 in chips) 
Seat 6: orosa (€2.02 in chips) 
Hotspot9119: posts small blind €0.01
Mr7331: posts big blind €0.02
*** HOLE CARDS ***
Dealt to pipinoelbreve9 [2h Td]
Ruben1990869: folds 
cuenca10: calls €0.02
orosa: folds 
pipinoelbreve9: folds 
Hotspot9119: folds 
Mr7331: checks 
*** FLOP *** [Ah Jc As]
Mr7331: checks 
cuenca10: bets €0.02
Mr7331: folds 
Uncalled bet (€0.02) returned to cuenca10
cuenca10 collected €0.05 from pot
cuenca10: doesn't show hand 
*** SUMMARY ***
Total pot €0.05 | Rake €0 
Board [Ah Jc As]
Seat 1: pipinoelbreve9 (button) folded before Flop (didn't bet)
Seat 2: Hotspot9119 (small blind) folded before Flop
Seat 3: Mr7331 (big blind) folded on the Flop
Seat 4: Ruben1990869 folded before Flop (didn't bet)
Seat 5: cuenca10 collected (€0.05)
Seat 6: orosa folded before Flop (didn't bet)



PokerStars Zoom Hand #257689099347:  Hold'em No Limit (€0.01/€0.02) - 2025/09/10 18:06:57 CET [2025/09/10 12:06:57 ET]
Table 'Arneb' 6-max Seat #1 is the button
Seat 1: fvprodigy (€2.57 in chips) 
Seat 2: candarias (€0.80 in chips) 
Seat 3: Ruben1990869 (€2 in chips) 
Seat 4: soyeterno (€0.37 in chips) 
Seat 5: reeemen_ (€2.71 in chips) 
Seat 6: pipinoelbreve9 (€2.55 in chips) 
candarias: posts small blind €0.01
Ruben1990869: posts big blind €0.02
*** HOLE CARDS ***
Dealt to pipinoelbreve9 [2c 3s]
soyeterno: folds 
reeemen_: raises €0.04 to €0.06
pipinoelbreve9: folds 
fvprodigy: folds 
candarias: folds 
Ruben1990869: folds 
Uncalled bet (€0.04) returned to reeemen_
reeemen_ collected €0.05 from pot
reeemen_: doesn't show hand 
*** SUMMARY ***
Total pot €0.05 | Rake €0 
Seat 1: fvprodigy (button) folded before Flop (didn't bet)
Seat 2: candarias (small blind) folded before Flop
Seat 3: Ruben1990869 (big blind) folded before Flop
Seat 4: soyeterno folded before Flop (didn't bet)
Seat 5: reeemen_ collected (€0.05)
Seat 6: pipinoelbreve9 folded before Flop (didn't bet)



PokerStars Zoom Hand #257689102324:  Hold'em No Limit (€0.01/€0.02) - 2025/09/10 18:07:12 CET [2025/09/10 12:07:12 ET]
Table 'Arneb' 6-max Seat #1 is the button
Seat 1: Mr7331 (€1.95 in chips) 
Seat 2: serviettski(fr) (€2.05 in chips) 
Seat 3: pipinoelbreve9 (€2.55 in chips) 
Seat 4: JENOFONTE73 (€1.44 in chips) 
Seat 5: smrj1976 (€2.85 in chips) 
Seat 6: dragonfly2467 (€2.02 in chips) 
serviettski(fr): posts small blind €0.01
pipinoelbreve9: posts big blind €0.02
*** HOLE CARDS ***
Dealt to pipinoelbreve9 [Kh 3s]
JENOFONTE73: folds 
smrj1976: folds 
dragonfly2467: raises €0.04 to €0.06
Mr7331: calls €0.06
serviettski(fr): folds 
pipinoelbreve9: folds 
*** FLOP *** [4d Ah 8c]
dragonfly2467: checks 
Mr7331: bets €0.04
dragonfly2467: folds 
Uncalled bet (€0.04) returned to Mr7331
Mr7331 collected €0.14 from pot
Mr7331: doesn't show hand 
*** SUMMARY ***
Total pot €0.15 | Rake €0.01 
Board [4d Ah 8c]
Seat 1: Mr7331 (button) collected (€0.14)
Seat 2: serviettski(fr) (small blind) folded before Flop
Seat 3: pipinoelbreve9 (big blind) folded before Flop
Seat 4: JENOFONTE73 folded before Flop (didn't bet)
Seat 5: smrj1976 folded before Flop (didn't bet)
Seat 6: dragonfly2467 folded on the Flop



PokerStars Zoom Hand #257689103646:  Hold'em No Limit (€0.01/€0.02) - 2025/09/10 18:07:19 CET [2025/09/10 12:07:19 ET]
Table 'Arneb' 6-max Seat #1 is the button
Seat 1: serviettski(fr) (€2.04 in chips) 
Seat 2: pipinoelbreve9 (€2.53 in chips) 
Seat 3: reeemen_ (€2.74 in chips) 
Seat 4: jeannono24 (€2.06 in chips) 
Seat 5: vaness47985 (€1.93 in chips) 
Seat 6: CORDEVIGO (€5.41 in chips) 
pipinoelbreve9: posts small blind €0.01
reeemen_: posts big blind €0.02
*** HOLE CARDS ***
Dealt to pipinoelbreve9 [Qh Ah]
jeannono24: raises €0.04 to €0.06
vaness47985: folds 
CORDEVIGO: folds 
serviettski(fr): folds 
pipinoelbreve9: raises €0.18 to €0.24
reeemen_: folds 
jeannono24: folds 
Uncalled bet (€0.18) returned to pipinoelbreve9
pipinoelbreve9 collected €0.14 from pot
pipinoelbreve9: doesn't show hand 
*** SUMMARY ***
Total pot €0.14 | Rake €0 
Seat 1: serviettski(fr) (button) folded before Flop (didn't bet)
Seat 2: pipinoelbreve9 (small blind) collected (€0.14)
Seat 3: reeemen_ (big blind) folded before Flop
Seat 4: jeannono24 folded before Flop
Seat 5: vaness47985 folded before Flop (didn't bet)
Seat 6: CORDEVIGO folded before Flop (didn't bet)



PokerStars Zoom Hand #257689101553:  Hold'em No Limit (€0.01/€0.02) - 2025/09/10 18:07:08 CET [2025/09/10 12:07:08 ET]
Table 'Arneb' 6-max Seat #1 is the button
Seat 1: DavSnook (€3.65 in chips) 
Seat 2: profequimica66 (€2.51 in chips) 
Seat 3: loudydrix (€0.67 in chips) 
Seat 4: pipinoelbreve9 (€2.55 in chips) 
Seat 5: rccmonteiro27 (€2.39 in chips) 
Seat 6: linto2800 (€2.26 in chips) 
profequimica66: posts small blind €0.01
loudydrix: posts big blind €0.02
*** HOLE CARDS ***
Dealt to pipinoelbreve9 [Jc 3s]
pipinoelbreve9: folds 
rccmonteiro27: folds 
linto2800: folds 
DavSnook: raises €0.05 to €0.07
profequimica66: calls €0.06
loudydrix: calls €0.05
*** FLOP *** [5h 2c 9d]
profequimica66: checks 
loudydrix: checks 
DavSnook: bets €0.10
profequimica66: calls €0.10
loudydrix: folds 
*** TURN *** [5h 2c 9d] [3c]
profequimica66: bets €0.20
DavSnook: calls €0.20
*** RIVER *** [5h 2c 9d 3c] [Qd]
profequimica66: checks 
DavSnook: checks 
*** SHOW DOWN ***
profequimica66: shows [9s Kd] (a pair of Nines)
DavSnook: mucks hand 
profequimica66 collected €0.77 from pot
*** SUMMARY ***
Total pot €0.81 | Rake €0.04 
Board [5h 2c 9d 3c Qd]
Seat 1: DavSnook (button) mucked [9c 8s]
Seat 2: profequimica66 (small blind) showed [9s Kd] and won (€0.77) with a pair of Nines
Seat 3: loudydrix (big blind) folded on the Flop
Seat 4: pipinoelbreve9 folded before Flop (didn't bet)
Seat 5: rccmonteiro27 folded before Flop (didn't bet)
Seat 6: linto2800 folded before Flop (didn't bet)



PokerStars Zoom Hand #257689109758:  Hold'em No Limit (€0.01/€0.02) - 2025/09/10 18:07:51 CET [2025/09/10 12:07:51 ET]
Table 'Arneb' 6-max Seat #1 is the button
Seat 1: candarias (€2.10 in chips) 
Seat 2: bluffynuts (€1.92 in chips) 
Seat 3: FELIPE439 (€2 in chips) 
Seat 4: jeannono24 (€2 in chips) 
Seat 5: alvlugom (€2.70 in chips) 
Seat 6: pipinoelbreve9 (€2.61 in chips) 
bluffynuts: posts small blind €0.01
FELIPE439: posts big blind €0.02
*** HOLE CARDS ***
Dealt to pipinoelbreve9 [2h Td]
jeannono24: raises €0.04 to €0.06
alvlugom: folds 
pipinoelbreve9: folds 
candarias: folds 
bluffynuts: folds 
FELIPE439: folds 
Uncalled bet (€0.04) returned to jeannono24
jeannono24 collected €0.05 from pot
jeannono24: doesn't show hand 
*** SUMMARY ***
Total pot €0.05 | Rake €0 
Seat 1: candarias (button) folded before Flop (didn't bet)
Seat 2: bluffynuts (small blind) folded before Flop
Seat 3: FELIPE439 (big blind) folded before Flop
Seat 4: jeannono24 collected (€0.05)
Seat 5: alvlugom folded before Flop (didn't bet)
Seat 6: pipinoelbreve9 folded before Flop (didn't bet)



PokerStars Zoom Hand #257689109365:  Hold'em No Limit (€0.01/€0.02) - 2025/09/10 18:07:49 CET [2025/09/10 12:07:49 ET]
Table 'Arneb' 6-max Seat #1 is the button
Seat 1: Meg62480 (€1.36 in chips) 
Seat 2: 34pluto (€1.35 in chips) 
Seat 3: dragonfly2467 (€2.03 in chips) 
Seat 4: pipinoelbreve9 (€2.61 in chips) 
Seat 5: remiiiiiiii (€1.94 in chips) 
Seat 6: spiritwarrior29 (€3.30 in chips) 
34pluto: posts small blind €0.01
dragonfly2467: posts big blind €0.02
*** HOLE CARDS ***
Dealt to pipinoelbreve9 [Jc 8d]
pipinoelbreve9: folds 
remiiiiiiii: folds 
spiritwarrior29: raises €0.04 to €0.06
Meg62480: folds 
34pluto: folds 
dragonfly2467: calls €0.04
*** FLOP *** [Qh Js 9s]
dragonfly2467: checks 
spiritwarrior29: bets €0.04
dragonfly2467: folds 
Uncalled bet (€0.04) returned to spiritwarrior29
spiritwarrior29 collected €0.12 from pot
spiritwarrior29: doesn't show hand 
*** SUMMARY ***
Total pot €0.13 | Rake €0.01 
Board [Qh Js 9s]
Seat 1: Meg62480 (button) folded before Flop (didn't bet)
Seat 2: 34pluto (small blind) folded before Flop
Seat 3: dragonfly2467 (big blind) folded on the Flop
Seat 4: pipinoelbreve9 folded before Flop (didn't bet)
Seat 5: remiiiiiiii folded before Flop (didn't bet)
Seat 6: spiritwarrior29 collected (€0.12)



PokerStars Zoom Hand #257689107079:  Hold'em No Limit (€0.01/€0.02) - 2025/09/10 18:07:37 CET [2025/09/10 12:07:37 ET]
Table 'Arneb' 6-max Seat #1 is the button
Seat 1: ssjimmyss88 (€1.56 in chips) 
Seat 2: candarias (€2.11 in chips) 
Seat 3: 34pluto (€1.55 in chips) 
Seat 4: cuenca10 (€3.23 in chips) 
Seat 5: pipinoelbreve9 (€2.61 in chips) 
Seat 6: Doblea315 (€2.17 in chips) 
candarias: posts small blind €0.01
34pluto: posts big blind €0.02
*** HOLE CARDS ***
Dealt to pipinoelbreve9 [7s 9c]
cuenca10: calls €0.02
pipinoelbreve9: folds 
Doblea315: folds 
ssjimmyss88: folds 
candarias: folds 
34pluto: checks 
*** FLOP *** [Ks 8d 9s]
34pluto: checks 
cuenca10: bets €0.04
34pluto: folds 
Uncalled bet (€0.04) returned to cuenca10
cuenca10 collected €0.05 from pot
cuenca10: doesn't show hand 
*** SUMMARY ***
Total pot €0.05 | Rake €0 
Board [Ks 8d 9s]
Seat 1: ssjimmyss88 (button) folded before Flop (didn't bet)
Seat 2: candarias (small blind) folded before Flop
Seat 3: 34pluto (big blind) folded on the Flop
Seat 4: cuenca10 collected (€0.05)
Seat 5: pipinoelbreve9 folded before Flop (didn't bet)
Seat 6: Doblea315 folded before Flop (didn't bet)



PokerStars Zoom Hand #257689110621:  Hold'em No Limit (€0.01/€0.02) - 2025/09/10 18:07:55 CET [2025/09/10 12:07:55 ET]
Table 'Arneb' 6-max Seat #1 is the button
Seat 1: osking118 (€1.57 in chips) 
Seat 2: DavSnook (€4.08 in chips) 
Seat 3: pipinoelbreve9 (€2.61 in chips) 
Seat 4: rccmonteiro27 (€2.37 in chips) 
Seat 5: loudydrix (€0.59 in chips) 
Seat 6: pucelazo (€2.56 in chips) 
DavSnook: posts small blind €0.01
pipinoelbreve9: posts big blind €0.02
*** HOLE CARDS ***
Dealt to pipinoelbreve9 [Td Qc]
rccmonteiro27: folds 
loudydrix: folds 
pucelazo: folds 
osking118: raises €0.02 to €0.04
DavSnook: calls €0.03
pipinoelbreve9: calls €0.02
*** FLOP *** [5d Th 4d]
DavSnook: bets €0.06
pipinoelbreve9: calls €0.06
osking118: folds 
*** TURN *** [5d Th 4d] [Jh]
DavSnook: bets €0.12
pipinoelbreve9: calls €0.12
*** RIVER *** [5d Th 4d Jh] [8c]
DavSnook: bets €0.23
pipinoelbreve9: calls €0.23
*** SHOW DOWN ***
DavSnook: shows [7d Jd] (a pair of Jacks)
pipinoelbreve9: mucks hand 
DavSnook collected €0.89 from pot
*** SUMMARY ***
Total pot €0.94 | Rake €0.05 
Board [5d Th 4d Jh 8c]
Seat 1: osking118 (button) folded on the Flop
Seat 2: DavSnook (small blind) showed [7d Jd] and won (€0.89) with a pair of Jacks
Seat 3: pipinoelbreve9 (big blind) mucked [Td Qc]
Seat 4: rccmonteiro27 folded before Flop (didn't bet)
Seat 5: loudydrix folded before Flop (didn't bet)
Seat 6: pucelazo folded before Flop (didn't bet)



PokerStars Zoom Hand #257689118969:  Hold'em No Limit (€0.01/€0.02) - 2025/09/10 18:08:38 CET [2025/09/10 12:08:38 ET]
Table 'Arneb' 6-max Seat #1 is the button
Seat 1: pipinoelbreve9 (€2.16 in chips) 
Seat 2: Siddharta33 (€1.95 in chips) 
Seat 3: soyeterno (€4.20 in chips) 
Seat 4: iam_xCidx (€2.18 in chips) 
Seat 5: DavSnook (€3.88 in chips) 
Seat 6: Mr7331 (€2.05 in chips) 
Siddharta33: posts small blind €0.01
soyeterno: posts big blind €0.02
*** HOLE CARDS ***
Dealt to pipinoelbreve9 [Qd Ks]
iam_xCidx: folds 
DavSnook: folds 
Mr7331: raises €0.02 to €0.04
pipinoelbreve9: calls €0.04
Siddharta33: folds 
soyeterno: folds 
*** FLOP *** [Ts As 4h]
Mr7331: checks 
pipinoelbreve9: bets €0.05
Mr7331: calls €0.05
*** TURN *** [Ts As 4h] [Td]
Mr7331: checks 
pipinoelbreve9: checks 
*** RIVER *** [Ts As 4h Td] [Jh]
Mr7331: checks 
pipinoelbreve9: bets €2.07 and is all-in
Mr7331: calls €1.96 and is all-in
Uncalled bet (€0.11) returned to pipinoelbreve9
*** SHOW DOWN ***
pipinoelbreve9: shows [Qd Ks] (a straight, Ten to Ace)
Mr7331: shows [Tc Kd] (three of a kind, Tens)
pipinoelbreve9 collected €3.92 from pot
*** SUMMARY ***
Total pot €4.13 | Rake €0.21 
Board [Ts As 4h Td Jh]
Seat 1: pipinoelbreve9 (button) showed [Qd Ks] and won (€3.92) with a straight, Ten to Ace
Seat 2: Siddharta33 (small blind) folded before Flop
Seat 3: soyeterno (big blind) folded before Flop
Seat 4: iam_xCidx folded before Flop (didn't bet)
Seat 5: DavSnook folded before Flop (didn't bet)
Seat 6: Mr7331 showed [Tc Kd] and lost with three of a kind, Tens



PokerStars Zoom Hand #257689127579:  Hold'em No Limit (€0.01/€0.02) - 2025/09/10 18:09:23 CET [2025/09/10 12:09:23 ET]
Table 'Arneb' 6-max Seat #1 is the button
Seat 1: Doblea315 (€2 in chips) 
Seat 2: Siddharta33 (€1.11 in chips) 
Seat 3: candarias (€0.71 in chips) 
Seat 4: malmeto45 (€2.52 in chips) 
Seat 5: Sportacus911 (€2.46 in chips) 
Seat 6: pipinoelbreve9 (€4.02 in chips) 
Siddharta33: posts small blind €0.01
candarias: posts big blind €0.02
*** HOLE CARDS ***
Dealt to pipinoelbreve9 [5d Qs]
malmeto45: folds 
Sportacus911: folds 
pipinoelbreve9: folds 
Doblea315: folds 
Siddharta33: calls €0.01
candarias: checks 
*** FLOP *** [8h 3h 8s]
Siddharta33: bets €0.02
candarias: folds 
Uncalled bet (€0.02) returned to Siddharta33
Siddharta33 collected €0.04 from pot
Siddharta33: doesn't show hand 
*** SUMMARY ***
Total pot €0.04 | Rake €0 
Board [8h 3h 8s]
Seat 1: Doblea315 (button) folded before Flop (didn't bet)
Seat 2: Siddharta33 (small blind) collected (€0.04)
Seat 3: candarias (big blind) folded on the Flop
Seat 4: malmeto45 folded before Flop (didn't bet)
Seat 5: Sportacus911 folded before Flop (didn't bet)
Seat 6: pipinoelbreve9 folded before Flop (didn't bet)



PokerStars Zoom Hand #257689129134:  Hold'em No Limit (€0.01/€0.02) - 2025/09/10 18:09:31 CET [2025/09/10 12:09:31 ET]
Table 'Arneb' 6-max Seat #1 is the button
Seat 1: 34pluto (€1.68 in chips) 
Seat 2: Hotspot9119 (€3.70 in chips) 
Seat 3: serviettski(fr) (€2 in chips) 
Seat 4: pipinoelbreve9 (€4.02 in chips) 
Seat 5: Diegot2119 (€0.98 in chips) 
Seat 6: malmeto45 (€2.51 in chips) 
Hotspot9119: posts small blind €0.01
serviettski(fr): posts big blind €0.02
*** HOLE CARDS ***
Dealt to pipinoelbreve9 [As 2h]
pipinoelbreve9: folds 
Diegot2119: raises €0.02 to €0.04
malmeto45: calls €0.04
34pluto: folds 
Hotspot9119: folds 
serviettski(fr): folds 
*** FLOP *** [8d Ts 6h]
Diegot2119: bets €0.05
malmeto45: raises €2.42 to €2.47 and is all-in
Diegot2119: folds 
Uncalled bet (€2.42) returned to malmeto45
malmeto45 collected €0.20 from pot
malmeto45: doesn't show hand 
*** SUMMARY ***
Total pot €0.21 | Rake €0.01 
Board [8d Ts 6h]
Seat 1: 34pluto (button) folded before Flop (didn't bet)
Seat 2: Hotspot9119 (small blind) folded before Flop
Seat 3: serviettski(fr) (big blind) folded before Flop
Seat 4: pipinoelbreve9 folded before Flop (didn't bet)
Seat 5: Diegot2119 folded on the Flop
Seat 6: malmeto45 collected (€0.20)



PokerStars Zoom Hand #257689125608:  Hold'em No Limit (€0.01/€0.02) - 2025/09/10 18:09:13 CET [2025/09/10 12:09:13 ET]
Table 'Arneb' 6-max Seat #1 is the button
Seat 1: ssjimmyss88 (€1.53 in chips) 
Seat 2: pipinoelbreve9 (€4.03 in chips) 
Seat 3: soyeterno (€0.46 in chips) 
Seat 4: Sportacus911 (€2.46 in chips) 
Seat 5: 34pluto (€1.84 in chips) 
Seat 6: spiritwarrior29 (€1.52 in chips) 
pipinoelbreve9: posts small blind €0.01
soyeterno: posts big blind €0.02
*** HOLE CARDS ***
Dealt to pipinoelbreve9 [3h 5c]
Sportacus911: folds 
34pluto: raises €0.04 to €0.06
spiritwarrior29: calls €0.06
ssjimmyss88: folds 
pipinoelbreve9: folds 
soyeterno: folds 
*** FLOP *** [Th 9h 7c]
34pluto: checks 
spiritwarrior29: bets €0.07
34pluto: folds 
Uncalled bet (€0.07) returned to spiritwarrior29
spiritwarrior29 collected €0.14 from pot
spiritwarrior29: doesn't show hand 
*** SUMMARY ***
Total pot €0.15 | Rake €0.01 
Board [Th 9h 7c]
Seat 1: ssjimmyss88 (button) folded before Flop (didn't bet)
Seat 2: pipinoelbreve9 (small blind) folded before Flop
Seat 3: soyeterno (big blind) folded before Flop
Seat 4: Sportacus911 folded before Flop (didn't bet)
Seat 5: 34pluto folded on the Flop
Seat 6: spiritwarrior29 collected (€0.14)



PokerStars Zoom Hand #257689130907:  Hold'em No Limit (€0.01/€0.02) - 2025/09/10 18:09:40 CET [2025/09/10 12:09:40 ET]
Table 'Arneb' 6-max Seat #1 is the button
Seat 1: pipinoelbreve9 (€4 in chips) 
Seat 2: osking118 (€1.56 in chips) 
Seat 3: FELIPE439 (€2.03 in chips) 
Seat 4: claret505 (€1.53 in chips) 
Seat 5: serviettski(fr) (€2.01 in chips) 
Seat 6: Hotspot9119 (€3.69 in chips) 
osking118: posts small blind €0.01
FELIPE439: posts big blind €0.02
*** HOLE CARDS ***
Dealt to pipinoelbreve9 [Ad Js]
claret505: folds 
serviettski(fr): folds 
Hotspot9119: raises €0.04 to €0.06
pipinoelbreve9: raises €0.12 to €0.18
osking118: folds 
FELIPE439: folds 
Hotspot9119: folds 
Uncalled bet (€0.12) returned to pipinoelbreve9
pipinoelbreve9 collected €0.15 from pot
pipinoelbreve9: doesn't show hand 
*** SUMMARY ***
Total pot €0.15 | Rake €0 
Seat 1: pipinoelbreve9 (button) collected (€0.15)
Seat 2: osking118 (small blind) folded before Flop
Seat 3: FELIPE439 (big blind) folded before Flop
Seat 4: claret505 folded before Flop (didn't bet)
Seat 5: serviettski(fr) folded before Flop (didn't bet)
Seat 6: Hotspot9119 folded before Flop



PokerStars Zoom Hand #257689134260:  Hold'em No Limit (€0.01/€0.02) - 2025/09/10 18:09:57 CET [2025/09/10 12:09:57 ET]
Table 'Arneb' 6-max Seat #1 is the button
Seat 1: FELIPE439 (€2.03 in chips) 
Seat 2: pipinoelbreve9 (€4.09 in chips) 
Seat 3: Abrelatas787 (€2.39 in chips) 
Seat 4: 34pluto (€1.78 in chips) 
Seat 5: raptureman1 (€4.21 in chips) 
Seat 6: marcel13013 (€1.02 in chips) 
pipinoelbreve9: posts small blind €0.01
Abrelatas787: posts big blind €0.02
*** HOLE CARDS ***
Dealt to pipinoelbreve9 [3c Ah]
34pluto: raises €0.02 to €0.04
raptureman1: folds 
marcel13013: folds 
FELIPE439: folds 
pipinoelbreve9: folds 
Abrelatas787: folds 
Uncalled bet (€0.02) returned to 34pluto
34pluto collected €0.05 from pot
34pluto: doesn't show hand 
*** SUMMARY ***
Total pot €0.05 | Rake €0 
Seat 1: FELIPE439 (button) folded before Flop (didn't bet)
Seat 2: pipinoelbreve9 (small blind) folded before Flop
Seat 3: Abrelatas787 (big blind) folded before Flop
Seat 4: 34pluto collected (€0.05)
Seat 5: raptureman1 folded before Flop (didn't bet)
Seat 6: marcel13013 folded before Flop (didn't bet)



PokerStars Zoom Hand #257689126876:  Hold'em No Limit (€0.01/€0.02) - 2025/09/10 18:09:20 CET [2025/09/10 12:09:20 ET]
Table 'Arneb' 6-max Seat #1 is the button
Seat 1: oñati4 (€0.99 in chips) 
Seat 2: Ruben1990869 (€2.01 in chips) 
Seat 3: Capi010 (€1 in chips) 
Seat 4: Dood Francisco (€4.16 in chips) 
Seat 5: pipinoelbreve9 (€4.02 in chips) 
Seat 6: DavSnook (€3.91 in chips) 
Ruben1990869: posts small blind €0.01
Capi010: posts big blind €0.02
*** HOLE CARDS ***
Dealt to pipinoelbreve9 [Ks 2d]
Dood Francisco: raises €0.02 to €0.04
pipinoelbreve9: folds 
DavSnook: calls €0.04
oñati4: calls €0.04
Ruben1990869: folds 
Capi010: calls €0.02
*** FLOP *** [5c 7h 5s]
Capi010: checks 
Dood Francisco: checks 
DavSnook: bets €0.08
oñati4: calls €0.08
Capi010: folds 
Dood Francisco: folds 
*** TURN *** [5c 7h 5s] [6h]
DavSnook: checks 
oñati4: bets €0.31
DavSnook: raises €0.93 to €1.24
oñati4: calls €0.56 and is all-in
Uncalled bet (€0.37) returned to DavSnook
*** RIVER *** [5c 7h 5s 6h] [Jd]
*** SHOW DOWN ***
DavSnook: shows [6d 6c] (a full house, Sixes full of Fives)
oñati4: shows [5d Ah] (three of a kind, Fives)
DavSnook collected €1.97 from pot
*** SUMMARY ***
Total pot €2.07 | Rake €0.10 
Board [5c 7h 5s 6h Jd]
Seat 1: oñati4 (button) showed [5d Ah] and lost with three of a kind, Fives
Seat 2: Ruben1990869 (small blind) folded before Flop
Seat 3: Capi010 (big blind) folded on the Flop
Seat 4: Dood Francisco folded on the Flop
Seat 5: pipinoelbreve9 folded before Flop (didn't bet)
Seat 6: DavSnook showed [6d 6c] and won (€1.97) with a full house, Sixes full of Fives



PokerStars Zoom Hand #257689137036:  Hold'em No Limit (€0.01/€0.02) - 2025/09/10 18:10:12 CET [2025/09/10 12:10:12 ET]
Table 'Arneb' 6-max Seat #1 is the button
Seat 1: Diamondsdogs (€2.63 in chips) 
Seat 2: Elons_Mucks (€2.19 in chips) 
Seat 3: chonji24 (€2.98 in chips) 
Seat 4: vaness47985 (€1.98 in chips) 
Seat 5: pipinoelbreve9 (€4.08 in chips) 
Seat 6: Mr7331 (€1.99 in chips) 
Elons_Mucks: posts small blind €0.01
chonji24: posts big blind €0.02
*** HOLE CARDS ***
Dealt to pipinoelbreve9 [6h 7s]
vaness47985: folds 
pipinoelbreve9: folds 
Mr7331: raises €0.02 to €0.04
Diamondsdogs: folds 
Elons_Mucks: folds 
chonji24: raises €0.16 to €0.20
Mr7331: folds 
Uncalled bet (€0.16) returned to chonji24
chonji24 collected €0.09 from pot
chonji24: doesn't show hand 
*** SUMMARY ***
Total pot €0.09 | Rake €0 
Seat 1: Diamondsdogs (button) folded before Flop (didn't bet)
Seat 2: Elons_Mucks (small blind) folded before Flop
Seat 3: chonji24 (big blind) collected (€0.09)
Seat 4: vaness47985 folded before Flop (didn't bet)
Seat 5: pipinoelbreve9 folded before Flop (didn't bet)
Seat 6: Mr7331 folded before Flop



PokerStars Zoom Hand #257689129895:  Hold'em No Limit (€0.01/€0.02) - 2025/09/10 18:09:35 CET [2025/09/10 12:09:35 ET]
Table 'Arneb' 6-max Seat #1 is the button
Seat 1: Meg62480 (€1.82 in chips) 
Seat 2: 34pluto (€1.35 in chips) 
Seat 3: pipinoelbreve9 (€4.02 in chips) 
Seat 4: soyeterno (€4.21 in chips) 
Seat 5: smrj1976 (€2.62 in chips) 
Seat 6: reeemen_ (€2.85 in chips) 
34pluto: posts small blind €0.01
pipinoelbreve9: posts big blind €0.02
*** HOLE CARDS ***
Dealt to pipinoelbreve9 [6d 2d]
soyeterno: raises €0.04 to €0.06
smrj1976: folds 
reeemen_: calls €0.06
Meg62480: calls €0.06
34pluto: folds 
pipinoelbreve9: folds 
*** FLOP *** [7h Ah 4h]
soyeterno: checks 
reeemen_: checks 
Meg62480: checks 
*** TURN *** [7h Ah 4h] [6c]
soyeterno: bets €0.04
reeemen_: calls €0.04
Meg62480: folds 
*** RIVER *** [7h Ah 4h 6c] [Jh]
soyeterno: checks 
reeemen_: checks 
*** SHOW DOWN ***
soyeterno: shows [Ad 5d] (a pair of Aces)
reeemen_: mucks hand 
soyeterno collected €0.28 from pot
*** SUMMARY ***
Total pot €0.29 | Rake €0.01 
Board [7h Ah 4h 6c Jh]
Seat 1: Meg62480 (button) folded on the Turn
Seat 2: 34pluto (small blind) folded before Flop
Seat 3: pipinoelbreve9 (big blind) folded before Flop
Seat 4: soyeterno showed [Ad 5d] and won (€0.28) with a pair of Aces
Seat 5: smrj1976 folded before Flop (didn't bet)
Seat 6: reeemen_ mucked [7c 8c]



PokerStars Zoom Hand #257689140739:  Hold'em No Limit (€0.01/€0.02) - 2025/09/10 18:10:31 CET [2025/09/10 12:10:31 ET]
Table 'Arneb' 6-max Seat #1 is the button
Seat 1: SMN242 (€2.48 in chips) 
Seat 2: iam_xCidx (€2 in chips) 
Seat 3: Diamondsdogs (€2.43 in chips) 
Seat 4: remiiiiiiii (€1.87 in chips) 
Seat 5: Siddharta33 (€2.85 in chips) 
Seat 6: pipinoelbreve9 (€4.06 in chips) 
iam_xCidx: posts small blind €0.01
Diamondsdogs: posts big blind €0.02
*** HOLE CARDS ***
Dealt to pipinoelbreve9 [8h Kd]
remiiiiiiii: folds 
Siddharta33: folds 
pipinoelbreve9: raises €0.04 to €0.06
SMN242: folds 
iam_xCidx: folds 
Diamondsdogs: folds 
Uncalled bet (€0.04) returned to pipinoelbreve9
pipinoelbreve9 collected €0.05 from pot
pipinoelbreve9: doesn't show hand 
*** SUMMARY ***
Total pot €0.05 | Rake €0 
Seat 1: SMN242 (button) folded before Flop (didn't bet)
Seat 2: iam_xCidx (small blind) folded before Flop
Seat 3: Diamondsdogs (big blind) folded before Flop
Seat 4: remiiiiiiii folded before Flop (didn't bet)
Seat 5: Siddharta33 folded before Flop (didn't bet)
Seat 6: pipinoelbreve9 collected (€0.05)



PokerStars Zoom Hand #257689137958:  Hold'em No Limit (€0.01/€0.02) - 2025/09/10 18:10:17 CET [2025/09/10 12:10:17 ET]
Table 'Arneb' 6-max Seat #1 is the button
Seat 1: spiritwarrior29 (€3.39 in chips) 
Seat 2: nometoquesloshu (€0.87 in chips) 
Seat 3: pipinoelbreve9 (€4.08 in chips) 
Seat 4: chiinche (€1.98 in chips) 
Seat 5: FELIPE439 (€2.01 in chips) 
Seat 6: candarias (€1 in chips) 
nometoquesloshu: posts small blind €0.01
pipinoelbreve9: posts big blind €0.02
*** HOLE CARDS ***
Dealt to pipinoelbreve9 [8h 6c]
chiinche: folds 
FELIPE439: folds 
candarias: raises €0.04 to €0.06
spiritwarrior29: folds 
nometoquesloshu: calls €0.05
pipinoelbreve9: folds 
*** FLOP *** [Jh Th 5s]
nometoquesloshu: checks 
candarias: checks 
*** TURN *** [Jh Th 5s] [Qs]
nometoquesloshu: bets €0.07
candarias: calls €0.07
*** RIVER *** [Jh Th 5s Qs] [Jd]
nometoquesloshu: checks 
candarias: checks 
*** SHOW DOWN ***
nometoquesloshu: shows [Ks 8s] (a pair of Jacks)
candarias: shows [Qc Kc] (two pair, Queens and Jacks)
candarias collected €0.27 from pot
*** SUMMARY ***
Total pot €0.28 | Rake €0.01 
Board [Jh Th 5s Qs Jd]
Seat 1: spiritwarrior29 (button) folded before Flop (didn't bet)
Seat 2: nometoquesloshu (small blind) showed [Ks 8s] and lost with a pair of Jacks
Seat 3: pipinoelbreve9 (big blind) folded before Flop
Seat 4: chiinche folded before Flop (didn't bet)
Seat 5: FELIPE439 folded before Flop (didn't bet)
Seat 6: candarias showed [Qc Kc] and won (€0.27) with two pair, Queens and Jacks



PokerStars Zoom Hand #257689143843:  Hold'em No Limit (€0.01/€0.02) - 2025/09/10 18:10:47 CET [2025/09/10 12:10:47 ET]
Table 'Arneb' 6-max Seat #1 is the button
Seat 1: pipinoelbreve9 (€4.09 in chips) 
Seat 2: Mr7331 (€2.03 in chips) 
Seat 3: raptureman1 (€4.18 in chips) 
Seat 4: Siddharta33 (€1.83 in chips) 
Seat 5: loudydrix (€1.83 in chips) 
Seat 6: soyeterno (€4.39 in chips) 
Mr7331: posts small blind €0.01
raptureman1: posts big blind €0.02
*** HOLE CARDS ***
Dealt to pipinoelbreve9 [Tc 4c]
Siddharta33: folds 
loudydrix: folds 
soyeterno: folds 
pipinoelbreve9: folds 
Mr7331: raises €0.04 to €0.06
raptureman1: folds 
Uncalled bet (€0.04) returned to Mr7331
Mr7331 collected €0.04 from pot
Mr7331: doesn't show hand 
*** SUMMARY ***
Total pot €0.04 | Rake €0 
Seat 1: pipinoelbreve9 (button) folded before Flop (didn't bet)
Seat 2: Mr7331 (small blind) collected (€0.04)
Seat 3: raptureman1 (big blind) folded before Flop
Seat 4: Siddharta33 folded before Flop (didn't bet)
Seat 5: loudydrix folded before Flop (didn't bet)
Seat 6: soyeterno folded before Flop (didn't bet)



PokerStars Zoom Hand #257689145190:  Hold'em No Limit (€0.01/€0.02) - 2025/09/10 18:10:54 CET [2025/09/10 12:10:54 ET]
Table 'Arneb' 6-max Seat #1 is the button
Seat 1: vaness47985 (€1.93 in chips) 
Seat 2: claret505 (€1.56 in chips) 
Seat 3: Ruben1990869 (€2.53 in chips) 
Seat 4: pipinoelbreve9 (€4.09 in chips) 
Seat 5: reeemen_ (€2.08 in chips) 
Seat 6: nometoquesloshu (€0.74 in chips) 
claret505: posts small blind €0.01
Ruben1990869: posts big blind €0.02
*** HOLE CARDS ***
Dealt to pipinoelbreve9 [6h Ad]
pipinoelbreve9: folds 
reeemen_: folds 
nometoquesloshu: raises €0.04 to €0.06
vaness47985: folds 
claret505: folds 
Ruben1990869: calls €0.04
*** FLOP *** [9c Jh 4s]
Ruben1990869: checks 
nometoquesloshu: bets €0.03
Ruben1990869: calls €0.03
*** TURN *** [9c Jh 4s] [8h]
Ruben1990869: checks 
nometoquesloshu: bets €0.09
Ruben1990869: folds 
Uncalled bet (€0.09) returned to nometoquesloshu
nometoquesloshu collected €0.18 from pot
nometoquesloshu: doesn't show hand 
*** SUMMARY ***
Total pot €0.19 | Rake €0.01 
Board [9c Jh 4s 8h]
Seat 1: vaness47985 (button) folded before Flop (didn't bet)
Seat 2: claret505 (small blind) folded before Flop
Seat 3: Ruben1990869 (big blind) folded on the Turn
Seat 4: pipinoelbreve9 folded before Flop (didn't bet)
Seat 5: reeemen_ folded before Flop (didn't bet)
Seat 6: nometoquesloshu collected (€0.18)



PokerStars Zoom Hand #257689146058:  Hold'em No Limit (€0.01/€0.02) - 2025/09/10 18:10:58 CET [2025/09/10 12:10:58 ET]
Table 'Arneb' 6-max Seat #1 is the button
Seat 1: alvlugom (€4.11 in chips) 
Seat 2: JENOFONTE73 (€3.11 in chips) 
Seat 3: manecas0000 (€1 in chips) 
Seat 4: Sportacus911 (€2.73 in chips) 
Seat 5: pipinoelbreve9 (€4.09 in chips) 
Seat 6: vaness47985 (€1.93 in chips) 
JENOFONTE73: posts small blind €0.01
manecas0000: posts big blind €0.02
*** HOLE CARDS ***
Dealt to pipinoelbreve9 [3s As]
Sportacus911: folds 
pipinoelbreve9: raises €0.04 to €0.06
vaness47985: calls €0.06
alvlugom: folds 
JENOFONTE73: calls €0.05
manecas0000: folds 
*** FLOP *** [Js Qh Ah]
JENOFONTE73: checks 
pipinoelbreve9: bets €0.10
vaness47985: folds 
JENOFONTE73: folds 
Uncalled bet (€0.10) returned to pipinoelbreve9
pipinoelbreve9 collected €0.19 from pot
pipinoelbreve9: doesn't show hand 
*** SUMMARY ***
Total pot €0.20 | Rake €0.01 
Board [Js Qh Ah]
Seat 1: alvlugom (button) folded before Flop (didn't bet)
Seat 2: JENOFONTE73 (small blind) folded on the Flop
Seat 3: manecas0000 (big blind) folded before Flop
Seat 4: Sportacus911 folded before Flop (didn't bet)
Seat 5: pipinoelbreve9 collected (€0.19)
Seat 6: vaness47985 folded on the Flop



PokerStars Zoom Hand #257689151459:  Hold'em No Limit (€0.01/€0.02) - 2025/09/10 18:11:26 CET [2025/09/10 12:11:26 ET]
Table 'Arneb' 6-max Seat #1 is the button
Seat 1: SMN242 (€2 in chips) 
Seat 2: Doblea315 (€2.01 in chips) 
Seat 3: reeemen_ (€2 in chips) 
Seat 4: ssjimmyss88 (€3.95 in chips) 
Seat 5: Ruben1990869 (€2.89 in chips) 
Seat 6: pipinoelbreve9 (€4.22 in chips) 
Doblea315: posts small blind €0.01
reeemen_: posts big blind €0.02
*** HOLE CARDS ***
Dealt to pipinoelbreve9 [Tc Qh]
ssjimmyss88: folds 
Ruben1990869: folds 
pipinoelbreve9: raises €0.04 to €0.06
SMN242: folds 
Doblea315: folds 
reeemen_: raises €0.14 to €0.20
pipinoelbreve9: folds 
Uncalled bet (€0.14) returned to reeemen_
reeemen_ collected €0.13 from pot
reeemen_: doesn't show hand 
*** SUMMARY ***
Total pot €0.13 | Rake €0 
Seat 1: SMN242 (button) folded before Flop (didn't bet)
Seat 2: Doblea315 (small blind) folded before Flop
Seat 3: reeemen_ (big blind) collected (€0.13)
Seat 4: ssjimmyss88 folded before Flop (didn't bet)
Seat 5: Ruben1990869 folded before Flop (didn't bet)
Seat 6: pipinoelbreve9 folded before Flop



PokerStars Zoom Hand #257689158477:  Hold'em No Limit (€0.01/€0.02) - 2025/09/10 18:12:02 CET [2025/09/10 12:12:02 ET]
Table 'Arneb' 6-max Seat #1 is the button
Seat 1: JENOFONTE73 (€1.36 in chips) 
Seat 2: pipinoelbreve9 (€4.16 in chips) 
Seat 3: Ruben1990869 (€2.91 in chips) 
Seat 4: candarias (€1.11 in chips) 
Seat 5: 240Rober (€2 in chips) 
Seat 6: nometoquesloshu (€0.83 in chips) 
pipinoelbreve9: posts small blind €0.01
Ruben1990869: posts big blind €0.02
*** HOLE CARDS ***
Dealt to pipinoelbreve9 [Js 5d]
candarias: folds 
240Rober: folds 
nometoquesloshu: folds 
JENOFONTE73: folds 
pipinoelbreve9: folds 
Uncalled bet (€0.01) returned to Ruben1990869
Ruben1990869 collected €0.02 from pot
Ruben1990869: doesn't show hand 
*** SUMMARY ***
Total pot €0.02 | Rake €0 
Seat 1: JENOFONTE73 (button) folded before Flop (didn't bet)
Seat 2: pipinoelbreve9 (small blind) folded before Flop
Seat 3: Ruben1990869 (big blind) collected (€0.02)
Seat 4: candarias folded before Flop (didn't bet)
Seat 5: 240Rober folded before Flop (didn't bet)
Seat 6: nometoquesloshu folded before Flop (didn't bet)



PokerStars Zoom Hand #257689161503:  Hold'em No Limit (€0.01/€0.02) - 2025/09/10 18:12:18 CET [2025/09/10 12:12:18 ET]
Table 'Arneb' 6-max Seat #1 is the button
Seat 1: pipinoelbreve9 (€4.15 in chips) 
Seat 2: soyeterno (€0.78 in chips) 
Seat 3: SMN242 (€2 in chips) 
Seat 4: WKBets (€2.31 in chips) 
Seat 5: PrendsCa (€2 in chips) 
Seat 6: 240Rober (€2 in chips) 
soyeterno: posts small blind €0.01
SMN242: posts big blind €0.02
*** HOLE CARDS ***
Dealt to pipinoelbreve9 [5d Ks]
WKBets: folds 
PrendsCa: folds 
240Rober: folds 
pipinoelbreve9: raises €0.04 to €0.06
soyeterno: folds 
SMN242: calls €0.04
*** FLOP *** [Kc 7d 8h]
SMN242: checks 
pipinoelbreve9: bets €0.06
SMN242: folds 
Uncalled bet (€0.06) returned to pipinoelbreve9
pipinoelbreve9 collected €0.12 from pot
pipinoelbreve9: doesn't show hand 
*** SUMMARY ***
Total pot €0.13 | Rake €0.01 
Board [Kc 7d 8h]
Seat 1: pipinoelbreve9 (button) collected (€0.12)
Seat 2: soyeterno (small blind) folded before Flop
Seat 3: SMN242 (big blind) folded on the Flop
Seat 4: WKBets folded before Flop (didn't bet)
Seat 5: PrendsCa folded before Flop (didn't bet)
Seat 6: 240Rober folded before Flop (didn't bet)



PokerStars Zoom Hand #257689167046:  Hold'em No Limit (€0.01/€0.02) - 2025/09/10 18:12:46 CET [2025/09/10 12:12:46 ET]
Table 'Arneb' 6-max Seat #1 is the button
Seat 1: cherda33 (€5.82 in chips) 
Seat 2: pipinoelbreve9 (€4.19 in chips) 
Seat 3: Mr7331 (€2 in chips) 
Seat 4: Abrelatas787 (€2.07 in chips) 
Seat 5: chonji24 (€2.12 in chips) 
Seat 6: Dood Francisco (€3.91 in chips) 
pipinoelbreve9: posts small blind €0.01
Mr7331: posts big blind €0.02
*** HOLE CARDS ***
Dealt to pipinoelbreve9 [Jd 7c]
Abrelatas787: folds 
chonji24: raises €0.04 to €0.06
Dood Francisco: folds 
cherda33: folds 
pipinoelbreve9: folds 
Mr7331: folds 
Uncalled bet (€0.04) returned to chonji24
chonji24 collected €0.05 from pot
chonji24: doesn't show hand 
*** SUMMARY ***
Total pot €0.05 | Rake €0 
Seat 1: cherda33 (button) folded before Flop (didn't bet)
Seat 2: pipinoelbreve9 (small blind) folded before Flop
Seat 3: Mr7331 (big blind) folded before Flop
Seat 4: Abrelatas787 folded before Flop (didn't bet)
Seat 5: chonji24 collected (€0.05)
Seat 6: Dood Francisco folded before Flop (didn't bet)



PokerStars Zoom Hand #257689164772:  Hold'em No Limit (€0.01/€0.02) - 2025/09/10 18:12:35 CET [2025/09/10 12:12:35 ET]
Table 'Arneb' 6-max Seat #1 is the button
Seat 1: raptureman1 (€4.21 in chips) 
Seat 2: soyeterno (€4.80 in chips) 
Seat 3: ese lines (€2.58 in chips) 
Seat 4: pipinoelbreve9 (€4.21 in chips) 
Seat 5: chiinche (€2 in chips) 
Seat 6: Ruben1990869 (€2 in chips) 
soyeterno: posts small blind €0.01
ese lines: posts big blind €0.02
*** HOLE CARDS ***
Dealt to pipinoelbreve9 [2d 7c]
pipinoelbreve9: folds 
chiinche: folds 
Ruben1990869: folds 
raptureman1: folds 
soyeterno: raises €0.04 to €0.06
ese lines: calls €0.04
*** FLOP *** [9d 6h Kc]
soyeterno: bets €0.06
ese lines: folds 
Uncalled bet (€0.06) returned to soyeterno
soyeterno collected €0.11 from pot
soyeterno: doesn't show hand 
*** SUMMARY ***
Total pot €0.12 | Rake €0.01 
Board [9d 6h Kc]
Seat 1: raptureman1 (button) folded before Flop (didn't bet)
Seat 2: soyeterno (small blind) collected (€0.11)
Seat 3: ese lines (big blind) folded on the Flop
Seat 4: pipinoelbreve9 folded before Flop (didn't bet)
Seat 5: chiinche folded before Flop (didn't bet)
Seat 6: Ruben1990869 folded before Flop (didn't bet)



PokerStars Zoom Hand #257689165816:  Hold'em No Limit (€0.01/€0.02) - 2025/09/10 18:12:40 CET [2025/09/10 12:12:40 ET]
Table 'Arneb' 6-max Seat #1 is the button
Seat 1: Doblea315 (€2 in chips) 
Seat 2: SGB36 (€1.98 in chips) 
Seat 3: pipinoelbreve9 (€4.21 in chips) 
Seat 4: smrj1976 (€2.74 in chips) 
Seat 5: DavSnook (€3.64 in chips) 
Seat 6: feerry61 (€2.02 in chips) 
SGB36: posts small blind €0.01
pipinoelbreve9: posts big blind €0.02
*** HOLE CARDS ***
Dealt to pipinoelbreve9 [3d 6c]
smrj1976: folds 
DavSnook: raises €0.05 to €0.07
feerry61: raises €0.11 to €0.18
Doblea315: folds 
SGB36: folds 
pipinoelbreve9: folds 
DavSnook: folds 
Uncalled bet (€0.11) returned to feerry61
feerry61 collected €0.17 from pot
feerry61: doesn't show hand 
*** SUMMARY ***
Total pot €0.17 | Rake €0 
Seat 1: Doblea315 (button) folded before Flop (didn't bet)
Seat 2: SGB36 (small blind) folded before Flop
Seat 3: pipinoelbreve9 (big blind) folded before Flop
Seat 4: smrj1976 folded before Flop (didn't bet)
Seat 5: DavSnook folded before Flop
Seat 6: feerry61 collected (€0.17)



PokerStars Zoom Hand #257689170708:  Hold'em No Limit (€0.01/€0.02) - 2025/09/10 18:13:05 CET [2025/09/10 12:13:05 ET]
Table 'Arneb' 6-max Seat #1 is the button
Seat 1: nometoquesloshu (€0.74 in chips) 
Seat 2: ssjimmyss88 (€4.07 in chips) 
Seat 3: Doblea315 (€2 in chips) 
Seat 4: Abrelatas787 (€2.05 in chips) 
Seat 5: ese lines (€2.52 in chips) 
Seat 6: pipinoelbreve9 (€4.18 in chips) 
ssjimmyss88: posts small blind €0.01
Doblea315: posts big blind €0.02
*** HOLE CARDS ***
Dealt to pipinoelbreve9 [As 2d]
Abrelatas787: folds 
ese lines: calls €0.02
pipinoelbreve9: folds 
nometoquesloshu: folds 
ssjimmyss88: raises €0.04 to €0.06
Doblea315: folds 
ese lines: calls €0.04
*** FLOP *** [4s 8s 7d]
ssjimmyss88: bets €0.07
ese lines: calls €0.07
*** TURN *** [4s 8s 7d] [9s]
ssjimmyss88: checks 
ese lines: bets €0.27
ssjimmyss88: folds 
Uncalled bet (€0.27) returned to ese lines
ese lines collected €0.27 from pot
ese lines: doesn't show hand 
*** SUMMARY ***
Total pot €0.28 | Rake €0.01 
Board [4s 8s 7d 9s]
Seat 1: nometoquesloshu (button) folded before Flop (didn't bet)
Seat 2: ssjimmyss88 (small blind) folded on the Turn
Seat 3: Doblea315 (big blind) folded before Flop
Seat 4: Abrelatas787 folded before Flop (didn't bet)
Seat 5: ese lines collected (€0.27)
Seat 6: pipinoelbreve9 folded before Flop (didn't bet)



PokerStars Zoom Hand #257689169007:  Hold'em No Limit (€0.01/€0.02) - 2025/09/10 18:12:57 CET [2025/09/10 12:12:57 ET]
Table 'Arneb' 6-max Seat #1 is the button
Seat 1: Marc Perca (€2.04 in chips) 
Seat 2: pucelazo (€4.47 in chips) 
Seat 3: 34pluto (€1.40 in chips) 
Seat 4: ese lines (€0.49 in chips) 
Seat 5: pipinoelbreve9 (€4.18 in chips) 
Seat 6: Doblea315 (€2 in chips) 
pucelazo: posts small blind €0.01
34pluto: posts big blind €0.02
*** HOLE CARDS ***
Dealt to pipinoelbreve9 [7c 4h]
ese lines: folds 
pipinoelbreve9: folds 
Doblea315: raises €0.04 to €0.06
Marc Perca: folds 
pucelazo: folds 
34pluto: calls €0.04
*** FLOP *** [3h Kh 8s]
34pluto: checks 
Doblea315: checks 
*** TURN *** [3h Kh 8s] [2c]
34pluto: checks 
Doblea315: checks 
*** RIVER *** [3h Kh 8s 2c] [6h]
34pluto: checks 
Doblea315: checks 
*** SHOW DOWN ***
34pluto: shows [Td Ac] (high card Ace)
Doblea315: mucks hand 
34pluto collected €0.12 from pot
*** SUMMARY ***
Total pot €0.13 | Rake €0.01 
Board [3h Kh 8s 2c 6h]
Seat 1: Marc Perca (button) folded before Flop (didn't bet)
Seat 2: pucelazo (small blind) folded before Flop
Seat 3: 34pluto (big blind) showed [Td Ac] and won (€0.12) with high card Ace
Seat 4: ese lines folded before Flop (didn't bet)
Seat 5: pipinoelbreve9 folded before Flop (didn't bet)
Seat 6: Doblea315 mucked [Ah 9d]



PokerStars Zoom Hand #257689172448:  Hold'em No Limit (€0.01/€0.02) - 2025/09/10 18:13:14 CET [2025/09/10 12:13:14 ET]
Table 'Arneb' 6-max Seat #1 is the button
Seat 1: ese lines (€0.47 in chips) 
Seat 2: Ahojador (€2 in chips) 
Seat 3: di_pt_82 (€1.92 in chips) 
Seat 4: pucelazo (€2.41 in chips) 
Seat 5: pipinoelbreve9 (€4.18 in chips) 
Seat 6: marcel13013 (€0.38 in chips) 
Ahojador: posts small blind €0.01
di_pt_82: posts big blind €0.02
*** HOLE CARDS ***
Dealt to pipinoelbreve9 [Jc 5h]
pucelazo: folds 
pipinoelbreve9: folds 
marcel13013: calls €0.02
ese lines: folds 
Ahojador: raises €0.04 to €0.06
di_pt_82: folds 
marcel13013: calls €0.04
*** FLOP *** [9h Ad Kd]
Ahojador: bets €0.05
marcel13013: raises €0.27 to €0.32 and is all-in
Ahojador: calls €0.27
*** TURN *** [9h Ad Kd] [6c]
*** RIVER *** [9h Ad Kd 6c] [7c]
*** SHOW DOWN ***
Ahojador: shows [Ts Ac] (a pair of Aces)
marcel13013: shows [Jd Qd] (high card Ace)
Ahojador collected €0.74 from pot
*** SUMMARY ***
Total pot €0.78 | Rake €0.04 
Board [9h Ad Kd 6c 7c]
Seat 1: ese lines (button) folded before Flop (didn't bet)
Seat 2: Ahojador (small blind) showed [Ts Ac] and won (€0.74) with a pair of Aces
Seat 3: di_pt_82 (big blind) folded before Flop
Seat 4: pucelazo folded before Flop (didn't bet)
Seat 5: pipinoelbreve9 folded before Flop (didn't bet)
Seat 6: marcel13013 showed [Jd Qd] and lost with high card Ace



PokerStars Zoom Hand #257689173385:  Hold'em No Limit (€0.01/€0.02) - 2025/09/10 18:13:19 CET [2025/09/10 12:13:19 ET]
Table 'Arneb' 6-max Seat #1 is the button
Seat 1: JENOFONTE73 (€2.81 in chips) 
Seat 2: ese lines (€0.47 in chips) 
Seat 3: pipinoelbreve9 (€4.18 in chips) 
Seat 4: Diamondsdogs (€2 in chips) 
Seat 5: Siddharta33 (€2.74 in chips) 
Seat 6: elcraque41 (€1.97 in chips) 
ese lines: posts small blind €0.01
pipinoelbreve9: posts big blind €0.02
*** HOLE CARDS ***
Dealt to pipinoelbreve9 [Kh 9d]
Diamondsdogs: folds 
Siddharta33: folds 
elcraque41 has timed out
elcraque41: folds 
JENOFONTE73: folds 
ese lines: calls €0.01
pipinoelbreve9: raises €0.04 to €0.06
ese lines: calls €0.04
*** FLOP *** [5h Jd Qs]
ese lines: checks 
pipinoelbreve9: checks 
*** TURN *** [5h Jd Qs] [4h]
ese lines: checks 
pipinoelbreve9: checks 
*** RIVER *** [5h Jd Qs 4h] [3d]
ese lines: checks 
pipinoelbreve9: checks 
*** SHOW DOWN ***
ese lines: shows [Th Ad] (high card Ace)
pipinoelbreve9: mucks hand 
ese lines collected €0.11 from pot
*** SUMMARY ***
Total pot €0.12 | Rake €0.01 
Board [5h Jd Qs 4h 3d]
Seat 1: JENOFONTE73 (button) folded before Flop (didn't bet)
Seat 2: ese lines (small blind) showed [Th Ad] and won (€0.11) with high card Ace
Seat 3: pipinoelbreve9 (big blind) mucked [Kh 9d]
Seat 4: Diamondsdogs folded before Flop (didn't bet)
Seat 5: Siddharta33 folded before Flop (didn't bet)
Seat 6: elcraque41 folded before Flop (didn't bet)



PokerStars Zoom Hand #257689185432:  Hold'em No Limit (€0.01/€0.02) - 2025/09/10 18:14:21 CET [2025/09/10 12:14:21 ET]
Table 'Arneb' 6-max Seat #1 is the button
Seat 1: fvprodigy (€2.78 in chips) 
Seat 2: Diamondsdogs (€2.02 in chips) 
Seat 3: di_pt_82 (€1.89 in chips) 
Seat 4: pipinoelbreve9 (€4.12 in chips) 
Seat 5: DavSnook (€4.18 in chips) 
Seat 6: CORDEVIGO (€5.27 in chips) 
Diamondsdogs: posts small blind €0.01
di_pt_82: posts big blind €0.02
*** HOLE CARDS ***
Dealt to pipinoelbreve9 [8c 8h]
pipinoelbreve9: raises €0.04 to €0.06
DavSnook: folds 
CORDEVIGO: calls €0.06
fvprodigy: folds 
Diamondsdogs: raises €0.20 to €0.26
di_pt_82: folds 
pipinoelbreve9: folds 
CORDEVIGO: folds 
Uncalled bet (€0.20) returned to Diamondsdogs
Diamondsdogs collected €0.20 from pot
Diamondsdogs: doesn't show hand 
*** SUMMARY ***
Total pot €0.20 | Rake €0 
Seat 1: fvprodigy (button) folded before Flop (didn't bet)
Seat 2: Diamondsdogs (small blind) collected (€0.20)
Seat 3: di_pt_82 (big blind) folded before Flop
Seat 4: pipinoelbreve9 folded before Flop
Seat 5: DavSnook folded before Flop (didn't bet)
Seat 6: CORDEVIGO folded before Flop



PokerStars Zoom Hand #257689184231:  Hold'em No Limit (€0.01/€0.02) - 2025/09/10 18:14:15 CET [2025/09/10 12:14:15 ET]
Table 'Arneb' 6-max Seat #1 is the button
Seat 1: pipinoelbreve9 (€4.12 in chips) 
Seat 2: linto2800 (€2.22 in chips) 
Seat 3: chonji24 (€2.19 in chips) 
Seat 4: Elons_Mucks (€2.15 in chips) 
Seat 5: FELIPE439 (€2.79 in chips) 
Seat 6: Hotspot9119 (€3.61 in chips) 
linto2800: posts small blind €0.01
chonji24: posts big blind €0.02
*** HOLE CARDS ***
Dealt to pipinoelbreve9 [6c 9h]
Elons_Mucks: raises €0.03 to €0.05
FELIPE439: folds 
Hotspot9119: folds 
pipinoelbreve9: folds 
linto2800: folds 
chonji24: calls €0.03
*** FLOP *** [5c 9s Qh]
chonji24: checks 
Elons_Mucks: checks 
*** TURN *** [5c 9s Qh] [Jc]
chonji24: checks 
Elons_Mucks: checks 
*** RIVER *** [5c 9s Qh Jc] [6d]
chonji24: checks 
Elons_Mucks: bets €0.04
chonji24: calls €0.04
*** SHOW DOWN ***
Elons_Mucks: shows [Ac Ts] (high card Ace)
chonji24: shows [6s Ks] (a pair of Sixes)
chonji24 collected €0.18 from pot
*** SUMMARY ***
Total pot €0.19 | Rake €0.01 
Board [5c 9s Qh Jc 6d]
Seat 1: pipinoelbreve9 (button) folded before Flop (didn't bet)
Seat 2: linto2800 (small blind) folded before Flop
Seat 3: chonji24 (big blind) showed [6s Ks] and won (€0.18) with a pair of Sixes
Seat 4: Elons_Mucks showed [Ac Ts] and lost with high card Ace
Seat 5: FELIPE439 folded before Flop (didn't bet)
Seat 6: Hotspot9119 folded before Flop (didn't bet)



PokerStars Zoom Hand #257689195706:  Hold'em No Limit (€0.01/€0.02) - 2025/09/10 18:15:14 CET [2025/09/10 12:15:14 ET]
Table 'Arneb' 6-max Seat #1 is the button
Seat 1: Capi010 (€0.83 in chips) 
Seat 2: CORDEVIGO (€5.12 in chips) 
Seat 3: pipinoelbreve9 (€4.05 in chips) 
Seat 4: Siddharta33 (€1.92 in chips) 
Seat 5: SGB36 (€1.77 in chips) 
Seat 6: malmeto45 (€2 in chips) 
CORDEVIGO: posts small blind €0.01
pipinoelbreve9: posts big blind €0.02
*** HOLE CARDS ***
Dealt to pipinoelbreve9 [Tc 8d]
Siddharta33: folds 
SGB36: folds 
malmeto45: folds 
Capi010: folds 
CORDEVIGO: folds 
Uncalled bet (€0.01) returned to pipinoelbreve9
pipinoelbreve9 collected €0.02 from pot
pipinoelbreve9: doesn't show hand 
*** SUMMARY ***
Total pot €0.02 | Rake €0 
Seat 1: Capi010 (button) folded before Flop (didn't bet)
Seat 2: CORDEVIGO (small blind) folded before Flop
Seat 3: pipinoelbreve9 (big blind) collected (€0.02)
Seat 4: Siddharta33 folded before Flop (didn't bet)
Seat 5: SGB36 folded before Flop (didn't bet)
Seat 6: malmeto45 folded before Flop (didn't bet)



PokerStars Zoom Hand #257689189337:  Hold'em No Limit (€0.01/€0.02) - 2025/09/10 18:14:42 CET [2025/09/10 12:14:42 ET]
Table 'Arneb' 6-max Seat #1 is the button
Seat 1: Marc Perca (€1.97 in chips) 
Seat 2: pipinoelbreve9 (€4.06 in chips) 
Seat 3: Meg62480 (€2.60 in chips) 
Seat 4: soyeterno (€4.71 in chips) 
Seat 5: elcraque41 (€1.97 in chips) 
Seat 6: Abrelatas787 (€2.03 in chips) 
pipinoelbreve9: posts small blind €0.01
Meg62480: posts big blind €0.02
*** HOLE CARDS ***
Dealt to pipinoelbreve9 [5c Td]
soyeterno: folds 
elcraque41: calls €0.02
Abrelatas787: raises €0.04 to €0.06
Marc Perca: folds 
pipinoelbreve9: folds 
Meg62480: folds 
elcraque41: calls €0.04
*** FLOP *** [8d 2c Kh]
elcraque41: checks 
Abrelatas787: checks 
*** TURN *** [8d 2c Kh] [9h]
elcraque41: bets €0.08
Abrelatas787: folds 
Uncalled bet (€0.08) returned to elcraque41
elcraque41 collected €0.14 from pot
elcraque41: doesn't show hand 
*** SUMMARY ***
Total pot €0.15 | Rake €0.01 
Board [8d 2c Kh 9h]
Seat 1: Marc Perca (button) folded before Flop (didn't bet)
Seat 2: pipinoelbreve9 (small blind) folded before Flop
Seat 3: Meg62480 (big blind) folded before Flop
Seat 4: soyeterno folded before Flop (didn't bet)
Seat 5: elcraque41 collected (€0.14)
Seat 6: Abrelatas787 folded on the Turn



PokerStars Zoom Hand #257689194685:  Hold'em No Limit (€0.01/€0.02) - 2025/09/10 18:15:09 CET [2025/09/10 12:15:09 ET]
Table 'Arneb' 6-max Seat #1 is the button
Seat 1: alvlugom (€2.60 in chips) 
Seat 2: 240Rober (€2.54 in chips) 
Seat 3: chiinche (€2.08 in chips) 
Seat 4: pipinoelbreve9 (€4.05 in chips) 
Seat 5: Sportacus911 (€2.84 in chips) 
Seat 6: manecas0000 (€1.16 in chips) 
240Rober: posts small blind €0.01
chiinche: posts big blind €0.02
*** HOLE CARDS ***
Dealt to pipinoelbreve9 [6s Ac]
pipinoelbreve9: folds 
Sportacus911: folds 
manecas0000: raises €0.05 to €0.07
alvlugom: calls €0.07
240Rober: folds 
chiinche: folds 
*** FLOP *** [6d 3d 9c]
manecas0000: bets €0.08
alvlugom: raises €0.08 to €0.16
manecas0000: calls €0.08
*** TURN *** [6d 3d 9c] [Qh]
manecas0000: bets €0.24
alvlugom: calls €0.24
*** RIVER *** [6d 3d 9c Qh] [5c]
manecas0000: bets €0.69 and is all-in
alvlugom: folds 
Uncalled bet (€0.69) returned to manecas0000
manecas0000 collected €0.92 from pot
manecas0000: doesn't show hand 
*** SUMMARY ***
Total pot €0.97 | Rake €0.05 
Board [6d 3d 9c Qh 5c]
Seat 1: alvlugom (button) folded on the River
Seat 2: 240Rober (small blind) folded before Flop
Seat 3: chiinche (big blind) folded before Flop
Seat 4: pipinoelbreve9 folded before Flop (didn't bet)
Seat 5: Sportacus911 folded before Flop (didn't bet)
Seat 6: manecas0000 collected (€0.92)



PokerStars Zoom Hand #257689197418:  Hold'em No Limit (€0.01/€0.02) - 2025/09/10 18:15:23 CET [2025/09/10 12:15:23 ET]
Table 'Arneb' 6-max Seat #1 is the button
Seat 1: Siddharta33 (€2.81 in chips) 
Seat 2: serviettski(fr) (€2.09 in chips) 
Seat 3: wendyd27 (€2.49 in chips) 
Seat 4: Mr7331 (€1.79 in chips) 
Seat 5: Diegot2119 (€1.01 in chips) 
Seat 6: pipinoelbreve9 (€4.06 in chips) 
serviettski(fr): posts small blind €0.01
wendyd27: posts big blind €0.02
*** HOLE CARDS ***
Dealt to pipinoelbreve9 [Ad 5h]
Mr7331: folds 
Diegot2119: folds 
pipinoelbreve9: folds 
Siddharta33: calls €0.02
serviettski(fr): raises €0.08 to €0.10
wendyd27: calls €0.08
Siddharta33: folds 
*** FLOP *** [Qh Ks 3s]
serviettski(fr): bets €0.07
wendyd27: calls €0.07
*** TURN *** [Qh Ks 3s] [7c]
serviettski(fr): bets €0.26
wendyd27: calls €0.26
*** RIVER *** [Qh Ks 3s 7c] [6c]
serviettski(fr): checks 
wendyd27: checks 
*** SHOW DOWN ***
serviettski(fr): shows [Kc As] (a pair of Kings)
wendyd27: mucks hand 
serviettski(fr) collected €0.84 from pot
*** SUMMARY ***
Total pot €0.88 | Rake €0.04 
Board [Qh Ks 3s 7c 6c]
Seat 1: Siddharta33 (button) folded before Flop
Seat 2: serviettski(fr) (small blind) showed [Kc As] and won (€0.84) with a pair of Kings
Seat 3: wendyd27 (big blind) mucked [Th Qc]
Seat 4: Mr7331 folded before Flop (didn't bet)
Seat 5: Diegot2119 folded before Flop (didn't bet)
Seat 6: pipinoelbreve9 folded before Flop (didn't bet)



PokerStars Zoom Hand #257689199226:  Hold'em No Limit (€0.01/€0.02) - 2025/09/10 18:15:32 CET [2025/09/10 12:15:32 ET]
Table 'Arneb' 6-max Seat #1 is the button
Seat 1: pipinoelbreve9 (€4.06 in chips) 
Seat 2: Nirvisen (€1.96 in chips) 
Seat 3: cherda33 (€6.02 in chips) 
Seat 4: CORDEVIGO (€5.11 in chips) 
Seat 5: marcel13013 (€1.42 in chips) 
Seat 6: feerry61 (€2.12 in chips) 
Nirvisen: posts small blind €0.01
cherda33: posts big blind €0.02
*** HOLE CARDS ***
Dealt to pipinoelbreve9 [9s Ac]
CORDEVIGO: folds 
marcel13013: folds 
feerry61: raises €0.04 to €0.06
pipinoelbreve9: calls €0.06
Nirvisen: folds 
cherda33: calls €0.04
*** FLOP *** [9d 7d Qc]
cherda33: checks 
feerry61: checks 
pipinoelbreve9: bets €0.09
cherda33: folds 
feerry61: calls €0.09
*** TURN *** [9d 7d Qc] [5h]
feerry61: checks 
pipinoelbreve9: checks 
*** RIVER *** [9d 7d Qc 5h] [5s]
feerry61: checks 
pipinoelbreve9: bets €0.18
feerry61: folds 
Uncalled bet (€0.18) returned to pipinoelbreve9
pipinoelbreve9 collected €0.35 from pot
pipinoelbreve9: doesn't show hand 
*** SUMMARY ***
Total pot €0.37 | Rake €0.02 
Board [9d 7d Qc 5h 5s]
Seat 1: pipinoelbreve9 (button) collected (€0.35)
Seat 2: Nirvisen (small blind) folded before Flop
Seat 3: cherda33 (big blind) folded on the Flop
Seat 4: CORDEVIGO folded before Flop (didn't bet)
Seat 5: marcel13013 folded before Flop (didn't bet)
Seat 6: feerry61 folded on the River



PokerStars Zoom Hand #257689215760:  Hold'em No Limit (€0.01/€0.02) - 2025/09/10 18:16:58 CET [2025/09/10 12:16:58 ET]
Table 'Arneb' 6-max Seat #1 is the button
Seat 1: marcel13013 (€1.15 in chips) 
Seat 2: pipinoelbreve9 (€4.26 in chips) 
Seat 3: ssjimmyss88 (€4.50 in chips) 
Seat 4: chiinche (€2 in chips) 
Seat 5: feerry61 (€2 in chips) 
Seat 6: soyeterno (€0.71 in chips) 
pipinoelbreve9: posts small blind €0.01
ssjimmyss88: posts big blind €0.02
*** HOLE CARDS ***
Dealt to pipinoelbreve9 [Qc Jd]
chiinche: folds 
feerry61: folds 
soyeterno: folds 
marcel13013: folds 
pipinoelbreve9: raises €0.04 to €0.06
ssjimmyss88: calls €0.04
*** FLOP *** [4s Ks 8c]
pipinoelbreve9: bets €0.06
ssjimmyss88: calls €0.06
*** TURN *** [4s Ks 8c] [7d]
pipinoelbreve9: checks 
ssjimmyss88: bets €0.12
pipinoelbreve9: folds 
Uncalled bet (€0.12) returned to ssjimmyss88
ssjimmyss88 collected €0.23 from pot
ssjimmyss88: doesn't show hand 
*** SUMMARY ***
Total pot €0.24 | Rake €0.01 
Board [4s Ks 8c 7d]
Seat 1: marcel13013 (button) folded before Flop (didn't bet)
Seat 2: pipinoelbreve9 (small blind) folded on the Turn
Seat 3: ssjimmyss88 (big blind) collected (€0.23)
Seat 4: chiinche folded before Flop (didn't bet)
Seat 5: feerry61 folded before Flop (didn't bet)
Seat 6: soyeterno folded before Flop (didn't bet)



PokerStars Zoom Hand #257689223288:  Hold'em No Limit (€0.01/€0.02) - 2025/09/10 18:17:37 CET [2025/09/10 12:17:37 ET]
Table 'Arneb' 6-max Seat #1 is the button
Seat 1: alvlugom (€2.45 in chips) 
Seat 2: cuenca10 (€3.12 in chips) 
Seat 3: TAO_INSIDE (€1.41 in chips) 
Seat 4: 240Rober (€2.11 in chips) 
Seat 5: AFRAGIL79 (€1.30 in chips) 
Seat 6: pipinoelbreve9 (€4.14 in chips) 
cuenca10: posts small blind €0.01
TAO_INSIDE: posts big blind €0.02
*** HOLE CARDS ***
Dealt to pipinoelbreve9 [5h 6c]
240Rober: folds 
AFRAGIL79: folds 
pipinoelbreve9: folds 
alvlugom: folds 
cuenca10: folds 
Uncalled bet (€0.01) returned to TAO_INSIDE
TAO_INSIDE collected €0.02 from pot
TAO_INSIDE: doesn't show hand 
*** SUMMARY ***
Total pot €0.02 | Rake €0 
Seat 1: alvlugom (button) folded before Flop (didn't bet)
Seat 2: cuenca10 (small blind) folded before Flop
Seat 3: TAO_INSIDE (big blind) collected (€0.02)
Seat 4: 240Rober folded before Flop (didn't bet)
Seat 5: AFRAGIL79 folded before Flop (didn't bet)
Seat 6: pipinoelbreve9 folded before Flop (didn't bet)



PokerStars Zoom Hand #257689224251:  Hold'em No Limit (€0.01/€0.02) - 2025/09/10 18:17:42 CET [2025/09/10 12:17:42 ET]
Table 'Arneb' 6-max Seat #1 is the button
Seat 1: PrendsCa (€3.61 in chips) 
Seat 2: 240Rober (€2.11 in chips) 
Seat 3: feerry61 (€2.08 in chips) 
Seat 4: pipinoelbreve9 (€4.14 in chips) 
Seat 5: cuenca10 (€3.11 in chips) 
Seat 6: serviettski(fr) (€2.50 in chips) 
240Rober: posts small blind €0.01
feerry61: posts big blind €0.02
*** HOLE CARDS ***
Dealt to pipinoelbreve9 [Ks 7s]
pipinoelbreve9: folds 
cuenca10: folds 
serviettski(fr): folds 
PrendsCa: raises €0.04 to €0.06
240Rober: folds 
feerry61: raises €0.14 to €0.20
PrendsCa: folds 
Uncalled bet (€0.14) returned to feerry61
feerry61 collected €0.13 from pot
feerry61: doesn't show hand 
*** SUMMARY ***
Total pot €0.13 | Rake €0 
Seat 1: PrendsCa (button) folded before Flop
Seat 2: 240Rober (small blind) folded before Flop
Seat 3: feerry61 (big blind) collected (€0.13)
Seat 4: pipinoelbreve9 folded before Flop (didn't bet)
Seat 5: cuenca10 folded before Flop (didn't bet)
Seat 6: serviettski(fr) folded before Flop (didn't bet)



PokerStars Zoom Hand #257689226486:  Hold'em No Limit (€0.01/€0.02) - 2025/09/10 18:17:53 CET [2025/09/10 12:17:53 ET]
Table 'Arneb' 6-max Seat #1 is the button
Seat 1: malmeto45 (€2.17 in chips) 
Seat 2: vaness47985 (€1.79 in chips) 
Seat 3: pipinoelbreve9 (€4.14 in chips) 
Seat 4: Capi010 (€0.73 in chips) 
Seat 5: ese lines (€2.49 in chips) 
Seat 6: soyeterno (€3.18 in chips) 
vaness47985: posts small blind €0.01
pipinoelbreve9: posts big blind €0.02
*** HOLE CARDS ***
Dealt to pipinoelbreve9 [Qd Kd]
Capi010: folds 
ese lines: folds 
soyeterno: raises €0.04 to €0.06
malmeto45: folds 
vaness47985: folds 
pipinoelbreve9: raises €0.12 to €0.18
soyeterno: calls €0.12
*** FLOP *** [3s Td 5c]
pipinoelbreve9: bets €0.14
soyeterno: folds 
Uncalled bet (€0.14) returned to pipinoelbreve9
pipinoelbreve9 collected €0.35 from pot
pipinoelbreve9: doesn't show hand 
*** SUMMARY ***
Total pot €0.37 | Rake €0.02 
Board [3s Td 5c]
Seat 1: malmeto45 (button) folded before Flop (didn't bet)
Seat 2: vaness47985 (small blind) folded before Flop
Seat 3: pipinoelbreve9 (big blind) collected (€0.35)
Seat 4: Capi010 folded before Flop (didn't bet)
Seat 5: ese lines folded before Flop (didn't bet)
Seat 6: soyeterno folded on the Flop



PokerStars Zoom Hand #257689232556:  Hold'em No Limit (€0.01/€0.02) - 2025/09/10 18:18:24 CET [2025/09/10 12:18:24 ET]
Table 'Arneb' 6-max Seat #1 is the button
Seat 1: pipinoelbreve9 (€4.31 in chips) 
Seat 2: malmeto45 (€2.15 in chips) 
Seat 3: wendyd27 (€1.71 in chips) 
Seat 4: SGB36 (€1.89 in chips) 
Seat 5: Ruben1990869 (€2 in chips) 
Seat 6: serviettski(fr) (€2.06 in chips) 
malmeto45: posts small blind €0.01
wendyd27: posts big blind €0.02
*** HOLE CARDS ***
Dealt to pipinoelbreve9 [3d Kh]
SGB36: folds 
Ruben1990869: folds 
serviettski(fr): folds 
pipinoelbreve9: folds 
malmeto45: folds 
Uncalled bet (€0.01) returned to wendyd27
wendyd27 collected €0.02 from pot
wendyd27: doesn't show hand 
*** SUMMARY ***
Total pot €0.02 | Rake €0 
Seat 1: pipinoelbreve9 (button) folded before Flop (didn't bet)
Seat 2: malmeto45 (small blind) folded before Flop
Seat 3: wendyd27 (big blind) collected (€0.02)
Seat 4: SGB36 folded before Flop (didn't bet)
Seat 5: Ruben1990869 folded before Flop (didn't bet)
Seat 6: serviettski(fr) folded before Flop (didn't bet)



PokerStars Zoom Hand #257689222416:  Hold'em No Limit (€0.01/€0.02) - 2025/09/10 18:17:32 CET [2025/09/10 12:17:32 ET]
Table 'Arneb' 6-max Seat #1 is the button
Seat 1: di_pt_82 (€2.02 in chips) 
Seat 2: ssjimmyss88 (€4.61 in chips) 
Seat 3: Momo94117 (€1.58 in chips) 
Seat 4: Popins0011 (€4.77 in chips) 
Seat 5: pipinoelbreve9 (€4.14 in chips) 
Seat 6: Marc Perca (€2.03 in chips) 
ssjimmyss88: posts small blind €0.01
Momo94117: posts big blind €0.02
*** HOLE CARDS ***
Dealt to pipinoelbreve9 [2h Jc]
Popins0011: folds 
pipinoelbreve9: folds 
Marc Perca: folds 
di_pt_82: raises €0.04 to €0.06
ssjimmyss88: folds 
Momo94117: calls €0.04
*** FLOP *** [9d Kd 4c]
Momo94117: checks 
di_pt_82: bets €0.08
Momo94117: calls €0.08
*** TURN *** [9d Kd 4c] [Ks]
Momo94117: checks 
di_pt_82: checks 
*** RIVER *** [9d Kd 4c Ks] [4h]
Momo94117: bets €0.10
di_pt_82: folds 
Uncalled bet (€0.10) returned to Momo94117
Momo94117 collected €0.28 from pot
Momo94117: doesn't show hand 
*** SUMMARY ***
Total pot €0.29 | Rake €0.01 
Board [9d Kd 4c Ks 4h]
Seat 1: di_pt_82 (button) folded on the River
Seat 2: ssjimmyss88 (small blind) folded before Flop
Seat 3: Momo94117 (big blind) collected (€0.28)
Seat 4: Popins0011 folded before Flop (didn't bet)
Seat 5: pipinoelbreve9 folded before Flop (didn't bet)
Seat 6: Marc Perca folded before Flop (didn't bet)



PokerStars Zoom Hand #257689233935:  Hold'em No Limit (€0.01/€0.02) - 2025/09/10 18:18:31 CET [2025/09/10 12:18:31 ET]
Table 'Arneb' 6-max Seat #1 is the button
Seat 1: chiinche (€1.98 in chips) 
Seat 2: iam_xCidx (€2.01 in chips) 
Seat 3: candarias (€1.52 in chips) 
Seat 4: pipinoelbreve9 (€4.31 in chips) 
Seat 5: nometoquesloshu (€0.59 in chips) 
Seat 6: Marc Perca (€2 in chips) 
iam_xCidx: posts small blind €0.01
candarias: posts big blind €0.02
*** HOLE CARDS ***
Dealt to pipinoelbreve9 [4h 7c]
pipinoelbreve9: folds 
nometoquesloshu: folds 
Marc Perca: folds 
chiinche: folds 
iam_xCidx: raises €0.10 to €0.12
candarias: folds 
Uncalled bet (€0.10) returned to iam_xCidx
iam_xCidx collected €0.04 from pot
iam_xCidx: doesn't show hand 
*** SUMMARY ***
Total pot €0.04 | Rake €0 
Seat 1: chiinche (button) folded before Flop (didn't bet)
Seat 2: iam_xCidx (small blind) collected (€0.04)
Seat 3: candarias (big blind) folded before Flop
Seat 4: pipinoelbreve9 folded before Flop (didn't bet)
Seat 5: nometoquesloshu folded before Flop (didn't bet)
Seat 6: Marc Perca folded before Flop (didn't bet)



PokerStars Zoom Hand #257689234913:  Hold'em No Limit (€0.01/€0.02) - 2025/09/10 18:18:36 CET [2025/09/10 12:18:36 ET]
Table 'Arneb' 6-max Seat #1 is the button
Seat 1: soyeterno (€2.99 in chips) 
Seat 2: candarias (€0.98 in chips) 
Seat 3: chancasweb (€2 in chips) 
Seat 4: Abrelatas787 (€2.38 in chips) 
Seat 5: pipinoelbreve9 (€4.31 in chips) 
Seat 6: Doblea315 (€2.20 in chips) 
candarias: posts small blind €0.01
chancasweb: posts big blind €0.02
*** HOLE CARDS ***
Dealt to pipinoelbreve9 [3c Qd]
Abrelatas787: folds 
pipinoelbreve9: folds 
Doblea315: folds 
soyeterno: folds 
candarias: folds 
Uncalled bet (€0.01) returned to chancasweb
chancasweb collected €0.02 from pot
chancasweb: doesn't show hand 
*** SUMMARY ***
Total pot €0.02 | Rake €0 
Seat 1: soyeterno (button) folded before Flop (didn't bet)
Seat 2: candarias (small blind) folded before Flop
Seat 3: chancasweb (big blind) collected (€0.02)
Seat 4: Abrelatas787 folded before Flop (didn't bet)
Seat 5: pipinoelbreve9 folded before Flop (didn't bet)
Seat 6: Doblea315 folded before Flop (didn't bet)



